Time,  Packets Generated,  Packets Reached,High Priority Packets Generated, High Priority Packets reached, Packet Dropped, Packet Dropped due to Faulty Node, High Prio Packet Dropped due to Faulty Node, Low Prio Packet Dropped due to Faulty Node 
5,1,1,1,1,0,0,0,0
10,6,3,5,2,3,3,3,0
15,8,3,6,2,4,4,4,0
20,16,7,10,3,8,8,6,2
25,19,9,11,4,10,10,7,3
30,24,13,13,5,11,11,8,3
35,28,13,15,5,14,14,9,5
40,31,15,16,7,16,16,9,7
45,32,16,17,8,16,16,9,7
50,37,18,19,9,19,19,10,9
55,39,18,21,9,20,20,11,9
60,47,22,23,11,24,24,12,12
65,50,24,26,12,24,24,12,12
70,55,30,29,17,25,25,12,13
75,59,30,30,17,27,27,13,14
80,62,34,31,17,27,27,13,14
85,63,36,31,18,27,27,13,14
90,68,38,32,19,28,28,13,15
95,70,40,34,19,29,29,14,15
100,78,44,36,21,31,31,14,17
105,81,48,37,22,31,31,14,17
110,86,54,39,25,32,32,14,18
115,90,55,41,26,34,34,15,19
120,93,58,43,28,34,34,15,19
125,94,60,44,29,34,34,15,19
130,99,62,45,29,35,35,15,20
135,101,64,46,30,36,36,15,21
140,109,68,50,33,38,38,16,22
145,112,72,53,35,38,38,16,22
150,117,78,56,39,39,39,17,22
155,121,79,58,39,40,40,17,23
160,124,82,60,42,41,40,17,23
165,125,83,60,43,42,40,17,23
170,130,85,63,45,44,41,17,24
175,132,86,64,46,45,42,17,25
180,140,90,68,49,48,44,18,26
185,143,92,70,50,49,44,18,26
190,148,97,72,54,51,45,18,27
195,152,97,74,54,54,46,19,27
200,155,99,76,56,55,46,19,27
205,156,100,77,57,56,46,19,27
210,161,101,80,58,58,47,19,28
215,163,103,80,60,60,48,19,29
220,171,105,85,62,65,51,21,30
225,174,107,87,63,65,51,21,30
230,179,112,91,68,67,52,22,30
235,183,112,93,68,69,53,22,31
240,186,115,94,71,71,53,22,31
245,187,115,94,71,72,53,22,31
250,192,115,96,71,77,53,22,31
255,194,115,96,71,79,54,22,32
260,202,117,101,72,85,56,24,32
265,205,118,103,73,87,56,24,32
270,210,119,106,74,91,57,24,33
275,214,119,106,74,95,58,24,34
280,217,120,107,75,97,58,24,34
285,218,120,108,75,98,58,24,34
290,223,120,110,75,103,58,24,34
295,225,120,110,75,105,59,24,35
300,233,122,113,76,111,61,24,37
305,236,122,115,76,114,61,24,37
310,241,123,117,76,118,62,25,37
315,245,123,119,76,121,63,25,38
320,248,125,120,78,123,63,25,38
325,249,125,121,78,124,63,25,38
330,254,125,124,78,129,64,26,38
335,256,125,124,78,131,65,26,39
340,264,127,131,80,137,67,28,39
345,267,127,132,80,140,67,28,39
350,272,129,133,81,143,68,28,40
355,276,130,136,82,145,69,29,40
360,279,132,137,84,147,69,29,40
365,280,132,137,84,148,69,29,40
370,285,132,139,84,153,69,29,40
375,287,132,140,84,155,70,29,41
380,295,134,144,85,161,72,30,42
385,298,134,144,85,164,72,30,42
390,303,135,148,86,168,72,30,42
395,307,135,150,86,172,73,31,42
400,310,136,152,87,174,73,31,42
405,311,136,152,87,175,73,31,42
410,316,137,157,88,179,73,31,42
415,318,137,157,88,181,74,31,43
420,326,139,161,89,187,76,31,45
425,329,139,163,89,190,76,31,45
430,334,140,165,90,194,76,31,45
435,338,140,168,90,197,77,32,45
440,341,143,171,93,198,77,32,45
445,342,143,171,93,199,77,32,45
450,347,143,172,93,204,77,32,45
455,349,143,173,93,206,78,33,45
460,357,145,177,94,212,80,35,45
465,360,145,178,94,215,80,35,45
470,365,145,181,94,220,81,36,45
475,369,145,182,94,223,82,36,46
480,372,145,184,94,224,82,36,46
485,373,146,185,95,227,82,36,46
490,378,146,186,95,232,82,36,46
495,380,146,188,95,234,83,37,46
500,388,146,193,95,242,84,38,46
505,391,146,194,95,245,84,38,46
510,396,146,197,95,250,84,38,46
515,400,146,199,95,254,85,38,47
520,403,146,200,95,257,85,38,47
525,404,146,200,95,258,85,38,47
530,409,147,201,95,262,85,38,47
535,411,147,202,95,264,86,39,47
540,419,147,205,95,272,87,39,48
545,422,147,206,95,275,87,39,48
550,427,147,207,95,280,87,39,48
555,431,147,209,95,283,88,40,48
560,434,148,210,96,286,88,40,48
565,435,149,211,97,286,88,40,48
570,440,150,213,97,290,89,41,48
575,442,150,213,97,292,90,41,49
580,450,153,218,99,297,92,41,51
585,453,154,221,100,299,92,41,51
590,458,155,222,101,303,93,41,52
595,462,155,223,101,307,94,41,53
600,465,155,223,101,310,94,41,53
605,466,155,224,101,311,94,41,53
610,471,156,225,101,315,94,41,53
615,473,156,226,101,317,95,41,54
620,481,157,227,102,324,95,41,54
625,484,157,228,102,327,95,41,54
630,489,158,230,103,331,95,41,54
635,493,158,231,103,335,95,41,54
640,496,158,231,103,338,95,41,54
645,497,158,231,103,339,95,41,54
650,502,159,235,104,343,95,41,54
655,504,159,236,104,345,96,42,54
660,512,159,241,104,353,96,42,54
665,515,159,242,104,356,96,42,54
670,520,160,242,104,360,96,42,54
675,524,160,244,104,363,96,42,54
680,527,161,245,105,366,96,42,54
685,528,161,245,105,367,96,42,54
690,533,162,247,105,371,96,42,54
695,535,162,249,105,373,97,43,54
700,543,162,252,105,381,97,43,54
705,546,162,253,105,384,97,43,54
710,551,163,254,105,388,98,43,55
715,555,164,255,106,391,99,43,56
720,558,164,256,106,393,99,43,56
725,559,165,256,107,394,99,43,56
730,564,165,257,107,399,99,43,56
735,566,165,259,107,401,100,44,56
740,574,166,261,107,408,101,44,57
745,577,166,263,107,411,101,44,57
750,582,167,267,108,415,102,45,57
755,586,167,269,108,419,102,45,57
760,589,167,271,108,422,102,45,57
765,590,167,271,108,423,102,45,57
770,595,167,275,108,428,102,45,57
775,597,167,277,108,430,103,46,57
780,605,168,281,109,437,104,47,57
785,608,168,282,109,440,104,47,57
790,613,169,283,109,444,105,47,58
795,617,169,286,109,448,105,47,58
800,620,169,286,109,451,105,47,58
805,621,169,287,109,452,105,47,58
810,626,169,291,109,457,105,47,58
815,628,169,291,109,459,106,47,59
820,636,170,296,110,466,107,48,59
825,639,171,297,111,468,107,48,59
830,644,172,299,112,472,107,48,59
835,648,172,300,112,476,108,48,60
840,651,174,302,114,477,108,48,60
845,652,174,303,114,478,108,48,60
850,657,174,307,114,483,108,48,60
855,659,174,309,114,485,109,49,60
860,667,174,312,114,493,109,49,60
865,670,174,314,114,496,109,49,60
870,675,175,318,115,500,110,49,61
875,679,175,321,115,504,110,49,61
880,682,175,322,115,507,110,49,61
885,683,175,323,115,508,110,49,61
890,688,175,326,115,513,110,49,61
895,690,175,328,115,515,111,50,61
900,698,176,333,116,522,111,50,61
905,701,176,334,116,525,111,50,61
910,706,177,336,116,529,112,50,62
915,710,177,339,116,533,112,50,62
920,713,177,341,116,536,112,50,62
925,714,177,342,116,537,112,50,62
930,719,177,345,116,542,112,50,62
935,721,177,346,116,544,113,50,63
940,729,177,350,116,552,113,50,63
945,732,177,353,116,555,113,50,63
950,737,179,356,117,558,114,51,63
955,741,179,356,117,562,115,51,64
960,744,180,357,118,564,115,51,64
965,745,180,358,118,565,115,51,64
970,750,181,361,119,569,116,52,64
975,752,181,362,119,571,117,53,64
980,760,182,365,120,578,118,53,65
985,763,182,367,120,581,118,53,65
990,768,183,371,121,585,119,54,65
995,772,183,373,121,589,119,54,65
1000,775,183,374,121,592,119,54,65
1005,776,183,374,121,593,119,54,65
1010,781,184,376,121,597,119,54,65
1015,783,184,376,121,599,120,54,66
1020,791,185,380,122,606,121,54,67
1025,794,185,381,122,609,121,54,67
1030,799,186,382,122,613,121,54,67
1035,803,186,383,122,617,121,54,67
1040,806,186,384,122,620,121,54,67
1045,807,186,385,122,621,121,54,67
1050,812,187,385,122,625,121,54,67
1055,814,187,385,122,627,122,54,68
1060,822,188,389,122,634,123,55,68
1065,825,188,390,122,637,123,55,68
1070,830,189,391,123,641,123,55,68
1075,834,189,392,123,644,124,55,69
1080,837,189,393,123,646,124,55,69
1085,838,190,394,124,648,124,55,69
1090,843,191,396,124,652,125,55,70
1095,845,191,397,124,654,126,56,70
1100,853,192,401,125,661,126,56,70
1105,856,192,402,125,664,126,56,70
1110,861,193,406,126,668,126,56,70
1115,865,193,407,126,672,127,57,70
1120,868,193,407,126,675,127,57,70
1125,869,193,407,126,676,127,57,70
1130,874,194,411,127,680,128,58,70
1135,876,194,411,127,682,129,58,71
1140,884,195,417,128,689,129,58,71
1145,887,195,418,128,692,129,58,71
1150,892,196,419,129,696,130,58,72
1155,896,196,421,129,700,131,58,73
1160,899,197,422,130,702,131,58,73
1165,900,197,423,130,703,131,58,73
1170,905,198,425,131,707,131,58,73
1175,907,198,427,131,709,132,59,73
1180,915,199,431,131,716,132,59,73
1185,918,199,432,131,719,132,59,73
1190,923,200,435,131,723,133,59,74
1195,927,200,437,131,727,134,60,74
1200,930,200,438,131,730,134,60,74
1205,931,200,438,131,731,134,60,74
1210,936,201,441,132,735,134,60,74
1215,938,201,442,132,737,135,61,74
1220,946,202,446,132,743,136,61,75
1225,949,204,447,134,745,136,61,75
1230,954,204,450,134,750,136,61,75
1235,958,204,453,134,753,136,61,75
1240,961,205,455,135,756,136,61,75
1245,962,205,456,135,757,136,61,75
1250,967,206,458,136,761,136,61,75
1255,969,206,460,136,763,137,62,75
1260,977,207,461,136,770,138,62,76
1265,980,207,461,136,773,138,62,76
1270,985,209,464,137,776,139,63,76
1275,989,209,467,137,779,139,63,76
1280,992,210,468,138,782,139,63,76
1285,993,210,469,138,783,139,63,76
1290,998,211,471,138,786,140,64,76
1295,1000,212,472,139,788,141,65,76
1300,1008,214,478,141,793,142,65,77
1305,1011,215,478,142,796,142,65,77
1310,1016,217,481,143,799,143,66,77
1315,1020,217,482,143,803,144,67,77
1320,1023,218,484,144,805,144,67,77
1325,1024,218,484,144,806,144,67,77
1330,1029,218,486,144,811,144,67,77
1335,1031,218,488,144,813,145,68,77
1340,1039,220,492,145,819,146,69,77
1345,1042,220,493,145,822,146,69,77
1350,1047,220,495,145,827,147,69,78
1355,1051,220,497,145,831,148,70,78
1360,1054,220,498,145,834,148,70,78
1365,1055,220,498,145,835,148,70,78
1370,1060,220,502,145,840,148,70,78
1375,1062,220,504,145,842,149,71,78
1380,1070,221,509,146,849,150,72,78
1385,1073,221,510,146,852,150,72,78
1390,1078,221,512,146,857,150,72,78
1395,1082,221,515,146,861,151,73,78
1400,1085,221,515,146,864,151,73,78
1405,1086,221,515,146,865,151,73,78
1410,1091,221,516,146,870,151,73,78
1415,1093,221,517,146,872,152,73,79
1420,1101,222,520,147,879,153,73,80
1425,1104,223,523,148,881,153,73,80
1430,1109,224,524,148,885,153,73,80
1435,1113,224,526,148,889,154,74,80
1440,1116,225,528,149,890,154,74,80
1445,1117,226,529,150,891,154,74,80
1450,1122,227,533,151,895,154,74,80
1455,1124,227,535,151,897,155,75,80
1460,1132,227,539,151,905,156,76,80
1465,1135,227,542,151,908,156,76,80
1470,1140,228,545,152,912,156,76,80
1475,1144,228,548,152,915,156,76,80
1480,1147,229,549,153,918,156,76,80
1485,1148,229,549,153,919,156,76,80
1490,1153,230,551,153,923,156,76,80
1495,1155,230,551,153,925,157,76,81
1500,1163,230,556,153,933,158,77,81
1505,1166,230,559,153,936,158,77,81
1510,1171,231,562,153,940,159,77,82
1515,1175,231,565,153,943,159,77,82
1520,1178,232,565,154,946,159,77,82
1525,1179,232,566,154,947,159,77,82
1530,1184,233,568,155,951,159,77,82
1535,1186,233,569,155,953,160,77,83
1540,1194,233,571,155,961,161,77,84
1545,1197,233,573,155,964,161,77,84
1550,1202,234,575,155,968,162,78,84
1555,1206,234,578,155,970,163,78,85
1560,1209,236,579,157,972,163,78,85
1565,1210,236,579,157,974,163,78,85
1570,1215,236,582,157,979,164,79,85
1575,1217,236,583,157,981,165,79,86
1580,1225,238,585,158,987,165,79,86
1585,1228,238,587,158,990,165,79,86
1590,1233,239,591,159,994,165,79,86
1595,1237,239,591,159,998,165,79,86
1600,1240,239,593,159,1001,165,79,86
1605,1241,239,593,159,1002,165,79,86
1610,1246,239,594,159,1007,166,79,87
1615,1248,239,595,159,1009,167,80,87
1620,1256,240,598,160,1016,167,80,87
1625,1259,240,600,160,1019,167,80,87
1630,1264,242,604,162,1022,168,81,87
1635,1268,242,606,162,1025,168,81,87
1640,1271,243,607,163,1028,168,81,87
1645,1272,243,607,163,1029,168,81,87
1650,1277,243,610,163,1034,169,81,88
1655,1279,243,611,163,1036,170,82,88
1660,1287,245,615,165,1042,171,82,89
1665,1290,245,615,165,1045,171,82,89
1670,1295,247,617,167,1048,172,82,90
1675,1299,247,618,167,1051,173,82,91
1680,1302,248,619,168,1053,173,82,91
1685,1303,249,619,169,1054,173,82,91
1690,1308,250,623,170,1058,173,82,91
1695,1310,250,624,170,1060,174,83,91
1700,1318,250,627,170,1068,174,83,91
1705,1321,250,628,170,1071,174,83,91
1710,1326,251,629,170,1075,174,83,91
1715,1330,251,630,170,1079,174,83,91
1720,1333,251,631,170,1082,174,83,91
1725,1334,251,632,170,1083,174,83,91
1730,1339,252,634,171,1087,174,83,91
1735,1341,252,635,171,1089,175,84,91
1740,1349,252,639,171,1097,175,84,91
1745,1352,252,639,171,1100,175,84,91
1750,1357,253,644,172,1104,175,84,91
1755,1361,253,646,172,1108,175,84,91
1760,1364,254,648,173,1110,175,84,91
1765,1365,254,649,173,1111,175,84,91
1770,1370,255,651,173,1115,175,84,91
1775,1372,255,653,173,1117,176,85,91
1780,1380,255,656,173,1125,176,85,91
1785,1383,255,658,173,1128,176,85,91
1790,1388,257,659,174,1131,177,85,92
1795,1392,258,661,175,1134,178,86,92
1800,1395,259,663,176,1135,178,86,92
1805,1396,259,664,176,1137,178,86,92
1810,1401,259,666,176,1142,178,86,92
1815,1403,259,667,176,1144,179,86,93
1820,1411,259,671,176,1152,179,86,93
1825,1414,259,673,176,1155,179,86,93
1830,1419,260,676,176,1159,179,86,93
1835,1423,260,677,176,1163,179,86,93
1840,1426,260,678,176,1166,179,86,93
1845,1427,260,679,176,1167,179,86,93
1850,1432,260,682,176,1172,179,86,93
1855,1434,260,683,176,1174,180,86,94
1860,1442,260,687,176,1182,180,86,94
1865,1445,260,688,176,1185,180,86,94
1870,1450,261,690,176,1189,180,86,94
1875,1454,261,691,176,1193,180,86,94
1880,1457,261,693,176,1196,180,86,94
1885,1458,261,694,176,1197,180,86,94
1890,1463,261,697,176,1202,180,86,94
1895,1465,261,698,176,1204,181,86,95
1900,1473,261,701,176,1212,181,86,95
1905,1476,261,701,176,1215,181,86,95
1910,1481,262,702,176,1219,181,86,95
1915,1485,262,705,176,1221,182,87,95
1920,1488,265,707,179,1222,182,87,95
1925,1489,265,707,179,1224,182,87,95
1930,1494,266,711,180,1228,183,88,95
1935,1496,266,713,180,1230,184,89,95
1940,1504,266,717,180,1236,185,89,96
1945,1507,266,720,180,1241,185,89,96
1950,1512,266,724,180,1246,185,89,96
1955,1516,266,726,180,1250,185,89,96
1960,1519,266,726,180,1253,185,89,96
1965,1520,266,726,180,1254,185,89,96
1970,1525,267,727,180,1258,186,89,97
1975,1527,267,729,180,1260,187,90,97
1980,1535,267,732,180,1268,188,90,98
1985,1538,267,735,180,1271,188,90,98
1990,1543,267,737,180,1276,188,90,98
1995,1547,267,739,180,1280,188,90,98
2000,1550,267,741,180,1283,188,90,98
2005,1551,267,742,180,1284,188,90,98
2010,1556,268,743,180,1288,188,90,98
2015,1558,268,743,180,1290,189,90,99
2020,1566,268,747,180,1298,190,90,100
2025,1569,268,750,180,1301,190,90,100
2030,1574,269,751,180,1305,190,90,100
2035,1578,269,752,180,1309,191,90,101
2040,1581,269,752,180,1312,191,90,101
2045,1582,269,752,180,1313,191,90,101
2050,1587,270,755,181,1317,191,90,101
2055,1589,270,756,181,1319,192,90,102
2060,1597,271,760,181,1326,192,90,102
2065,1600,271,762,181,1329,192,90,102
2070,1605,272,765,181,1333,192,90,102
2075,1609,272,766,181,1337,193,90,103
2080,1612,272,766,181,1340,193,90,103
2085,1613,272,766,181,1341,193,90,103
2090,1618,273,770,182,1345,193,90,103
2095,1620,273,771,182,1347,194,90,104
2100,1628,274,774,183,1354,194,90,104
2105,1631,274,777,183,1357,194,90,104
2110,1636,275,777,183,1361,194,90,104
2115,1640,275,780,183,1365,194,90,104
2120,1643,275,782,183,1368,194,90,104
2125,1644,275,783,183,1369,194,90,104
2130,1649,276,785,184,1373,194,90,104
2135,1651,276,786,184,1375,195,90,105
2140,1659,277,792,184,1382,195,90,105
2145,1662,277,793,184,1385,195,90,105
2150,1667,279,796,185,1388,195,90,105
2155,1671,279,797,185,1392,195,90,105
2160,1674,281,800,187,1393,195,90,105
2165,1675,282,801,188,1393,195,90,105
2170,1680,282,803,188,1398,196,90,106
2175,1682,282,805,188,1400,197,91,106
2180,1690,282,809,188,1408,199,92,107
2185,1693,282,809,188,1411,199,92,107
2190,1698,282,811,188,1416,200,92,108
2195,1702,282,813,188,1420,200,92,108
2200,1705,282,813,188,1423,200,92,108
2205,1706,282,813,188,1424,200,92,108
2210,1711,282,817,188,1429,201,93,108
2215,1713,282,818,188,1431,202,93,109
2220,1721,282,822,188,1439,203,93,110
2225,1724,282,824,188,1442,203,93,110
2230,1729,282,826,188,1447,203,93,110
2235,1733,282,827,188,1451,203,93,110
2240,1736,282,829,188,1454,203,93,110
2245,1737,282,830,188,1455,203,93,110
2250,1742,282,832,188,1460,203,93,110
2255,1744,282,833,188,1462,204,93,111
2260,1752,282,838,188,1470,205,94,111
2265,1755,282,838,188,1473,205,94,111
2270,1760,283,840,189,1477,205,94,111
2275,1764,283,843,189,1481,205,94,111
2280,1767,283,843,189,1484,205,94,111
2285,1768,283,843,189,1485,205,94,111
2290,1773,284,844,190,1489,205,94,111
2295,1775,284,844,190,1491,206,94,112
2300,1783,285,846,191,1498,206,94,112
2305,1786,285,846,191,1501,206,94,112
2310,1791,286,849,192,1505,206,94,112
2315,1795,286,853,192,1508,206,94,112
2320,1798,287,854,193,1511,206,94,112
2325,1799,287,854,193,1512,206,94,112
2330,1804,288,857,193,1516,206,94,112
2335,1806,288,858,193,1518,207,94,113
2340,1814,289,860,194,1525,207,94,113
2345,1817,289,863,194,1528,207,94,113
2350,1822,290,867,195,1532,208,95,113
2355,1826,290,870,195,1536,208,95,113
2360,1829,290,871,195,1539,208,95,113
2365,1830,290,872,195,1540,208,95,113
2370,1835,291,874,195,1544,208,95,113
2375,1837,291,875,195,1546,209,96,113
2380,1845,292,876,195,1553,209,96,113
2385,1848,292,878,195,1556,209,96,113
2390,1853,293,881,195,1560,209,96,113
2395,1857,293,884,195,1564,210,97,113
2400,1860,294,886,196,1566,210,97,113
2405,1861,294,886,196,1567,210,97,113
2410,1866,296,889,197,1570,210,97,113
2415,1868,296,890,197,1572,211,98,113
2420,1876,297,895,198,1579,213,99,114
2425,1879,297,895,198,1582,213,99,114
2430,1884,298,897,199,1586,213,99,114
2435,1888,298,899,199,1590,214,99,115
2440,1891,298,900,199,1593,214,99,115
2445,1892,298,900,199,1594,214,99,115
2450,1897,300,903,200,1597,215,100,115
2455,1899,300,904,200,1598,216,100,116
2460,1907,302,911,202,1604,218,102,116
2465,1910,302,913,202,1608,218,102,116
2470,1915,303,915,203,1612,219,102,117
2475,1919,304,918,204,1615,219,102,117
2480,1922,305,921,205,1617,219,102,117
2485,1923,305,922,205,1618,219,102,117
2490,1928,306,926,206,1622,219,102,117
2495,1930,306,926,206,1624,220,102,118
2500,1938,306,929,206,1632,221,102,119
2505,1941,306,931,206,1635,221,102,119
2510,1946,307,935,206,1639,222,103,119
2515,1950,308,936,207,1642,222,103,119
2520,1953,309,937,208,1644,222,103,119
2525,1954,309,937,208,1645,222,103,119
2530,1959,310,940,209,1649,222,103,119
2535,1961,310,941,209,1651,223,104,119
2540,1969,311,946,210,1658,223,104,119
2545,1972,311,947,210,1661,223,104,119
2550,1977,312,951,211,1665,223,104,119
2555,1981,312,951,211,1669,223,104,119
2560,1984,312,951,211,1672,223,104,119
2565,1985,312,951,211,1673,223,104,119
2570,1990,313,953,212,1677,223,104,119
2575,1992,313,953,212,1679,224,104,120
2580,2000,314,956,213,1686,225,104,121
2585,2003,314,957,213,1689,225,104,121
2590,2008,316,959,214,1692,225,104,121
2595,2012,316,959,214,1696,226,104,122
2600,2015,316,961,214,1699,226,104,122
2605,2016,316,962,214,1700,226,104,122
2610,2021,317,964,214,1704,227,105,122
2615,2023,317,966,214,1706,228,106,122
2620,2031,319,972,216,1712,229,107,122
2625,2034,319,972,216,1715,229,107,122
2630,2039,321,975,218,1718,229,107,122
2635,2043,321,978,218,1722,230,108,122
2640,2046,322,980,219,1724,230,108,122
2645,2047,322,981,219,1725,230,108,122
2650,2052,323,983,220,1729,230,108,122
2655,2054,323,985,220,1731,231,109,122
2660,2062,324,989,221,1738,232,109,123
2665,2065,324,991,221,1741,232,109,123
2670,2070,324,994,221,1746,232,109,123
2675,2074,324,994,221,1750,232,109,123
2680,2077,324,994,221,1753,232,109,123
2685,2078,324,995,221,1754,232,109,123
2690,2083,325,999,221,1758,232,109,123
2695,2085,325,1000,221,1760,233,110,123
2700,2093,326,1006,222,1767,235,111,124
2705,2096,326,1009,222,1770,235,111,124
2710,2101,327,1012,222,1774,236,112,124
2715,2105,327,1014,222,1777,237,112,125
2720,2108,328,1015,223,1780,237,112,125
2725,2109,328,1015,223,1781,237,112,125
2730,2114,329,1016,223,1785,237,112,125
2735,2116,329,1016,223,1787,238,112,126
2740,2124,330,1022,224,1794,239,113,126
2745,2127,330,1024,224,1797,239,113,126
2750,2132,331,1026,224,1801,240,114,126
2755,2136,331,1026,224,1805,241,114,127
2760,2139,331,1028,224,1807,241,114,127
2765,2140,331,1028,224,1809,241,114,127
2770,2145,332,1030,224,1813,241,114,127
2775,2147,332,1032,224,1815,242,115,127
2780,2155,333,1034,225,1822,242,115,127
2785,2158,333,1036,225,1825,242,115,127
2790,2163,333,1038,225,1830,242,115,127
2795,2167,333,1042,225,1833,242,115,127
2800,2170,334,1043,226,1836,242,115,127
2805,2171,334,1044,226,1837,242,115,127
2810,2176,335,1048,227,1841,242,115,127
2815,2178,335,1049,227,1843,243,116,127
2820,2186,336,1051,227,1850,244,116,128
2825,2189,336,1051,227,1853,244,116,128
2830,2194,336,1055,227,1858,244,116,128
2835,2198,336,1059,227,1861,244,116,128
2840,2201,338,1061,229,1863,244,116,128
2845,2202,338,1061,229,1864,244,116,128
2850,2207,339,1065,230,1868,244,116,128
2855,2209,339,1065,230,1870,245,116,129
2860,2217,340,1069,230,1877,246,117,129
2865,2220,341,1071,231,1879,246,117,129
2870,2225,341,1073,231,1884,246,117,129
2875,2229,341,1075,231,1887,247,117,130
2880,2232,343,1077,233,1889,247,117,130
2885,2233,343,1077,233,1890,247,117,130
2890,2238,343,1077,233,1895,248,117,131
2895,2240,343,1079,233,1897,249,118,131
2900,2248,343,1086,233,1905,250,119,131
2905,2251,343,1089,233,1908,250,119,131
2910,2256,343,1092,233,1913,251,119,132
2915,2260,343,1092,233,1917,252,119,133
2920,2263,343,1093,233,1920,252,119,133
2925,2264,343,1094,233,1921,252,119,133
2930,2269,343,1096,233,1926,253,119,134
2935,2271,343,1097,233,1928,254,120,134
2940,2279,343,1100,233,1936,255,120,135
2945,2282,343,1102,233,1939,255,120,135
2950,2287,343,1104,233,1944,255,120,135
2955,2291,343,1105,233,1947,255,120,135
2960,2294,343,1108,233,1951,255,120,135
2965,2295,343,1109,233,1952,255,120,135
2970,2300,344,1110,233,1956,255,120,135
2975,2302,344,1111,233,1958,256,121,135
2980,2310,344,1114,233,1966,256,121,135
2985,2313,344,1115,233,1969,256,121,135
2990,2318,345,1117,234,1973,256,121,135
2995,2322,345,1118,234,1977,256,121,135
3000,2325,345,1119,234,1980,256,121,135
3005,2326,345,1119,234,1981,256,121,135
3010,2331,346,1122,235,1985,256,121,135
3015,2333,346,1123,235,1987,257,121,136
3020,2341,348,1128,236,1993,258,122,136
3025,2344,349,1131,237,1995,258,122,136
3030,2349,350,1133,237,1999,258,122,136
3035,2353,350,1133,237,2003,258,122,136
3040,2356,351,1134,238,2005,258,122,136
3045,2357,351,1134,238,2006,258,122,136
3050,2362,353,1138,239,2009,259,123,136
3055,2364,353,1139,239,2011,260,124,136
3060,2372,355,1143,240,2017,261,125,136
3065,2375,356,1145,241,2019,261,125,136
3070,2380,356,1148,241,2024,261,125,136
3075,2384,356,1151,241,2028,261,125,136
3080,2387,356,1153,241,2031,261,125,136
3085,2388,356,1153,241,2032,261,125,136
3090,2393,356,1155,241,2037,261,125,136
3095,2395,356,1156,241,2039,262,126,136
3100,2403,356,1161,241,2047,262,126,136
3105,2406,356,1162,241,2050,262,126,136
3110,2411,356,1165,241,2055,263,126,137
3115,2415,356,1168,241,2058,263,126,137
3120,2418,356,1169,241,2062,263,126,137
3125,2419,356,1169,241,2063,263,126,137
3130,2424,357,1174,242,2067,263,126,137
3135,2426,357,1174,242,2069,264,126,138
3140,2434,359,1179,244,2075,265,127,138
3145,2437,359,1180,244,2078,265,127,138
3150,2442,359,1181,244,2083,265,127,138
3155,2446,359,1181,244,2087,265,127,138
3160,2449,359,1181,244,2090,265,127,138
3165,2450,359,1181,244,2091,265,127,138
3170,2455,360,1184,245,2095,265,127,138
3175,2457,360,1185,245,2097,266,127,139
3180,2465,361,1188,246,2104,267,127,140
3185,2468,361,1190,246,2107,267,127,140
3190,2473,362,1191,246,2111,267,127,140
3195,2477,362,1191,246,2115,267,127,140
3200,2480,362,1193,246,2118,267,127,140
3205,2481,362,1193,246,2119,267,127,140
3210,2486,363,1195,247,2123,267,127,140
3215,2488,363,1196,247,2125,268,127,141
3220,2496,364,1200,248,2132,269,127,142
3225,2499,365,1203,249,2134,269,127,142
3230,2504,367,1205,250,2137,270,128,142
3235,2508,367,1208,250,2141,270,128,142
3240,2511,368,1210,251,2143,270,128,142
3245,2512,368,1210,251,2144,270,128,142
3250,2517,369,1214,252,2148,270,128,142
3255,2519,369,1215,252,2150,271,129,142
3260,2527,370,1216,252,2157,271,129,142
3265,2530,370,1217,252,2160,271,129,142
3270,2535,371,1220,252,2164,271,129,142
3275,2539,371,1221,252,2168,271,129,142
3280,2542,371,1221,252,2171,271,129,142
3285,2543,372,1222,253,2171,271,129,142
3290,2548,374,1224,255,2174,272,129,143
3295,2550,374,1225,255,2176,273,130,143
3300,2558,376,1230,257,2182,274,131,143
3305,2561,376,1232,257,2185,274,131,143
3310,2566,377,1236,257,2189,275,132,143
3315,2570,377,1239,257,2193,275,132,143
3320,2573,377,1239,257,2196,275,132,143
3325,2574,377,1239,257,2197,275,132,143
3330,2579,378,1242,258,2201,275,132,143
3335,2581,378,1244,258,2203,276,133,143
3340,2589,379,1248,259,2210,276,133,143
3345,2592,379,1248,259,2213,276,133,143
3350,2597,380,1251,260,2217,276,133,143
3355,2601,380,1253,260,2219,276,133,143
3360,2604,381,1253,261,2223,276,133,143
3365,2605,381,1253,261,2224,276,133,143
3370,2610,382,1256,262,2228,276,133,143
3375,2612,382,1257,262,2230,277,133,144
3380,2620,383,1263,263,2237,278,134,144
3385,2623,383,1264,263,2240,278,134,144
3390,2628,385,1267,264,2243,278,134,144
3395,2632,385,1270,264,2246,278,134,144
3400,2635,386,1272,265,2249,278,134,144
3405,2636,386,1272,265,2250,278,134,144
3410,2641,387,1273,265,2254,279,134,145
3415,2643,387,1275,265,2255,280,135,145
3420,2651,390,1280,268,2260,282,136,146
3425,2654,391,1282,269,2263,282,136,146
3430,2659,392,1282,269,2267,282,136,146
3435,2663,392,1282,269,2271,282,136,146
3440,2666,393,1284,270,2273,282,136,146
3445,2667,393,1284,270,2274,282,136,146
3450,2672,393,1287,270,2279,282,136,146
3455,2674,393,1289,270,2281,283,137,146
3460,2682,393,1290,270,2289,284,137,147
3465,2685,393,1293,270,2292,284,137,147
3470,2690,394,1293,270,2296,284,137,147
3475,2694,394,1296,270,2300,284,137,147
3480,2697,395,1297,271,2302,284,137,147
3485,2698,395,1297,271,2303,284,137,147
3490,2703,396,1300,272,2306,284,137,147
3495,2705,396,1302,272,2309,285,138,147
3500,2713,396,1303,272,2317,285,138,147
3505,2716,396,1304,272,2320,285,138,147
3510,2721,397,1308,273,2324,285,138,147
3515,2725,397,1310,273,2328,285,138,147
3520,2728,397,1310,273,2331,285,138,147
3525,2729,397,1310,273,2332,285,138,147
3530,2734,399,1313,275,2335,285,138,147
3535,2736,399,1315,275,2337,286,139,147
3540,2744,400,1319,276,2344,288,140,148
3545,2747,401,1322,277,2346,288,140,148
3550,2752,401,1323,277,2351,288,140,148
3555,2756,401,1323,277,2355,289,140,149
3560,2759,401,1326,277,2358,289,140,149
3565,2760,401,1326,277,2359,289,140,149
3570,2765,402,1328,278,2363,290,140,150
3575,2767,402,1329,278,2365,291,140,151
3580,2775,404,1334,279,2370,293,142,151
3585,2778,405,1336,280,2373,293,142,151
3590,2783,405,1339,280,2378,293,142,151
3595,2787,405,1342,280,2381,294,143,151
3600,2790,406,1344,281,2384,294,143,151
3605,2791,406,1344,281,2385,294,143,151
3610,2796,407,1348,282,2389,294,143,151
3615,2798,407,1349,282,2391,295,144,151
3620,2806,408,1352,283,2398,295,144,151
3625,2809,408,1353,283,2401,295,144,151
3630,2814,408,1355,283,2406,295,144,151
3635,2818,408,1357,283,2409,295,144,151
3640,2821,409,1359,284,2412,295,144,151
3645,2822,409,1359,284,2413,295,144,151
3650,2827,410,1362,284,2417,295,144,151
3655,2829,410,1363,284,2419,296,145,151
3660,2837,411,1367,284,2425,297,145,152
3665,2840,412,1368,285,2428,297,145,152
3670,2845,413,1371,285,2432,297,145,152
3675,2849,413,1375,285,2435,297,145,152
3680,2852,415,1377,287,2437,297,145,152
3685,2853,415,1377,287,2438,297,145,152
3690,2858,416,1378,287,2442,297,145,152
3695,2860,416,1380,287,2444,298,146,152
3700,2868,417,1382,287,2451,299,146,153
3705,2871,417,1383,287,2454,299,146,153
3710,2876,418,1387,288,2458,299,146,153
3715,2880,418,1391,288,2461,299,146,153
3720,2883,419,1391,289,2464,299,146,153
3725,2884,419,1391,289,2465,299,146,153
3730,2889,419,1393,289,2470,299,146,153
3735,2891,419,1395,289,2472,300,147,153
3740,2899,421,1399,290,2478,301,147,154
3745,2902,421,1401,290,2481,301,147,154
3750,2907,421,1402,290,2486,301,147,154
3755,2911,421,1404,290,2490,301,147,154
3760,2914,421,1405,290,2493,301,147,154
3765,2915,421,1405,290,2494,301,147,154
3770,2920,421,1408,290,2499,301,147,154
3775,2922,421,1408,290,2501,302,147,155
3780,2930,422,1413,291,2508,304,148,156
3785,2933,422,1414,291,2511,304,148,156
3790,2938,422,1415,291,2516,304,148,156
3795,2942,422,1415,291,2520,305,148,157
3800,2945,422,1416,291,2523,305,148,157
3805,2946,422,1417,291,2524,305,148,157
3810,2951,422,1421,291,2529,306,148,158
3815,2953,422,1421,291,2531,307,148,159
3820,2961,422,1424,291,2539,308,148,160
3825,2964,422,1426,291,2542,308,148,160
3830,2969,423,1429,291,2546,308,148,160
3835,2973,423,1432,291,2549,308,148,160
3840,2976,425,1434,293,2551,308,148,160
3845,2977,425,1434,293,2552,308,148,160
3850,2982,426,1437,294,2556,308,148,160
3855,2984,426,1437,294,2558,309,148,161
3860,2992,426,1443,294,2566,309,148,161
3865,2995,426,1444,294,2569,309,148,161
3870,3000,427,1447,295,2573,309,148,161
3875,3004,427,1450,295,2577,309,148,161
3880,3007,427,1451,295,2580,309,148,161
3885,3008,427,1451,295,2581,309,148,161
3890,3013,428,1454,296,2585,309,148,161
3895,3015,428,1454,296,2587,310,148,162
3900,3023,429,1458,296,2594,311,148,163
3905,3026,429,1458,296,2597,311,148,163
3910,3031,430,1458,296,2601,311,148,163
3915,3035,430,1461,296,2605,311,148,163
3920,3038,430,1461,296,2608,311,148,163
3925,3039,430,1461,296,2609,311,148,163
3930,3044,431,1463,296,2613,311,148,163
3935,3046,431,1463,296,2615,312,148,164
3940,3054,432,1466,297,2622,313,148,165
3945,3057,432,1468,297,2625,313,148,165
3950,3062,433,1471,298,2629,313,148,165
3955,3066,433,1472,298,2633,313,148,165
3960,3069,433,1473,298,2636,313,148,165
3965,3070,433,1473,298,2637,313,148,165
3970,3075,434,1475,299,2641,313,148,165
3975,3077,434,1476,299,2643,314,148,166
3980,3085,435,1478,300,2650,314,148,166
3985,3088,435,1480,300,2653,314,148,166
3990,3093,436,1484,301,2657,314,148,166
3995,3097,436,1486,301,2661,314,148,166
4000,3100,436,1487,301,2664,314,148,166
4005,3101,436,1488,301,2665,314,148,166
4010,3106,437,1490,301,2669,314,148,166
4015,3108,437,1490,301,2671,315,148,167
4020,3116,439,1497,303,2677,316,149,167
4025,3119,440,1499,304,2679,316,149,167
4030,3124,440,1501,304,2684,317,150,167
4035,3128,440,1501,304,2688,317,150,167
4040,3131,440,1503,304,2691,317,150,167
4045,3132,440,1504,304,2692,317,150,167
4050,3137,441,1505,305,2696,317,150,167
4055,3139,441,1507,305,2698,318,151,167
4060,3147,442,1510,305,2705,319,152,167
4065,3150,442,1510,305,2708,319,152,167
4070,3155,442,1511,305,2713,319,152,167
4075,3159,442,1512,305,2717,320,152,168
4080,3162,443,1514,306,2719,320,152,168
4085,3163,443,1514,306,2720,320,152,168
4090,3168,444,1517,307,2724,320,152,168
4095,3170,444,1517,307,2726,321,152,169
4100,3178,445,1518,307,2733,321,152,169
4105,3181,445,1521,307,2736,321,152,169
4110,3186,445,1524,307,2741,321,152,169
4115,3190,445,1526,307,2745,321,152,169
4120,3193,445,1527,307,2748,321,152,169
4125,3194,445,1528,307,2749,321,152,169
4130,3199,446,1530,307,2753,321,152,169
4135,3201,446,1530,307,2755,322,152,170
4140,3209,447,1532,307,2762,322,152,170
4145,3212,447,1535,307,2765,322,152,170
4150,3217,447,1537,307,2770,322,152,170
4155,3221,447,1540,307,2773,322,152,170
4160,3224,448,1541,308,2776,322,152,170
4165,3225,448,1542,308,2777,322,152,170
4170,3230,449,1546,309,2781,322,152,170
4175,3232,449,1547,309,2783,323,153,170
4180,3240,450,1551,309,2790,323,153,170
4185,3243,450,1553,309,2793,323,153,170
4190,3248,451,1557,310,2797,323,153,170
4195,3252,451,1559,310,2801,324,153,171
4200,3255,452,1561,311,2803,324,153,171
4205,3256,452,1562,311,2804,324,153,171
4210,3261,453,1565,312,2808,325,153,172
4215,3263,453,1565,312,2810,326,153,173
4220,3271,454,1570,312,2817,326,153,173
4225,3274,454,1572,312,2820,326,153,173
4230,3279,455,1573,312,2824,326,153,173
4235,3283,455,1576,312,2828,326,153,173
4240,3286,455,1577,312,2831,326,153,173
4245,3287,455,1577,312,2832,326,153,173
4250,3292,456,1579,313,2836,326,153,173
4255,3294,456,1581,313,2838,327,154,173
4260,3302,458,1584,314,2844,328,154,174
4265,3305,459,1587,315,2846,328,154,174
4270,3310,460,1590,315,2850,328,154,174
4275,3314,460,1594,315,2854,329,155,174
4280,3317,460,1595,315,2857,329,155,174
4285,3318,460,1595,315,2858,329,155,174
4290,3323,461,1599,316,2862,329,155,174
4295,3325,461,1601,316,2864,330,156,174
4300,3333,462,1605,317,2871,331,157,174
4305,3336,463,1607,318,2873,331,157,174
4310,3341,464,1609,319,2877,331,157,174
4315,3345,464,1612,319,2881,332,157,175
4320,3348,465,1613,320,2883,332,157,175
4325,3349,465,1613,320,2884,332,157,175
4330,3354,466,1616,320,2888,332,157,175
4335,3356,466,1618,320,2890,333,158,175
4340,3364,468,1623,322,2895,335,160,175
4345,3367,469,1624,323,2898,335,160,175
4350,3372,470,1628,324,2902,335,160,175
4355,3376,470,1632,324,2906,335,160,175
4360,3379,471,1635,325,2908,335,160,175
4365,3380,471,1636,325,2909,335,160,175
4370,3385,472,1641,326,2913,336,161,175
4375,3387,472,1642,326,2915,337,161,176
4380,3395,473,1646,327,2921,339,163,176
4385,3398,474,1648,328,2924,339,163,176
4390,3403,474,1651,328,2929,339,163,176
4395,3407,474,1654,328,2932,339,163,176
4400,3410,475,1655,329,2935,339,163,176
4405,3411,475,1655,329,2936,339,163,176
4410,3416,476,1658,330,2940,340,163,177
4415,3418,476,1659,330,2942,341,164,177
4420,3426,476,1663,330,2950,341,164,177
4425,3429,476,1665,330,2953,341,164,177
4430,3434,476,1667,330,2958,341,164,177
4435,3438,476,1669,330,2961,341,164,177
4440,3441,477,1669,331,2964,341,164,177
4445,3442,477,1669,331,2965,341,164,177
4450,3447,478,1672,332,2969,341,164,177
4455,3449,478,1673,332,2971,342,164,178
4460,3457,479,1676,332,2978,342,164,178
4465,3460,479,1677,332,2981,342,164,178
4470,3465,480,1678,332,2985,342,164,178
4475,3469,480,1679,332,2989,342,164,178
4480,3472,480,1680,332,2992,342,164,178
4485,3473,480,1681,332,2993,342,164,178
4490,3478,481,1683,333,2997,342,164,178
4495,3480,481,1685,333,2999,343,165,178
4500,3488,483,1689,335,3004,344,165,179
4505,3491,484,1689,336,3007,344,165,179
4510,3496,484,1691,336,3012,344,165,179
4515,3500,484,1692,336,3016,345,166,179
4520,3503,484,1694,336,3019,345,166,179
4525,3504,484,1695,336,3020,345,166,179
4530,3509,484,1695,336,3025,346,166,180
4535,3511,484,1696,336,3027,347,167,180
4540,3519,485,1701,336,3034,347,167,180
4545,3522,485,1703,336,3037,347,167,180
4550,3527,485,1705,336,3042,347,167,180
4555,3531,485,1705,336,3046,348,167,181
4560,3534,485,1705,336,3049,348,167,181
4565,3535,485,1705,336,3050,348,167,181
4570,3540,485,1708,336,3055,348,167,181
4575,3542,485,1710,336,3057,349,168,181
4580,3550,486,1713,337,3064,350,168,182
4585,3553,486,1714,337,3067,350,168,182
4590,3558,486,1714,337,3072,350,168,182
4595,3562,486,1715,337,3076,350,168,182
4600,3565,486,1717,337,3079,350,168,182
4605,3566,486,1717,337,3080,350,168,182
4610,3571,486,1719,337,3085,350,168,182
4615,3573,486,1720,337,3087,351,168,183
4620,3581,487,1723,337,3094,353,169,184
4625,3584,487,1725,337,3097,353,169,184
4630,3589,488,1727,337,3101,353,169,184
4635,3593,488,1728,337,3104,353,169,184
4640,3596,489,1729,338,3107,353,169,184
4645,3597,489,1729,338,3108,353,169,184
4650,3602,489,1732,338,3113,353,169,184
4655,3604,489,1733,338,3115,354,169,185
4660,3612,490,1737,338,3122,354,169,185
4665,3615,490,1738,338,3125,354,169,185
4670,3620,491,1739,338,3129,354,169,185
4675,3624,491,1742,338,3132,355,169,186
4680,3627,492,1743,339,3135,355,169,186
4685,3628,492,1744,339,3136,355,169,186
4690,3633,493,1746,339,3140,356,170,186
4695,3635,493,1747,339,3142,357,171,186
4700,3643,495,1751,341,3147,358,171,187
4705,3646,496,1753,342,3150,358,171,187
4710,3651,497,1755,342,3154,358,171,187
4715,3655,497,1757,342,3158,358,171,187
4720,3658,497,1759,342,3161,358,171,187
4725,3659,497,1760,342,3162,358,171,187
4730,3664,498,1762,342,3166,358,171,187
4735,3666,498,1763,342,3168,359,171,188
4740,3674,501,1767,344,3173,361,172,189
4745,3677,501,1770,344,3176,361,172,189
4750,3682,502,1772,344,3180,361,172,189
4755,3686,502,1774,344,3184,361,172,189
4760,3689,503,1775,345,3186,361,172,189
4765,3690,503,1775,345,3187,361,172,189
4770,3695,504,1777,346,3191,361,172,189
4775,3697,504,1778,346,3193,362,173,189
4780,3705,504,1781,346,3201,362,173,189
4785,3708,504,1782,346,3204,362,173,189
4790,3713,505,1786,347,3208,362,173,189
4795,3717,505,1787,347,3212,362,173,189
4800,3720,506,1788,348,3214,362,173,189
4805,3721,506,1789,348,3215,362,173,189
4810,3726,507,1792,349,3219,362,173,189
4815,3728,507,1793,349,3221,363,173,190
4820,3736,507,1797,349,3229,363,173,190
4825,3739,507,1799,349,3232,363,173,190
4830,3744,507,1800,349,3237,363,173,190
4835,3748,507,1801,349,3241,363,173,190
4840,3751,507,1802,349,3244,363,173,190
4845,3752,507,1802,349,3245,363,173,190
4850,3757,508,1805,350,3249,364,174,190
4855,3759,508,1805,350,3251,365,174,191
4860,3767,509,1809,351,3257,367,175,192
4865,3770,510,1811,352,3260,367,175,192
4870,3775,510,1812,352,3265,367,175,192
4875,3779,510,1815,352,3268,367,175,192
4880,3782,511,1817,353,3271,367,175,192
4885,3783,511,1817,353,3272,367,175,192
4890,3788,512,1818,353,3276,367,175,192
4895,3790,512,1819,353,3278,368,176,192
4900,3798,512,1823,353,3286,368,176,192
4905,3801,512,1824,353,3289,368,176,192
4910,3806,513,1828,354,3293,368,176,192
4915,3810,513,1832,354,3296,368,176,192
4920,3813,514,1833,355,3299,368,176,192
4925,3814,514,1833,355,3300,368,176,192
4930,3819,515,1835,356,3304,368,176,192
4935,3821,515,1836,356,3306,369,176,193
4940,3829,516,1842,356,3313,371,178,193
4945,3832,516,1843,356,3316,371,178,193
4950,3837,518,1846,357,3319,371,178,193
4955,3841,518,1849,357,3322,371,178,193
4960,3844,520,1851,359,3324,371,178,193
4965,3845,520,1851,359,3325,371,178,193
4970,3850,522,1856,361,3328,371,178,193
4975,3852,522,1856,361,3330,372,178,194
4980,3860,524,1862,362,3336,374,180,194
4985,3863,524,1864,362,3339,374,180,194
4990,3868,525,1867,363,3343,374,180,194
4995,3872,525,1868,363,3347,374,180,194
5000,3875,526,1871,364,3349,374,180,194
5005,3876,526,1872,364,3350,374,180,194
5010,3881,527,1875,365,3354,375,180,195
5015,3883,527,1877,365,3356,376,181,195
5020,3891,528,1880,366,3363,376,181,195
5025,3894,528,1883,366,3366,376,181,195
5030,3899,529,1883,366,3370,376,181,195
5035,3903,529,1884,366,3374,376,181,195
5040,3906,530,1886,367,3376,376,181,195
5045,3907,530,1886,367,3377,376,181,195
5050,3912,531,1889,368,3381,376,181,195
5055,3914,531,1890,368,3383,377,182,195
5060,3922,533,1894,369,3389,378,182,196
5065,3925,533,1894,369,3392,378,182,196
5070,3930,534,1894,369,3396,378,182,196
5075,3934,534,1895,369,3400,378,182,196
5080,3937,534,1897,369,3403,378,182,196
5085,3938,534,1898,369,3404,378,182,196
5090,3943,535,1899,370,3408,378,182,196
5095,3945,535,1900,370,3410,379,182,197
5100,3953,537,1906,372,3415,381,183,198
5105,3956,538,1908,373,3418,381,183,198
5110,3961,539,1911,373,3422,381,183,198
5115,3965,539,1914,373,3425,381,183,198
5120,3968,540,1914,374,3428,381,183,198
5125,3969,541,1915,375,3428,381,183,198
5130,3974,542,1916,375,3432,381,183,198
5135,3976,542,1918,375,3434,382,184,198
5140,3984,542,1921,375,3442,384,185,199
5145,3987,542,1923,375,3445,384,185,199
5150,3992,543,1925,375,3449,384,185,199
5155,3996,543,1926,375,3453,384,185,199
5160,3999,545,1928,377,3454,384,185,199
5165,4000,545,1929,377,3455,384,185,199
5170,4005,546,1934,378,3459,385,186,199
5175,4007,546,1935,378,3461,386,187,199
5180,4015,547,1938,379,3468,386,187,199
5185,4018,547,1940,379,3471,386,187,199
5190,4023,548,1943,380,3475,386,187,199
5195,4027,548,1946,380,3478,386,187,199
5200,4030,550,1948,382,3480,386,187,199
5205,4031,550,1948,382,3481,386,187,199
5210,4036,551,1951,383,3485,386,187,199
5215,4038,551,1953,383,3487,387,188,199
5220,4046,554,1956,386,3492,388,188,200
5225,4049,554,1959,386,3495,388,188,200
5230,4054,554,1961,386,3500,388,188,200
5235,4058,554,1961,386,3504,388,188,200
5240,4061,554,1962,386,3507,388,188,200
5245,4062,554,1963,386,3508,388,188,200
5250,4067,555,1965,386,3512,388,188,200
5255,4069,555,1966,386,3514,389,189,200
5260,4077,555,1971,386,3522,389,189,200
5265,4080,555,1973,386,3525,389,189,200
5270,4085,555,1976,386,3530,389,189,200
5275,4089,555,1976,386,3534,389,189,200
5280,4092,555,1976,386,3537,389,189,200
5285,4093,555,1976,386,3538,389,189,200
5290,4098,556,1979,387,3542,390,190,200
5295,4100,556,1980,387,3544,391,190,201
5300,4108,557,1982,387,3551,392,190,202
5305,4111,558,1984,388,3553,392,190,202
5310,4116,558,1988,388,3558,392,190,202
5315,4120,558,1990,388,3561,392,190,202
5320,4123,559,1992,389,3564,392,190,202
5325,4124,559,1992,389,3565,392,190,202
5330,4129,560,1995,389,3569,392,190,202
5335,4131,560,1996,389,3571,393,191,202
5340,4139,561,2001,390,3578,394,192,202
5345,4142,561,2003,390,3581,394,192,202
5350,4147,562,2004,390,3585,395,193,202
5355,4151,562,2005,390,3589,395,193,202
5360,4154,563,2007,391,3591,395,193,202
5365,4155,563,2007,391,3592,395,193,202
5370,4160,564,2009,391,3596,395,193,202
5375,4162,564,2009,391,3598,396,193,203
5380,4170,565,2012,392,3605,396,193,203
5385,4173,565,2015,392,3608,396,193,203
5390,4178,566,2017,393,3612,397,193,204
5395,4182,566,2019,393,3616,397,193,204
5400,4185,567,2021,394,3618,397,193,204
5405,4186,567,2021,394,3619,397,193,204
5410,4191,568,2025,395,3623,398,194,204
5415,4193,568,2026,395,3625,399,195,204
5420,4201,569,2031,396,3632,399,195,204
5425,4204,569,2032,396,3635,399,195,204
5430,4209,570,2035,396,3639,399,195,204
5435,4213,570,2036,396,3643,399,195,204
5440,4216,571,2037,397,3645,399,195,204
5445,4217,571,2038,397,3646,399,195,204
5450,4222,572,2039,397,3650,399,195,204
5455,4224,572,2040,397,3652,400,196,204
5460,4232,574,2043,398,3657,401,196,205
5465,4235,575,2045,399,3660,401,196,205
5470,4240,575,2047,399,3665,401,196,205
5475,4244,575,2050,399,3668,401,196,205
5480,4247,576,2052,400,3671,401,196,205
5485,4248,576,2053,400,3672,401,196,205
5490,4253,577,2055,400,3676,401,196,205
5495,4255,577,2056,400,3678,402,196,206
5500,4263,578,2059,401,3685,403,196,207
5505,4266,578,2061,401,3688,403,196,207
5510,4271,578,2062,401,3693,403,196,207
5515,4275,578,2066,401,3696,403,196,207
5520,4278,579,2067,402,3699,403,196,207
5525,4279,579,2067,402,3700,403,196,207
5530,4284,579,2070,402,3705,404,196,208
5535,4286,579,2071,402,3707,405,196,209
5540,4294,580,2073,402,3714,405,196,209
5545,4297,580,2074,402,3717,405,196,209
5550,4302,581,2078,403,3721,406,197,209
5555,4306,581,2082,403,3724,406,197,209
5560,4309,582,2083,404,3727,406,197,209
5565,4310,582,2084,404,3728,406,197,209
5570,4315,582,2086,404,3733,407,198,209
5575,4317,582,2087,404,3735,408,198,210
5580,4325,584,2092,405,3741,409,199,210
5585,4328,585,2095,406,3743,409,199,210
5590,4333,585,2099,406,3748,409,199,210
5595,4337,585,2100,406,3752,409,199,210
5600,4340,585,2101,406,3755,409,199,210
5605,4341,585,2102,406,3756,409,199,210
5610,4346,585,2105,406,3761,409,199,210
5615,4348,585,2105,406,3763,410,199,211
5620,4356,587,2110,407,3769,411,199,212
5625,4359,587,2111,407,3772,411,199,212
5630,4364,587,2113,407,3777,411,199,212
5635,4368,587,2115,407,3780,411,199,212
5640,4371,589,2117,409,3782,411,199,212
5645,4372,589,2118,409,3783,411,199,212
5650,4377,590,2121,409,3787,411,199,212
5655,4379,590,2123,409,3789,412,200,212
5660,4387,591,2125,409,3796,412,200,212
5665,4390,591,2126,409,3799,412,200,212
5670,4395,591,2128,409,3804,413,201,212
5675,4399,591,2130,409,3808,413,201,212
5680,4402,591,2131,409,3811,413,201,212
5685,4403,591,2132,409,3812,413,201,212
5690,4408,592,2136,410,3816,413,201,212
5695,4410,592,2137,410,3818,414,201,213
5700,4418,593,2142,411,3825,414,201,213
5705,4421,593,2143,411,3828,414,201,213
5710,4426,594,2144,411,3832,414,201,213
5715,4430,594,2144,411,3836,414,201,213
5720,4433,595,2145,412,3838,414,201,213
5725,4434,595,2146,412,3839,414,201,213
5730,4439,596,2148,412,3843,415,201,214
5735,4441,596,2149,412,3845,416,201,215
5740,4449,597,2154,413,3852,416,201,215
5745,4452,597,2157,413,3855,416,201,215
5750,4457,598,2160,414,3859,416,201,215
5755,4461,598,2162,414,3862,416,201,215
5760,4464,600,2164,416,3864,416,201,215
5765,4465,600,2164,416,3865,416,201,215
5770,4470,600,2166,416,3870,416,201,215
5775,4472,600,2166,416,3872,417,201,216
5780,4480,601,2170,417,3879,417,201,216
5785,4483,601,2170,417,3882,417,201,216
5790,4488,602,2173,417,3886,417,201,216
5795,4492,602,2177,417,3890,417,201,216
5800,4495,603,2178,418,3892,417,201,216
5805,4496,603,2179,418,3893,417,201,216
5810,4501,603,2181,418,3898,417,201,216
5815,4503,603,2182,418,3900,418,201,217
5820,4511,604,2188,418,3907,419,202,217
5825,4514,605,2189,419,3909,419,202,217
5830,4519,606,2191,420,3913,419,202,217
5835,4523,606,2194,420,3917,419,202,217
5840,4526,607,2196,421,3919,419,202,217
5845,4527,607,2196,421,3920,419,202,217
5850,4532,607,2198,421,3925,419,202,217
5855,4534,607,2199,421,3927,420,203,217
5860,4542,608,2203,422,3934,421,203,218
5865,4545,609,2204,423,3936,421,203,218
5870,4550,610,2207,424,3940,421,203,218
5875,4554,610,2211,424,3943,421,203,218
5880,4557,612,2213,426,3945,421,203,218
5885,4558,612,2214,426,3946,421,203,218
5890,4563,612,2216,426,3951,421,203,218
5895,4565,612,2217,426,3953,422,203,219
5900,4573,612,2222,426,3961,422,203,219
5905,4576,612,2223,426,3964,422,203,219
5910,4581,612,2225,426,3969,422,203,219
5915,4585,612,2227,426,3973,422,203,219
5920,4588,612,2228,426,3976,422,203,219
5925,4589,612,2229,426,3977,422,203,219
5930,4594,612,2230,426,3982,422,203,219
5935,4596,612,2231,426,3984,423,203,220
5940,4604,612,2235,426,3992,423,203,220
5945,4607,612,2236,426,3995,423,203,220
5950,4612,612,2238,426,4000,423,203,220
5955,4616,612,2238,426,4004,423,203,220
5960,4619,612,2241,426,4007,423,203,220
5965,4620,612,2242,426,4008,423,203,220
5970,4625,612,2243,426,4013,423,203,220
5975,4627,612,2244,426,4015,424,203,221
5980,4635,612,2249,426,4023,424,203,221
5985,4638,612,2249,426,4026,424,203,221
5990,4643,612,2254,426,4031,425,204,221
5995,4647,612,2255,426,4035,425,204,221
6000,4650,613,2257,427,4037,425,204,221
6005,4651,613,2257,427,4038,425,204,221
6010,4656,614,2260,427,4042,425,204,221
6015,4658,614,2261,427,4044,426,204,222
6020,4666,615,2263,428,4051,427,205,222
6025,4669,615,2264,428,4054,427,205,222
6030,4674,616,2266,429,4058,427,205,222
6035,4678,616,2268,429,4062,427,205,222
6040,4681,616,2269,429,4065,427,205,222
6045,4682,616,2269,429,4066,427,205,222
6050,4687,617,2272,430,4070,428,205,223
6055,4689,617,2274,430,4072,429,206,223
6060,4697,619,2278,431,4078,430,206,224
6065,4700,620,2280,432,4080,430,206,224
6070,4705,621,2280,432,4084,430,206,224
6075,4709,621,2282,432,4088,430,206,224
6080,4712,621,2285,432,4091,430,206,224
6085,4713,621,2285,432,4092,430,206,224
6090,4718,622,2288,432,4096,430,206,224
6095,4720,622,2289,432,4098,431,207,224
6100,4728,623,2295,433,4105,431,207,224
6105,4731,623,2296,433,4108,431,207,224
6110,4736,624,2297,433,4112,431,207,224
6115,4740,624,2300,433,4115,431,207,224
6120,4743,627,2302,436,4116,431,207,224
6125,4744,627,2303,436,4117,431,207,224
6130,4749,627,2305,436,4122,431,207,224
6135,4751,627,2307,436,4124,432,208,224
6140,4759,627,2309,436,4132,432,208,224
6145,4762,627,2310,436,4135,432,208,224
6150,4767,628,2312,437,4139,432,208,224
6155,4771,628,2313,437,4143,432,208,224
6160,4774,629,2315,438,4145,432,208,224
6165,4775,629,2315,438,4146,432,208,224
6170,4780,629,2320,438,4151,433,209,224
6175,4782,629,2321,438,4153,434,210,224
6180,4790,629,2325,438,4161,434,210,224
6185,4793,629,2326,438,4164,434,210,224
6190,4798,629,2328,438,4169,434,210,224
6195,4802,629,2329,438,4173,434,210,224
6200,4805,629,2329,438,4176,434,210,224
6205,4806,629,2330,438,4177,434,210,224
6210,4811,629,2334,438,4182,435,211,224
6215,4813,629,2336,438,4184,436,212,224
6220,4821,629,2339,438,4192,436,212,224
6225,4824,629,2339,438,4195,436,212,224
6230,4829,629,2342,438,4200,437,213,224
6235,4833,629,2345,438,4203,437,213,224
6240,4836,631,2346,440,4205,437,213,224
6245,4837,631,2347,440,4206,437,213,224
6250,4842,631,2350,440,4211,437,213,224
6255,4844,631,2350,440,4213,438,213,225
6260,4852,632,2355,440,4220,438,213,225
6265,4855,632,2356,440,4223,438,213,225
6270,4860,632,2357,440,4228,438,213,225
6275,4864,632,2360,440,4232,438,213,225
6280,4867,632,2361,440,4235,438,213,225
6285,4868,632,2361,440,4236,438,213,225
6290,4873,632,2362,440,4241,438,213,225
6295,4875,632,2362,440,4243,439,213,226
6300,4883,633,2364,440,4250,439,213,226
6305,4886,633,2367,440,4253,439,213,226
6310,4891,634,2371,441,4257,439,213,226
6315,4895,634,2372,441,4261,439,213,226
6320,4898,634,2373,441,4264,439,213,226
6325,4899,634,2374,441,4265,439,213,226
6330,4904,634,2377,441,4270,440,213,227
6335,4906,634,2377,441,4272,441,213,228
6340,4914,636,2382,443,4278,442,214,228
6345,4917,636,2384,443,4281,442,214,228
6350,4922,637,2387,444,4285,442,214,228
6355,4926,637,2389,444,4288,442,214,228
6360,4929,639,2390,446,4290,442,214,228
6365,4930,639,2391,446,4291,442,214,228
6370,4935,640,2395,447,4295,442,214,228
6375,4937,640,2397,447,4297,443,215,228
6380,4945,641,2402,448,4304,444,215,229
6385,4948,641,2402,448,4307,444,215,229
6390,4953,642,2403,448,4311,444,215,229
6395,4957,642,2404,448,4315,444,215,229
6400,4960,642,2404,448,4318,444,215,229
6405,4961,642,2405,448,4319,444,215,229
6410,4966,643,2408,448,4323,444,215,229
6415,4968,643,2409,448,4325,445,215,230
6420,4976,644,2412,448,4332,446,215,231
6425,4979,644,2412,448,4335,446,215,231
6430,4984,645,2415,448,4339,446,215,231
6435,4988,645,2417,448,4343,446,215,231
6440,4991,645,2419,448,4346,446,215,231
6445,4992,645,2420,448,4347,446,215,231
6450,4997,646,2423,448,4351,446,215,231
6455,4999,646,2425,448,4353,447,216,231
6460,5007,647,2429,449,4360,448,216,232
6465,5010,648,2432,450,4362,448,216,232
6470,5015,649,2435,451,4366,449,217,232
6475,5019,649,2438,451,4369,449,217,232
6480,5022,652,2440,454,4370,449,217,232
6485,5023,652,2440,454,4371,449,217,232
6490,5028,653,2442,455,4375,450,218,232
6495,5030,653,2443,455,4377,451,219,232
6500,5038,655,2448,456,4383,451,219,232
6505,5041,655,2449,456,4386,451,219,232
6510,5046,656,2450,456,4390,451,219,232
6515,5050,656,2452,456,4394,451,219,232
6520,5053,656,2454,456,4397,451,219,232
6525,5054,656,2455,456,4398,451,219,232
6530,5059,657,2459,457,4402,452,220,232
6535,5061,657,2459,457,4404,453,220,233
6540,5069,658,2463,458,4411,453,220,233
6545,5072,658,2465,458,4414,453,220,233
6550,5077,659,2468,459,4418,453,220,233
6555,5081,659,2469,459,4422,453,220,233
6560,5084,659,2470,459,4425,453,220,233
6565,5085,659,2471,459,4426,453,220,233
6570,5090,660,2473,459,4430,453,220,233
6575,5092,660,2473,459,4432,454,220,234
6580,5100,662,2476,460,4438,454,220,234
6585,5103,662,2478,460,4441,454,220,234
6590,5108,663,2481,461,4445,455,220,235
6595,5112,663,2483,461,4448,455,220,235
6600,5115,664,2484,462,4451,455,220,235
6605,5116,665,2485,463,4451,455,220,235
6610,5121,666,2488,464,4455,455,220,235
6615,5123,666,2489,464,4457,456,221,235
6620,5131,666,2492,464,4465,458,221,237
6625,5134,666,2494,464,4468,458,221,237
6630,5139,667,2497,464,4472,458,221,237
6635,5143,667,2500,464,4475,458,221,237
6640,5146,669,2502,466,4477,458,221,237
6645,5147,669,2502,466,4478,458,221,237
6650,5152,670,2505,467,4482,458,221,237
6655,5154,670,2506,467,4484,459,221,238
6660,5162,670,2509,467,4492,461,223,238
6665,5165,670,2512,467,4495,461,223,238
6670,5170,671,2514,468,4499,461,223,238
6675,5174,671,2518,468,4503,461,223,238
6680,5177,672,2521,469,4505,461,223,238
6685,5178,672,2521,469,4506,461,223,238
6690,5183,673,2524,470,4510,461,223,238
6695,5185,673,2525,470,4512,462,223,239
6700,5193,673,2528,470,4520,463,224,239
6705,5196,673,2530,470,4523,463,224,239
6710,5201,674,2534,471,4527,463,224,239
6715,5205,674,2534,471,4531,463,224,239
6720,5208,675,2535,472,4533,463,224,239
6725,5209,675,2536,472,4534,463,224,239
6730,5214,676,2539,473,4538,463,224,239
6735,5216,676,2540,473,4540,464,224,240
6740,5224,678,2543,474,4546,464,224,240
6745,5227,678,2544,474,4549,464,224,240
6750,5232,679,2545,474,4553,464,224,240
6755,5236,679,2548,474,4557,464,224,240
6760,5239,679,2549,474,4560,464,224,240
6765,5240,679,2549,474,4561,464,224,240
6770,5245,680,2551,474,4565,465,225,240
6775,5247,680,2553,474,4567,466,226,240
6780,5255,682,2558,475,4573,467,227,240
6785,5258,682,2559,475,4576,467,227,240
6790,5263,683,2562,476,4580,467,227,240
6795,5267,683,2565,476,4583,467,227,240
6800,5270,684,2566,477,4586,467,227,240
6805,5271,684,2567,477,4587,467,227,240
6810,5276,685,2570,478,4591,467,227,240
6815,5278,685,2572,478,4593,468,228,240
6820,5286,686,2573,478,4600,468,228,240
6825,5289,686,2575,478,4603,468,228,240
6830,5294,687,2578,479,4607,469,228,241
6835,5298,687,2580,479,4611,469,228,241
6840,5301,688,2582,480,4613,469,228,241
6845,5302,688,2583,480,4614,469,228,241
6850,5307,689,2584,480,4618,469,228,241
6855,5309,689,2585,480,4620,470,229,241
6860,5317,689,2589,480,4628,471,230,241
6865,5320,689,2590,480,4631,471,230,241
6870,5325,689,2594,480,4636,471,230,241
6875,5329,689,2596,480,4640,471,230,241
6880,5332,689,2599,480,4643,471,230,241
6885,5333,689,2599,480,4644,471,230,241
6890,5338,690,2602,481,4648,472,231,241
6895,5340,690,2603,481,4650,473,231,242
6900,5348,690,2606,481,4658,475,232,243
6905,5351,690,2607,481,4661,475,232,243
6910,5356,690,2609,481,4666,475,232,243
6915,5360,690,2611,481,4669,475,232,243
6920,5363,691,2612,482,4672,475,232,243
6925,5364,691,2612,482,4673,475,232,243
6930,5369,692,2614,483,4677,475,232,243
6935,5371,692,2614,483,4679,476,232,244
6940,5379,692,2616,483,4687,477,232,245
6945,5382,692,2618,483,4690,477,232,245
6950,5387,693,2619,483,4694,477,232,245
6955,5391,693,2621,483,4698,477,232,245
6960,5394,693,2623,483,4701,477,232,245
6965,5395,693,2623,483,4702,477,232,245
6970,5400,694,2625,483,4706,477,232,245
6975,5402,694,2626,483,4708,478,232,246
6980,5410,695,2629,484,4715,478,232,246
6985,5413,695,2629,484,4718,478,232,246
6990,5418,696,2633,485,4722,478,232,246
6995,5422,696,2635,485,4726,478,232,246
7000,5425,697,2637,486,4728,478,232,246
7005,5426,698,2638,487,4728,478,232,246
7010,5431,699,2640,488,4732,478,232,246
7015,5433,699,2640,488,4734,479,232,247
7020,5441,701,2644,489,4740,480,233,247
7025,5444,701,2647,489,4743,480,233,247
7030,5449,701,2650,489,4748,480,233,247
7035,5453,701,2650,489,4752,480,233,247
7040,5456,701,2651,489,4755,480,233,247
7045,5457,701,2652,489,4756,480,233,247
7050,5462,702,2654,490,4760,480,233,247
7055,5464,702,2654,490,4762,481,233,248
7060,5472,703,2657,491,4769,481,233,248
7065,5475,703,2657,491,4772,481,233,248
7070,5480,703,2660,491,4777,482,234,248
7075,5484,703,2662,491,4781,482,234,248
7080,5487,704,2664,492,4783,482,234,248
7085,5488,704,2664,492,4784,482,234,248
7090,5493,705,2667,493,4788,482,234,248
7095,5495,705,2668,493,4790,483,234,249
7100,5503,706,2672,493,4796,485,235,250
7105,5506,708,2673,495,4798,485,235,250
7110,5511,708,2675,495,4803,485,235,250
7115,5515,708,2676,495,4807,485,235,250
7120,5518,708,2676,495,4810,485,235,250
7125,5519,709,2677,496,4810,485,235,250
7130,5524,710,2680,496,4814,486,236,250
7135,5526,710,2681,496,4816,487,236,251
7140,5534,711,2683,496,4822,489,237,252
7145,5537,712,2686,497,4825,489,237,252
7150,5542,713,2689,498,4829,489,237,252
7155,5546,713,2691,498,4833,489,237,252
7160,5549,713,2691,498,4836,489,237,252
7165,5550,713,2692,498,4837,489,237,252
7170,5555,714,2693,498,4841,490,237,253
7175,5557,714,2695,498,4843,491,238,253
7180,5565,714,2697,498,4851,491,238,253
7185,5568,714,2699,498,4854,491,238,253
7190,5573,715,2702,499,4858,491,238,253
7195,5577,715,2706,499,4861,491,238,253
7200,5580,716,2708,500,4864,491,238,253
7205,5581,716,2708,500,4865,491,238,253
7210,5586,717,2709,501,4869,491,238,253
7215,5588,717,2709,501,4871,492,238,254
7220,5596,718,2711,502,4878,493,238,255
7225,5599,719,2714,503,4880,493,238,255
7230,5604,720,2716,504,4884,493,238,255
7235,5608,720,2717,504,4888,493,238,255
7240,5611,720,2718,504,4891,493,238,255
7245,5612,720,2718,504,4892,493,238,255
7250,5617,721,2722,505,4896,493,238,255
7255,5619,721,2723,505,4898,494,239,255
7260,5627,724,2729,507,4902,496,241,255
7265,5630,725,2731,508,4905,496,241,255
7270,5635,726,2733,508,4909,496,241,255
7275,5639,726,2734,508,4913,496,241,255
7280,5642,726,2734,508,4916,496,241,255
7285,5643,726,2734,508,4917,496,241,255
7290,5648,726,2736,508,4922,497,241,256
7295,5650,726,2737,508,4924,498,241,257
7300,5658,726,2741,508,4932,498,241,257
7305,5661,726,2742,508,4935,498,241,257
7310,5666,727,2745,509,4939,498,241,257
7315,5670,727,2746,509,4943,498,241,257
7320,5673,728,2748,510,4945,498,241,257
7325,5674,728,2749,510,4946,498,241,257
7330,5679,728,2751,510,4951,498,241,257
7335,5681,728,2751,510,4953,499,241,258
7340,5689,731,2756,512,4957,500,241,259
7345,5692,732,2756,513,4960,500,241,259
7350,5697,733,2757,513,4964,500,241,259
7355,5701,733,2759,513,4968,500,241,259
7360,5704,733,2760,513,4971,500,241,259
7365,5705,733,2760,513,4972,500,241,259
7370,5710,734,2762,513,4976,500,241,259
7375,5712,734,2764,513,4978,501,242,259
7380,5720,737,2768,515,4983,503,242,261
7385,5723,737,2768,515,4986,503,242,261
7390,5728,737,2770,515,4991,503,242,261
7395,5732,737,2774,515,4994,503,242,261
7400,5735,738,2774,516,4997,503,242,261
7405,5736,738,2775,516,4998,503,242,261
7410,5741,739,2777,516,5002,504,242,262
7415,5743,739,2778,516,5004,505,242,263
7420,5751,739,2781,516,5012,505,242,263
7425,5754,739,2782,516,5015,505,242,263
7430,5759,739,2783,516,5020,505,242,263
7435,5763,739,2786,516,5023,505,242,263
7440,5766,740,2787,517,5026,505,242,263
7445,5767,740,2788,517,5027,505,242,263
7450,5772,741,2792,518,5031,505,242,263
7455,5774,741,2792,518,5033,506,242,264
7460,5782,741,2796,518,5041,506,242,264
7465,5785,741,2799,518,5044,506,242,264
7470,5790,741,2801,518,5049,506,242,264
7475,5794,741,2802,518,5053,506,242,264
7480,5797,741,2803,518,5056,506,242,264
7485,5798,741,2803,518,5057,506,242,264
7490,5803,742,2808,519,5061,506,242,264
7495,5805,742,2808,519,5063,507,242,265
7500,5813,745,2812,522,5067,509,242,267
7505,5816,746,2814,523,5070,509,242,267
7510,5821,747,2816,523,5074,510,243,267
7515,5825,747,2819,523,5078,510,243,267
7520,5828,747,2821,523,5081,510,243,267
7525,5829,748,2822,524,5081,510,243,267
7530,5834,749,2823,524,5085,510,243,267
7535,5836,749,2824,524,5087,511,244,267
7540,5844,750,2829,525,5094,511,244,267
7545,5847,750,2831,525,5097,511,244,267
7550,5852,751,2833,525,5101,512,244,268
7555,5856,751,2836,525,5105,512,244,268
7560,5859,751,2837,525,5108,512,244,268
7565,5860,752,2838,526,5108,512,244,268
7570,5865,753,2840,526,5112,513,244,269
7575,5867,753,2842,526,5114,514,245,269
7580,5875,754,2850,527,5121,514,245,269
7585,5878,754,2851,527,5124,514,245,269
7590,5883,755,2854,527,5128,514,245,269
7595,5887,755,2856,527,5132,514,245,269
7600,5890,755,2858,527,5135,514,245,269
7605,5891,755,2858,527,5136,514,245,269
7610,5896,756,2860,527,5140,515,245,270
7615,5898,756,2860,527,5142,516,245,271
7620,5906,758,2864,529,5148,518,245,273
7625,5909,758,2867,529,5151,518,245,273
7630,5914,759,2870,529,5155,518,245,273
7635,5918,759,2870,529,5159,518,245,273
7640,5921,759,2870,529,5162,518,245,273
7645,5922,759,2870,529,5163,518,245,273
7650,5927,760,2874,530,5167,518,245,273
7655,5929,760,2874,530,5169,519,245,274
7660,5937,760,2879,530,5177,519,245,274
7665,5940,760,2879,530,5180,519,245,274
7670,5945,761,2882,531,5184,519,245,274
7675,5949,761,2885,531,5187,519,245,274
7680,5952,762,2886,532,5190,519,245,274
7685,5953,762,2886,532,5191,519,245,274
7690,5958,763,2888,532,5195,519,245,274
7695,5960,763,2890,532,5197,520,246,274
7700,5968,763,2897,532,5205,520,246,274
7705,5971,763,2897,532,5208,520,246,274
7710,5976,764,2901,533,5212,520,246,274
7715,5980,764,2901,533,5216,520,246,274
7720,5983,765,2904,534,5218,520,246,274
7725,5984,765,2905,534,5219,520,246,274
7730,5989,766,2909,535,5223,520,246,274
7735,5991,766,2910,535,5225,521,246,275
7740,5999,769,2916,538,5230,523,248,275
7745,6002,769,2917,538,5233,523,248,275
7750,6007,770,2918,538,5237,524,249,275
7755,6011,770,2920,538,5241,524,249,275
7760,6014,770,2922,538,5244,524,249,275
7765,6015,771,2923,539,5244,524,249,275
7770,6020,772,2925,539,5248,525,249,276
7775,6022,772,2926,539,5250,526,249,277
7780,6030,773,2928,539,5257,527,249,278
7785,6033,774,2930,540,5259,527,249,278
7790,6038,775,2932,540,5263,528,250,278
7795,6042,775,2933,540,5267,528,250,278
7800,6045,776,2934,541,5269,528,250,278
7805,6046,777,2935,542,5269,528,250,278
7810,6051,778,2937,542,5273,529,250,279
7815,6053,778,2939,542,5275,530,251,279
7820,6061,780,2944,543,5281,531,252,279
7825,6064,780,2944,543,5284,531,252,279
7830,6069,781,2946,544,5288,531,252,279
7835,6073,781,2949,544,5292,531,252,279
7840,6076,781,2951,544,5295,531,252,279
7845,6077,782,2952,545,5295,531,252,279
7850,6082,783,2953,545,5299,531,252,279
7855,6084,783,2953,545,5301,532,252,280
7860,6092,784,2955,545,5308,534,253,281
7865,6095,784,2957,545,5311,534,253,281
7870,6100,784,2957,545,5316,534,253,281
7875,6104,784,2959,545,5320,534,253,281
7880,6107,784,2961,545,5323,534,253,281
7885,6108,784,2961,545,5324,534,253,281
7890,6113,785,2964,545,5328,534,253,281
7895,6115,785,2965,545,5330,535,254,281
7900,6123,785,2968,545,5338,535,254,281
7905,6126,785,2970,545,5341,535,254,281
7910,6131,785,2972,545,5346,535,254,281
7915,6135,785,2976,545,5349,535,254,281
7920,6138,786,2979,546,5352,535,254,281
7925,6139,786,2979,546,5353,535,254,281
7930,6144,787,2984,547,5357,536,255,281
7935,6146,787,2985,547,5359,537,256,281
7940,6154,787,2988,547,5367,537,256,281
7945,6157,787,2989,547,5370,537,256,281
7950,6162,787,2993,547,5375,537,256,281
7955,6166,787,2995,547,5378,537,256,281
7960,6169,788,2997,548,5381,537,256,281
7965,6170,788,2997,548,5382,537,256,281
7970,6175,789,2999,548,5386,538,256,282
7975,6177,789,3001,548,5388,539,257,282
7980,6185,790,3004,549,5394,541,258,283
7985,6188,791,3004,550,5397,541,258,283
7990,6193,792,3008,551,5401,541,258,283
7995,6197,792,3011,551,5404,541,258,283
8000,6200,793,3014,552,5407,541,258,283
8005,6201,793,3014,552,5408,541,258,283
8010,6206,793,3015,552,5413,542,259,283
8015,6208,793,3017,552,5415,543,260,283
8020,6216,794,3021,552,5422,543,260,283
8025,6219,794,3023,552,5425,543,260,283
8030,6224,795,3027,553,5429,543,260,283
8035,6228,795,3028,553,5433,543,260,283
8040,6231,795,3029,553,5436,543,260,283
8045,6232,795,3029,553,5437,543,260,283
8050,6237,795,3029,553,5442,544,260,284
8055,6239,795,3031,553,5444,545,261,284
8060,6247,797,3037,555,5450,545,261,284
8065,6250,797,3038,555,5453,545,261,284
8070,6255,798,3039,556,5457,545,261,284
8075,6259,798,3040,556,5461,545,261,284
8080,6262,798,3041,556,5464,545,261,284
8085,6263,798,3042,556,5465,545,261,284
8090,6268,799,3046,557,5469,545,261,284
8095,6270,799,3046,557,5471,546,261,285
8100,6278,801,3051,559,5476,548,263,285
8105,6281,803,3053,561,5478,548,263,285
8110,6286,804,3053,561,5482,549,263,286
8115,6290,804,3054,561,5486,549,263,286
8120,6293,805,3056,562,5488,549,263,286
8125,6294,806,3057,563,5488,549,263,286
8130,6299,807,3059,563,5492,549,263,286
8135,6301,807,3060,563,5494,550,264,286
8140,6309,808,3066,564,5501,550,264,286
8145,6312,808,3068,564,5504,550,264,286
8150,6317,809,3071,565,5508,551,265,286
8155,6321,809,3074,565,5512,551,265,286
8160,6324,809,3076,565,5515,551,265,286
8165,6325,809,3076,565,5516,551,265,286
8170,6330,810,3080,566,5520,552,266,286
8175,6332,810,3080,566,5522,553,266,287
8180,6340,810,3083,566,5530,553,266,287
8185,6343,810,3085,566,5533,553,266,287
8190,6348,811,3086,567,5537,553,266,287
8195,6352,811,3089,567,5541,553,266,287
8200,6355,812,3092,568,5543,553,266,287
8205,6356,812,3093,568,5544,553,266,287
8210,6361,813,3097,569,5548,554,267,287
8215,6363,813,3099,569,5550,555,268,287
8220,6371,814,3102,570,5557,556,268,288
8225,6374,814,3103,570,5560,556,268,288
8230,6379,814,3106,570,5565,556,268,288
8235,6383,814,3107,570,5569,556,268,288
8240,6386,814,3108,570,5572,556,268,288
8245,6387,814,3108,570,5573,556,268,288
8250,6392,815,3112,571,5577,557,269,288
8255,6394,815,3114,571,5579,558,270,288
8260,6402,816,3117,571,5586,558,270,288
8265,6405,816,3119,571,5589,558,270,288
8270,6410,816,3120,571,5594,558,270,288
8275,6414,816,3122,571,5598,558,270,288
8280,6417,816,3123,571,5601,558,270,288
8285,6418,817,3124,572,5601,558,270,288
8290,6423,818,3127,572,5605,559,271,288
8295,6425,818,3128,572,5607,560,272,288
8300,6433,819,3130,572,5614,560,272,288
8305,6436,819,3132,572,5617,560,272,288
8310,6441,819,3134,572,5622,560,272,288
8315,6445,819,3136,572,5626,560,272,288
8320,6448,819,3137,572,5629,560,272,288
8325,6449,819,3137,572,5630,560,272,288
8330,6454,820,3139,572,5634,560,272,288
8335,6456,820,3139,572,5636,561,272,289
8340,6464,821,3141,572,5643,563,273,290
8345,6467,821,3142,572,5646,563,273,290
8350,6472,822,3146,573,5650,563,273,290
8355,6476,822,3147,573,5654,563,273,290
8360,6479,823,3149,574,5656,563,273,290
8365,6480,823,3149,574,5657,563,273,290
8370,6485,824,3151,575,5661,563,273,290
8375,6487,824,3151,575,5663,564,273,291
8380,6495,826,3155,577,5669,564,273,291
8385,6498,826,3158,577,5672,564,273,291
8390,6503,827,3162,578,5676,564,273,291
8395,6507,827,3165,578,5680,564,273,291
8400,6510,827,3167,578,5683,564,273,291
8405,6511,827,3167,578,5684,564,273,291
8410,6516,828,3169,578,5688,565,273,292
8415,6518,828,3170,578,5690,566,274,292
8420,6526,830,3175,580,5696,566,274,292
8425,6529,830,3176,580,5699,566,274,292
8430,6534,830,3176,580,5704,566,274,292
8435,6538,830,3178,580,5708,566,274,292
8440,6541,830,3180,580,5711,566,274,292
8445,6542,830,3180,580,5712,566,274,292
8450,6547,831,3182,580,5716,566,274,292
8455,6549,831,3182,580,5718,567,274,293
8460,6557,834,3187,582,5723,569,276,293
8465,6560,834,3189,582,5726,569,276,293
8470,6565,834,3190,582,5731,569,276,293
8475,6569,834,3191,582,5735,569,276,293
8480,6572,834,3192,582,5738,569,276,293
8485,6573,835,3193,583,5738,569,276,293
8490,6578,836,3196,584,5742,569,276,293
8495,6580,836,3198,584,5744,570,277,293
8500,6588,836,3202,584,5752,570,277,293
8505,6591,836,3203,584,5755,570,277,293
8510,6596,837,3206,585,5759,570,277,293
8515,6600,837,3207,585,5763,570,277,293
8520,6603,837,3208,585,5766,570,277,293
8525,6604,837,3208,585,5767,570,277,293
8530,6609,838,3210,585,5771,570,277,293
8535,6611,838,3211,585,5773,571,277,294
8540,6619,839,3216,586,5780,571,277,294
8545,6622,839,3219,586,5783,571,277,294
8550,6627,840,3219,586,5787,571,277,294
8555,6631,840,3220,586,5791,571,277,294
8560,6634,840,3221,586,5794,571,277,294
8565,6635,840,3222,586,5795,571,277,294
8570,6640,841,3225,586,5799,571,277,294
8575,6642,841,3226,586,5801,572,278,294
8580,6650,842,3228,586,5808,574,280,294
8585,6653,842,3229,586,5811,574,280,294
8590,6658,843,3231,587,5815,574,280,294
8595,6662,843,3232,587,5819,574,280,294
8600,6665,844,3235,588,5821,574,280,294
8605,6666,844,3235,588,5822,574,280,294
8610,6671,845,3236,588,5826,575,280,295
8615,6673,845,3236,588,5828,576,280,296
8620,6681,846,3239,589,5835,577,280,297
8625,6684,846,3241,589,5838,577,280,297
8630,6689,847,3245,590,5842,577,280,297
8635,6693,847,3248,590,5845,577,280,297
8640,6696,849,3250,592,5847,577,280,297
8645,6697,849,3250,592,5848,577,280,297
8650,6702,850,3252,593,5852,578,281,297
8655,6704,850,3254,593,5854,579,282,297
8660,6712,851,3256,593,5861,579,282,297
8665,6715,851,3257,593,5864,579,282,297
8670,6720,852,3260,594,5868,579,282,297
8675,6724,852,3260,594,5872,579,282,297
8680,6727,852,3261,594,5875,579,282,297
8685,6728,853,3262,595,5875,579,282,297
8690,6733,854,3265,595,5879,579,282,297
8695,6735,854,3265,595,5881,580,282,298
8700,6743,855,3270,595,5888,581,282,299
8705,6746,855,3271,595,5891,581,282,299
8710,6751,856,3274,596,5895,581,282,299
8715,6755,856,3277,596,5899,581,282,299
8720,6758,857,3279,597,5901,581,282,299
8725,6759,857,3279,597,5902,581,282,299
8730,6764,858,3282,598,5906,581,282,299
8735,6766,858,3282,598,5908,582,282,300
8740,6774,859,3285,598,5915,582,282,300
8745,6777,859,3287,598,5918,582,282,300
8750,6782,860,3290,598,5922,582,282,300
8755,6786,860,3293,598,5925,582,282,300
8760,6789,862,3296,600,5927,582,282,300
8765,6790,862,3297,600,5928,582,282,300
8770,6795,863,3300,600,5932,583,282,301
8775,6797,863,3301,600,5934,584,283,301
8780,6805,865,3305,601,5939,585,284,301
8785,6808,866,3305,602,5942,585,284,301
8790,6813,867,3308,603,5946,585,284,301
8795,6817,867,3310,603,5949,585,284,301
8800,6820,869,3312,605,5951,585,284,301
8805,6821,869,3312,605,5952,585,284,301
8810,6826,870,3315,606,5956,585,284,301
8815,6828,870,3317,606,5958,586,285,301
8820,6836,872,3322,608,5963,588,285,303
8825,6839,873,3323,609,5966,588,285,303
8830,6844,873,3325,609,5971,588,285,303
8835,6848,873,3326,609,5975,588,285,303
8840,6851,873,3329,609,5978,588,285,303
8845,6852,874,3330,610,5978,588,285,303
8850,6857,875,3332,610,5982,588,285,303
8855,6859,875,3332,610,5984,589,285,304
8860,6867,875,3338,610,5992,589,285,304
8865,6870,875,3339,610,5995,589,285,304
8870,6875,875,3341,610,6000,589,285,304
8875,6879,875,3343,610,6004,589,285,304
8880,6882,875,3343,610,6007,589,285,304
8885,6883,875,3343,610,6008,589,285,304
8890,6888,876,3346,610,6012,590,285,305
8895,6890,876,3346,610,6014,591,285,306
8900,6898,876,3350,610,6022,591,285,306
8905,6901,876,3352,610,6025,591,285,306
8910,6906,876,3353,610,6030,591,285,306
8915,6910,876,3355,610,6033,591,285,306
8920,6913,877,3357,611,6036,591,285,306
8925,6914,877,3357,611,6037,591,285,306
8930,6919,878,3358,611,6041,591,285,306
8935,6921,878,3358,611,6043,592,285,307
8940,6929,880,3363,613,6048,594,286,308
8945,6932,881,3366,614,6051,594,286,308
8950,6937,882,3369,614,6055,594,286,308
8955,6941,882,3370,614,6058,594,286,308
8960,6944,884,3372,616,6060,594,286,308
8965,6945,884,3372,616,6061,594,286,308
8970,6950,885,3373,616,6065,595,286,309
8975,6952,885,3375,616,6067,596,287,309
8980,6960,885,3378,616,6075,596,287,309
8985,6963,885,3379,616,6078,596,287,309
8990,6968,886,3382,617,6082,596,287,309
8995,6972,886,3384,617,6085,596,287,309
9000,6975,887,3384,618,6088,596,287,309
9005,6976,888,3385,619,6088,596,287,309
9010,6981,889,3389,620,6092,596,287,309
9015,6983,889,3389,620,6094,597,287,310
9020,6991,891,3393,622,6100,599,289,310
9025,6994,891,3395,622,6103,599,289,310
9030,6999,892,3399,623,6107,600,290,310
9035,7003,892,3401,623,6111,600,290,310
9040,7006,892,3401,623,6114,600,290,310
9045,7007,893,3402,624,6114,600,290,310
9050,7012,894,3403,624,6118,600,290,310
9055,7014,894,3403,624,6120,601,290,311
9060,7022,897,3409,626,6124,603,292,311
9065,7025,898,3410,627,6127,603,292,311
9070,7030,899,3414,628,6131,603,292,311
9075,7034,899,3415,628,6135,603,292,311
9080,7037,899,3416,628,6138,603,292,311
9085,7038,900,3417,629,6138,603,292,311
9090,7043,901,3419,629,6142,604,292,312
9095,7045,901,3419,629,6144,605,292,313
9100,7053,902,3422,630,6151,605,292,313
9105,7056,902,3424,630,6154,605,292,313
9110,7061,903,3425,630,6158,605,292,313
9115,7065,903,3426,630,6162,605,292,313
9120,7068,904,3427,631,6164,605,292,313
9125,7069,905,3428,632,6164,605,292,313
9130,7074,906,3430,632,6168,606,292,314
9135,7076,906,3430,632,6170,607,292,315
9140,7084,907,3432,633,6177,607,292,315
9145,7087,907,3433,633,6180,607,292,315
9150,7092,907,3436,633,6185,607,292,315
9155,7096,907,3438,633,6188,607,292,315
9160,7099,908,3440,634,6191,607,292,315
9165,7100,908,3441,634,6192,607,292,315
9170,7105,909,3444,635,6196,608,293,315
9175,7107,909,3444,635,6198,609,293,316
9180,7115,911,3449,636,6203,610,294,316
9185,7118,912,3450,637,6206,610,294,316
9190,7123,912,3453,637,6211,610,294,316
9195,7127,912,3455,637,6214,610,294,316
9200,7130,913,3456,638,6217,610,294,316
9205,7131,913,3457,638,6218,610,294,316
9210,7136,914,3460,638,6222,610,294,316
9215,7138,914,3461,638,6224,611,295,316
9220,7146,915,3464,639,6231,611,295,316
9225,7149,915,3466,639,6234,611,295,316
9230,7154,915,3468,639,6239,611,295,316
9235,7158,915,3471,639,6242,611,295,316
9240,7161,917,3472,641,6244,611,295,316
9245,7162,917,3473,641,6245,611,295,316
9250,7167,917,3477,641,6250,611,295,316
9255,7169,917,3477,641,6252,612,295,317
9260,7177,918,3480,641,6259,613,296,317
9265,7180,919,3482,642,6261,613,296,317
9270,7185,920,3486,643,6265,613,296,317
9275,7189,920,3487,643,6269,613,296,317
9280,7192,921,3489,644,6271,613,296,317
9285,7193,921,3490,644,6272,613,296,317
9290,7198,921,3495,644,6277,614,297,317
9295,7200,921,3497,644,6279,615,298,317
9300,7208,922,3499,644,6286,616,298,318
9305,7211,922,3500,644,6289,616,298,318
9310,7216,922,3501,644,6294,616,298,318
9315,7220,922,3503,644,6298,616,298,318
9320,7223,922,3504,644,6301,616,298,318
9325,7224,922,3504,644,6302,616,298,318
9330,7229,922,3507,644,6307,617,299,318
9335,7231,922,3508,644,6309,618,300,318
9340,7239,923,3511,644,6316,618,300,318
9345,7242,923,3513,644,6319,618,300,318
9350,7247,923,3517,644,6324,618,300,318
9355,7251,923,3519,644,6327,618,300,318
9360,7254,924,3520,645,6330,618,300,318
9365,7255,924,3520,645,6331,618,300,318
9370,7260,925,3522,646,6335,619,301,318
9375,7262,925,3522,646,6337,620,301,319
9380,7270,927,3527,648,6343,621,302,319
9385,7273,927,3528,648,6346,621,302,319
9390,7278,927,3532,648,6351,621,302,319
9395,7282,927,3535,648,6354,621,302,319
9400,7285,928,3537,649,6357,621,302,319
9405,7286,928,3538,649,6358,621,302,319
9410,7291,929,3542,650,6362,621,302,319
9415,7293,929,3543,650,6364,622,303,319
9420,7301,930,3546,650,6370,624,304,320
9425,7304,931,3546,651,6373,624,304,320
9430,7309,932,3549,651,6377,624,304,320
9435,7313,932,3552,651,6381,624,304,320
9440,7316,932,3553,651,6384,624,304,320
9445,7317,932,3553,651,6385,624,304,320
9450,7322,933,3558,652,6389,624,304,320
9455,7324,933,3558,652,6391,625,304,321
9460,7332,934,3561,652,6398,625,304,321
9465,7335,934,3564,652,6401,625,304,321
9470,7340,935,3566,652,6405,625,304,321
9475,7344,935,3568,652,6409,625,304,321
9480,7347,936,3571,653,6411,625,304,321
9485,7348,937,3572,654,6411,625,304,321
9490,7353,938,3576,655,6415,625,304,321
9495,7355,938,3577,655,6417,626,305,321
9500,7363,940,3584,657,6423,626,305,321
9505,7366,940,3586,657,6426,626,305,321
9510,7371,941,3589,657,6430,626,305,321
9515,7375,941,3592,657,6434,626,305,321
9520,7378,942,3594,658,6436,626,305,321
9525,7379,943,3595,659,6436,626,305,321
9530,7384,944,3600,660,6440,626,305,321
9535,7386,944,3602,660,6442,627,306,321
9540,7394,946,3605,661,6447,629,307,322
9545,7397,947,3606,662,6450,629,307,322
9550,7402,947,3608,662,6455,629,307,322
9555,7406,947,3611,662,6458,629,307,322
9560,7409,948,3612,663,6461,629,307,322
9565,7410,948,3612,663,6462,629,307,322
9570,7415,949,3614,663,6466,629,307,322
9575,7417,949,3615,663,6468,630,307,323
9580,7425,949,3621,663,6476,630,307,323
9585,7428,949,3622,663,6479,630,307,323
9590,7433,949,3627,663,6484,630,307,323
9595,7437,949,3630,663,6488,630,307,323
9600,7440,949,3632,663,6491,630,307,323
9605,7441,949,3632,663,6492,630,307,323
9610,7446,950,3635,664,6496,631,307,324
9615,7448,950,3636,664,6498,632,307,325
9620,7456,950,3640,664,6506,632,307,325
9625,7459,950,3642,664,6509,632,307,325
9630,7464,950,3644,664,6514,632,307,325
9635,7468,950,3646,664,6517,632,307,325
9640,7471,951,3648,665,6520,632,307,325
9645,7472,951,3649,665,6521,632,307,325
9650,7477,952,3654,666,6525,633,308,325
9655,7479,952,3655,666,6527,634,309,325
9660,7487,955,3660,669,6532,636,310,326
9665,7490,955,3661,669,6535,636,310,326
9670,7495,956,3664,670,6539,636,310,326
9675,7499,956,3665,670,6543,636,310,326
9680,7502,956,3665,670,6546,636,310,326
9685,7503,956,3666,670,6547,636,310,326
9690,7508,957,3667,671,6551,637,310,327
9695,7510,957,3668,671,6553,638,310,328
9700,7518,957,3672,671,6561,638,310,328
9705,7521,957,3674,671,6564,638,310,328
9710,7526,958,3675,671,6568,638,310,328
9715,7530,958,3677,671,6572,638,310,328
9720,7533,958,3678,671,6575,638,310,328
9725,7534,958,3678,671,6576,638,310,328
9730,7539,959,3679,671,6580,638,310,328
9735,7541,959,3679,671,6582,639,310,329
9740,7549,960,3681,672,6589,639,310,329
9745,7552,960,3681,672,6592,639,310,329
9750,7557,961,3681,672,6596,639,310,329
9755,7561,961,3682,672,6600,639,310,329
9760,7564,962,3685,673,6602,639,310,329
9765,7565,963,3686,674,6602,639,310,329
9770,7570,964,3689,675,6606,639,310,329
9775,7572,964,3690,675,6608,640,311,329
9780,7580,965,3692,675,6614,642,312,330
9785,7583,966,3694,676,6617,642,312,330
9790,7588,967,3695,676,6621,642,312,330
9795,7592,967,3696,676,6624,642,312,330
9800,7595,969,3698,678,6626,642,312,330
9805,7596,970,3699,679,6626,642,312,330
9810,7601,971,3703,680,6630,642,312,330
9815,7603,971,3704,680,6632,643,312,331
9820,7611,972,3708,681,6639,643,312,331
9825,7614,972,3710,681,6642,643,312,331
9830,7619,973,3712,681,6646,643,312,331
9835,7623,973,3715,681,6649,643,312,331
9840,7626,974,3715,682,6652,643,312,331
9845,7627,974,3716,682,6653,643,312,331
9850,7632,975,3716,682,6657,644,312,332
9855,7634,975,3718,682,6659,645,313,332
9860,7642,976,3723,683,6666,645,313,332
9865,7645,976,3725,683,6669,645,313,332
9870,7650,977,3726,684,6673,645,313,332
9875,7654,977,3727,684,6677,645,313,332
9880,7657,978,3728,685,6679,645,313,332
9885,7658,978,3729,685,6680,645,313,332
9890,7663,979,3732,686,6684,646,314,332
9895,7665,979,3732,686,6686,647,314,333
9900,7673,981,3736,687,6691,649,315,334
9905,7676,982,3739,688,6694,649,315,334
9910,7681,982,3743,688,6699,649,315,334
9915,7685,982,3744,688,6703,649,315,334
9920,7688,982,3747,688,6706,649,315,334
9925,7689,982,3748,688,6707,649,315,334
9930,7694,983,3751,689,6711,650,315,335
9935,7696,983,3753,689,6713,651,316,335
9940,7704,983,3760,689,6721,651,316,335
9945,7707,983,3762,689,6724,651,316,335
9950,7712,983,3765,689,6729,651,316,335
9955,7716,983,3768,689,6732,651,316,335
9960,7719,984,3770,690,6735,651,316,335
9965,7720,984,3770,690,6736,651,316,335
9970,7725,985,3772,691,6740,651,316,335
9975,7727,985,3774,691,6742,652,317,335
9980,7735,986,3778,692,6749,653,318,335
9985,7738,986,3778,692,6752,653,318,335
9990,7743,986,3780,692,6757,653,318,335
9995,7747,986,3784,692,6760,653,318,335
10000,7750,987,3784,693,6763,653,318,335
10005,7751,988,3785,694,6763,653,318,335
10010,7756,989,3787,694,6767,653,318,335
10015,7758,989,3788,694,6769,654,318,336
10020,7766,990,3793,695,6776,655,318,337
10025,7769,990,3793,695,6779,655,318,337
10030,7774,990,3794,695,6784,655,318,337
10035,7778,990,3797,695,6787,655,318,337
10040,7781,991,3798,696,6790,655,318,337
10045,7782,991,3798,696,6791,655,318,337
10050,7787,992,3798,696,6795,656,318,338
10055,7789,992,3799,696,6797,657,318,339
10060,7797,993,3802,697,6804,657,318,339
10065,7800,993,3802,697,6807,657,318,339
10070,7805,994,3803,697,6811,657,318,339
10075,7809,994,3807,697,6814,657,318,339
10080,7812,995,3808,698,6817,657,318,339
10085,7813,995,3808,698,6818,657,318,339
10090,7818,996,3811,699,6822,658,319,339
10095,7820,996,3813,699,6824,659,320,339
10100,7828,998,3818,700,6830,659,320,339
10105,7831,998,3820,700,6833,659,320,339
10110,7836,999,3822,700,6837,659,320,339
10115,7840,999,3824,700,6840,659,320,339
10120,7843,1000,3825,701,6843,659,320,339
10125,7844,1001,3826,702,6843,659,320,339
10130,7849,1002,3830,702,6847,659,320,339
10135,7851,1002,3832,702,6849,660,321,339
10140,7859,1003,3837,703,6856,661,322,339
10145,7862,1003,3839,703,6859,661,322,339
10150,7867,1003,3841,703,6864,661,322,339
10155,7871,1003,3841,703,6868,661,322,339
10160,7874,1003,3842,703,6871,661,322,339
10165,7875,1004,3843,704,6871,661,322,339
10170,7880,1005,3844,704,6875,661,322,339
10175,7882,1005,3844,704,6877,662,322,340
10180,7890,1006,3849,705,6884,662,322,340
10185,7893,1006,3852,705,6887,662,322,340
10190,7898,1006,3855,705,6892,662,322,340
10195,7902,1006,3856,705,6896,662,322,340
10200,7905,1006,3858,705,6899,662,322,340
10205,7906,1006,3859,705,6900,662,322,340
10210,7911,1006,3863,705,6905,662,322,340
10215,7913,1006,3864,705,6907,663,322,341
10220,7921,1008,3866,706,6913,664,322,342
10225,7924,1008,3867,706,6916,664,322,342
10230,7929,1008,3870,706,6921,664,322,342
10235,7933,1008,3871,706,6925,664,322,342
10240,7936,1008,3872,706,6928,664,322,342
10245,7937,1008,3873,706,6929,664,322,342
10250,7942,1008,3877,706,6934,665,323,342
10255,7944,1008,3879,706,6936,666,324,342
10260,7952,1010,3881,707,6942,668,324,344
10265,7955,1010,3883,707,6945,668,324,344
10270,7960,1011,3884,707,6949,668,324,344
10275,7964,1011,3886,707,6952,668,324,344
10280,7967,1012,3886,708,6955,668,324,344
10285,7968,1012,3887,708,6956,668,324,344
10290,7973,1012,3889,708,6961,669,325,344
10295,7975,1012,3891,708,6963,670,326,344
10300,7983,1014,3895,709,6969,670,326,344
10305,7986,1014,3895,709,6972,670,326,344
10310,7991,1015,3897,710,6976,670,326,344
10315,7995,1015,3900,710,6979,670,326,344
10320,7998,1016,3901,711,6982,670,326,344
10325,7999,1017,3902,712,6982,670,326,344
10330,8004,1018,3902,712,6986,671,326,345
10335,8006,1018,3902,712,6988,672,326,346
10340,8014,1019,3904,712,6995,672,326,346
10345,8017,1019,3906,712,6998,672,326,346
10350,8022,1019,3908,712,7003,672,326,346
10355,8026,1019,3909,712,7007,672,326,346
10360,8029,1019,3911,712,7010,672,326,346
10365,8030,1019,3912,712,7011,672,326,346
10370,8035,1020,3913,712,7015,673,326,347
10375,8037,1020,3914,712,7017,674,327,347
10380,8045,1021,3917,712,7024,675,327,348
10385,8048,1021,3919,712,7027,675,327,348
10390,8053,1021,3920,712,7032,675,327,348
10395,8057,1021,3920,712,7036,675,327,348
10400,8060,1021,3923,712,7039,675,327,348
10405,8061,1021,3923,712,7040,675,327,348
10410,8066,1022,3924,713,7044,676,327,349
10415,8068,1022,3925,713,7046,677,327,350
10420,8076,1023,3931,714,7053,677,327,350
10425,8079,1023,3932,714,7056,677,327,350
10430,8084,1024,3934,715,7060,677,327,350
10435,8088,1024,3935,715,7064,677,327,350
10440,8091,1024,3935,715,7067,677,327,350
10445,8092,1024,3935,715,7068,677,327,350
10450,8097,1025,3937,715,7072,677,327,350
10455,8099,1025,3938,715,7074,678,327,351
10460,8107,1027,3945,717,7080,678,327,351
10465,8110,1027,3946,717,7083,678,327,351
10470,8115,1028,3950,718,7087,678,327,351
10475,8119,1028,3953,718,7090,678,327,351
10480,8122,1029,3954,719,7093,678,327,351
10485,8123,1030,3955,720,7093,678,327,351
10490,8128,1031,3957,720,7097,678,327,351
10495,8130,1031,3958,720,7099,679,328,351
10500,8138,1033,3963,721,7105,680,328,352
10505,8141,1033,3963,721,7108,680,328,352
10510,8146,1033,3966,721,7113,680,328,352
10515,8150,1033,3969,721,7117,680,328,352
10520,8153,1033,3971,721,7120,680,328,352
10525,8154,1033,3972,721,7121,680,328,352
10530,8159,1034,3975,722,7125,680,328,352
10535,8161,1034,3976,722,7127,681,329,352
10540,8169,1034,3981,722,7135,681,329,352
10545,8172,1034,3982,722,7138,681,329,352
10550,8177,1034,3986,722,7143,681,329,352
10555,8181,1034,3987,722,7147,681,329,352
10560,8184,1034,3988,722,7150,681,329,352
10565,8185,1034,3988,722,7151,681,329,352
10570,8190,1035,3990,722,7155,682,329,353
10575,8192,1035,3991,722,7157,683,329,354
10580,8200,1036,3994,722,7164,684,329,355
10585,8203,1036,3996,722,7167,684,329,355
10590,8208,1036,4000,722,7172,684,329,355
10595,8212,1036,4003,722,7176,684,329,355
10600,8215,1036,4003,722,7179,684,329,355
10605,8216,1036,4003,722,7180,684,329,355
10610,8221,1037,4005,722,7184,684,329,355
10615,8223,1037,4007,722,7186,685,330,355
10620,8231,1038,4009,722,7193,687,331,356
10625,8234,1038,4010,722,7196,687,331,356
10630,8239,1038,4013,722,7201,687,331,356
10635,8243,1038,4013,722,7205,687,331,356
10640,8246,1038,4014,722,7208,687,331,356
10645,8247,1039,4015,723,7208,687,331,356
10650,8252,1040,4016,723,7212,687,331,356
10655,8254,1040,4017,723,7214,688,331,357
10660,8262,1040,4022,723,7222,688,331,357
10665,8265,1040,4023,723,7225,688,331,357
10670,8270,1041,4023,723,7229,688,331,357
10675,8274,1041,4026,723,7232,688,331,357
10680,8277,1043,4029,725,7234,688,331,357
10685,8278,1043,4030,725,7235,688,331,357
10690,8283,1044,4031,725,7239,689,331,358
10695,8285,1044,4032,725,7241,690,332,358
10700,8293,1045,4035,726,7248,692,333,359
10705,8296,1046,4037,727,7250,692,333,359
10710,8301,1047,4041,728,7254,692,333,359
10715,8305,1047,4043,728,7257,692,333,359
10720,8308,1049,4045,730,7259,692,333,359
10725,8309,1049,4046,730,7260,692,333,359
10730,8314,1050,4049,730,7264,693,334,359
10735,8316,1050,4051,730,7266,694,335,359
10740,8324,1052,4052,731,7272,696,335,361
10745,8327,1052,4053,731,7275,696,335,361
10750,8332,1052,4055,731,7280,696,335,361
10755,8336,1052,4055,731,7284,696,335,361
10760,8339,1052,4057,731,7287,696,335,361
10765,8340,1052,4057,731,7288,696,335,361
10770,8345,1053,4061,732,7292,696,335,361
10775,8347,1053,4062,732,7294,697,335,362
10780,8355,1053,4065,732,7302,698,335,363
10785,8358,1053,4067,732,7305,698,335,363
10790,8363,1053,4069,732,7310,698,335,363
10795,8367,1053,4069,732,7314,698,335,363
10800,8370,1053,4071,732,7317,698,335,363
10805,8371,1054,4072,733,7317,698,335,363
10810,8376,1055,4074,733,7321,698,335,363
10815,8378,1055,4075,733,7323,699,336,363
10820,8386,1055,4079,733,7331,699,336,363
10825,8389,1055,4082,733,7334,699,336,363
10830,8394,1055,4084,733,7339,699,336,363
10835,8398,1055,4086,733,7343,699,336,363
10840,8401,1055,4087,733,7346,699,336,363
10845,8402,1055,4087,733,7347,699,336,363
10850,8407,1056,4090,733,7351,699,336,363
10855,8409,1056,4091,733,7353,700,337,363
10860,8417,1058,4094,734,7358,701,337,364
10865,8420,1060,4097,736,7360,701,337,364
10870,8425,1062,4100,737,7363,701,337,364
10875,8429,1062,4102,737,7366,701,337,364
10880,8432,1064,4105,739,7368,701,337,364
10885,8433,1064,4105,739,7369,701,337,364
10890,8438,1065,4107,740,7373,702,338,364
10895,8440,1065,4107,740,7375,703,338,365
10900,8448,1067,4112,742,7381,704,338,366
10905,8451,1067,4113,742,7384,704,338,366
10910,8456,1068,4117,743,7388,704,338,366
10915,8460,1068,4118,743,7391,704,338,366
10920,8463,1070,4119,745,7393,704,338,366
10925,8464,1070,4119,745,7394,704,338,366
10930,8469,1071,4119,745,7398,705,338,367
10935,8471,1071,4120,745,7400,706,338,368
10940,8479,1072,4124,746,7407,706,338,368
10945,8482,1072,4127,746,7410,706,338,368
10950,8487,1072,4130,746,7415,706,338,368
10955,8491,1072,4133,746,7418,706,338,368
10960,8494,1073,4134,747,7421,706,338,368
10965,8495,1073,4135,747,7422,706,338,368
10970,8500,1074,4138,747,7426,707,339,368
10975,8502,1074,4139,747,7428,708,340,368
10980,8510,1076,4143,749,7434,709,341,368
10985,8513,1076,4146,749,7437,709,341,368
10990,8518,1076,4147,749,7442,709,341,368
10995,8522,1076,4149,749,7446,709,341,368
11000,8525,1076,4150,749,7449,709,341,368
11005,8526,1077,4151,750,7449,709,341,368
11010,8531,1078,4153,751,7453,709,341,368
11015,8533,1078,4154,751,7455,710,341,369
11020,8541,1079,4159,752,7462,710,341,369
11025,8544,1079,4160,752,7465,710,341,369
11030,8549,1080,4161,752,7469,710,341,369
11035,8553,1080,4163,752,7473,710,341,369
11040,8556,1081,4166,753,7475,710,341,369
11045,8557,1081,4167,753,7476,710,341,369
11050,8562,1082,4170,754,7480,710,341,369
11055,8564,1082,4171,754,7482,711,342,369
11060,8572,1083,4175,755,7489,711,342,369
11065,8575,1083,4176,755,7492,711,342,369
11070,8580,1084,4179,756,7496,711,342,369
11075,8584,1084,4181,756,7500,711,342,369
11080,8587,1084,4183,756,7503,711,342,369
11085,8588,1084,4183,756,7504,711,342,369
11090,8593,1085,4187,757,7508,711,342,369
11095,8595,1085,4188,757,7510,712,343,369
11100,8603,1087,4194,759,7515,713,344,369
11105,8606,1088,4196,760,7518,713,344,369
11110,8611,1089,4198,761,7522,713,344,369
11115,8615,1089,4200,761,7526,713,344,369
11120,8618,1090,4201,762,7528,713,344,369
11125,8619,1090,4202,762,7529,713,344,369
11130,8624,1091,4204,762,7533,714,344,370
11135,8626,1091,4205,762,7535,715,345,370
11140,8634,1092,4212,763,7542,715,345,370
11145,8637,1092,4214,763,7545,715,345,370
11150,8642,1093,4216,764,7549,715,345,370
11155,8646,1093,4217,764,7553,715,345,370
11160,8649,1093,4219,764,7556,715,345,370
11165,8650,1093,4219,764,7557,715,345,370
11170,8655,1094,4221,765,7561,716,345,371
11175,8657,1094,4222,765,7563,717,345,372
11180,8665,1096,4226,767,7569,717,345,372
11185,8668,1096,4227,767,7572,717,345,372
11190,8673,1097,4231,768,7576,717,345,372
11195,8677,1097,4233,768,7580,717,345,372
11200,8680,1098,4235,769,7582,717,345,372
11205,8681,1098,4235,769,7583,717,345,372
11210,8686,1099,4236,769,7587,717,345,372
11215,8688,1099,4238,769,7589,718,346,372
11220,8696,1102,4242,772,7594,719,346,373
11225,8699,1102,4244,772,7597,719,346,373
11230,8704,1103,4247,772,7601,719,346,373
11235,8708,1103,4249,772,7605,719,346,373
11240,8711,1103,4250,772,7608,719,346,373
11245,8712,1103,4250,772,7609,719,346,373
11250,8717,1104,4250,772,7613,719,346,373
11255,8719,1104,4251,772,7615,720,346,374
11260,8727,1104,4252,772,7623,720,346,374
11265,8730,1104,4253,772,7626,720,346,374
11270,8735,1105,4256,773,7630,720,346,374
11275,8739,1105,4257,773,7633,720,346,374
11280,8742,1106,4258,774,7636,720,346,374
11285,8743,1106,4258,774,7637,720,346,374
11290,8748,1107,4260,775,7641,721,346,375
11295,8750,1107,4261,775,7643,722,346,376
11300,8758,1108,4266,775,7650,723,347,376
11305,8761,1108,4267,775,7653,723,347,376
11310,8766,1108,4269,775,7658,723,347,376
11315,8770,1108,4270,775,7662,723,347,376
11320,8773,1108,4273,775,7665,723,347,376
11325,8774,1108,4273,775,7666,723,347,376
11330,8779,1109,4278,776,7670,724,348,376
11335,8781,1109,4280,776,7672,725,349,376
11340,8789,1110,4282,776,7679,727,351,376
11345,8792,1111,4283,777,7681,727,351,376
11350,8797,1111,4286,777,7686,727,351,376
11355,8801,1111,4288,777,7689,727,351,376
11360,8804,1112,4288,778,7692,727,351,376
11365,8805,1113,4289,779,7692,727,351,376
11370,8810,1114,4292,779,7696,727,351,376
11375,8812,1114,4294,779,7698,728,352,376
11380,8820,1114,4298,779,7706,729,353,376
11385,8823,1114,4299,779,7709,729,353,376
11390,8828,1115,4302,780,7713,729,353,376
11395,8832,1115,4304,780,7716,729,353,376
11400,8835,1116,4305,781,7719,729,353,376
11405,8836,1116,4305,781,7720,729,353,376
11410,8841,1117,4305,781,7724,729,353,376
11415,8843,1117,4306,781,7726,730,353,377
11420,8851,1118,4311,782,7732,731,354,377
11425,8854,1119,4312,783,7735,731,354,377
11430,8859,1120,4313,783,7739,731,354,377
11435,8863,1120,4313,783,7743,731,354,377
11440,8866,1121,4314,784,7745,731,354,377
11445,8867,1121,4314,784,7746,731,354,377
11450,8872,1122,4316,784,7750,732,354,378
11455,8874,1122,4317,784,7752,733,354,379
11460,8882,1124,4322,786,7758,734,355,379
11465,8885,1124,4323,786,7761,734,355,379
11470,8890,1124,4326,786,7766,734,355,379
11475,8894,1124,4326,786,7770,734,355,379
11480,8897,1124,4327,786,7773,734,355,379
11485,8898,1124,4328,786,7774,734,355,379
11490,8903,1125,4331,786,7778,734,355,379
11495,8905,1125,4331,786,7780,735,355,380
11500,8913,1126,4335,787,7787,736,356,380
11505,8916,1127,4338,788,7789,736,356,380
11510,8921,1127,4342,788,7794,736,356,380
11515,8925,1127,4344,788,7798,736,356,380
11520,8928,1127,4346,788,7801,736,356,380
11525,8929,1127,4347,788,7802,736,356,380
11530,8934,1128,4350,789,7806,736,356,380
11535,8936,1128,4351,789,7808,737,356,381
11540,8944,1129,4353,789,7815,737,356,381
11545,8947,1129,4353,789,7818,737,356,381
11550,8952,1129,4356,789,7823,737,356,381
11555,8956,1129,4359,789,7826,737,356,381
11560,8959,1130,4360,790,7829,737,356,381
11565,8960,1130,4360,790,7830,737,356,381
11570,8965,1131,4361,790,7834,738,356,382
11575,8967,1131,4362,790,7836,739,357,382
11580,8975,1133,4365,791,7842,740,357,383
11585,8978,1133,4365,791,7845,740,357,383
11590,8983,1134,4367,792,7849,740,357,383
11595,8987,1134,4368,792,7853,740,357,383
11600,8990,1135,4369,793,7855,740,357,383
11605,8991,1135,4369,793,7856,740,357,383
11610,8996,1136,4371,793,7860,741,358,383
11615,8998,1136,4372,793,7862,742,358,384
11620,9006,1138,4377,795,7868,742,358,384
11625,9009,1138,4378,795,7871,742,358,384
11630,9014,1139,4379,795,7875,742,358,384
11635,9018,1139,4381,795,7879,742,358,384
11640,9021,1140,4384,796,7881,742,358,384
11645,9022,1141,4385,797,7881,742,358,384
11650,9027,1142,4388,797,7885,742,358,384
11655,9029,1142,4388,797,7887,743,358,385
11660,9037,1143,4391,798,7894,743,358,385
11665,9040,1143,4394,798,7897,743,358,385
11670,9045,1144,4397,798,7901,743,358,385
11675,9049,1144,4399,798,7905,743,358,385
11680,9052,1145,4401,799,7907,743,358,385
11685,9053,1146,4402,800,7907,743,358,385
11690,9058,1147,4405,801,7911,743,358,385
11695,9060,1147,4406,801,7913,744,359,385
11700,9068,1149,4410,803,7918,746,360,386
11705,9071,1150,4412,804,7921,746,360,386
11710,9076,1150,4415,804,7926,746,360,386
11715,9080,1150,4418,804,7929,746,360,386
11720,9083,1151,4421,805,7932,746,360,386
11725,9084,1151,4422,805,7933,746,360,386
11730,9089,1152,4427,806,7937,746,360,386
11735,9091,1152,4427,806,7939,747,360,387
11740,9099,1152,4430,806,7947,747,360,387
11745,9102,1152,4432,806,7950,747,360,387
11750,9107,1152,4435,806,7955,747,360,387
11755,9111,1152,4437,806,7958,747,360,387
11760,9114,1153,4439,807,7961,747,360,387
11765,9115,1153,4440,807,7962,747,360,387
11770,9120,1154,4443,807,7966,747,360,387
11775,9122,1154,4445,807,7968,748,361,387
11780,9130,1155,4450,808,7974,750,363,387
11785,9133,1157,4453,810,7976,750,363,387
11790,9138,1157,4453,810,7981,750,363,387
11795,9142,1157,4455,810,7985,750,363,387
11800,9145,1157,4456,810,7988,750,363,387
11805,9146,1157,4456,810,7989,750,363,387
11810,9151,1158,4457,811,7993,750,363,387
11815,9153,1158,4458,811,7995,751,364,387
11820,9161,1160,4463,813,8000,753,365,388
11825,9164,1161,4464,814,8003,753,365,388
11830,9169,1162,4465,814,8007,753,365,388
11835,9173,1162,4467,814,8010,753,365,388
11840,9176,1164,4469,816,8012,753,365,388
11845,9177,1165,4470,817,8012,753,365,388
11850,9182,1166,4473,817,8016,753,365,388
11855,9184,1166,4474,817,8018,754,365,389
11860,9192,1168,4477,818,8024,754,365,389
11865,9195,1168,4479,818,8027,754,365,389
11870,9200,1169,4481,819,8031,754,365,389
11875,9204,1169,4481,819,8035,754,365,389
11880,9207,1170,4484,820,8037,754,365,389
11885,9208,1170,4484,820,8038,754,365,389
11890,9213,1171,4488,821,8042,754,365,389
11895,9215,1171,4489,821,8044,755,365,390
11900,9223,1173,4491,822,8050,755,365,390
11905,9226,1173,4494,822,8053,755,365,390
11910,9231,1173,4497,822,8058,755,365,390
11915,9235,1173,4498,822,8062,755,365,390
11920,9238,1173,4501,822,8065,755,365,390
11925,9239,1173,4502,822,8066,755,365,390
11930,9244,1174,4505,823,8070,755,365,390
11935,9246,1174,4506,823,8072,756,365,391
11940,9254,1176,4511,824,8078,758,366,392
11945,9257,1176,4513,824,8081,758,366,392
11950,9262,1176,4515,824,8086,758,366,392
11955,9266,1176,4516,824,8090,758,366,392
11960,9269,1176,4518,824,8093,758,366,392
11965,9270,1176,4518,824,8094,758,366,392
11970,9275,1177,4520,824,8098,758,366,392
11975,9277,1177,4522,824,8100,759,367,392
11980,9285,1177,4525,824,8108,759,367,392
11985,9288,1177,4525,824,8111,759,367,392
11990,9293,1178,4525,824,8115,759,367,392
11995,9297,1178,4527,824,8119,759,367,392
12000,9300,1178,4529,824,8122,759,367,392
12005,9301,1179,4530,825,8122,759,367,392
12010,9306,1180,4532,826,8126,760,367,393
12015,9308,1180,4532,826,8128,761,367,394
12020,9316,1181,4537,827,8135,761,367,394
12025,9319,1181,4537,827,8138,761,367,394
12030,9324,1182,4541,828,8142,761,367,394
12035,9328,1182,4542,828,8146,761,367,394
12040,9331,1182,4543,828,8149,761,367,394
12045,9332,1182,4543,828,8150,761,367,394
12050,9337,1183,4545,829,8154,762,367,395
12055,9339,1183,4545,829,8156,763,367,396
12060,9347,1185,4550,831,8161,765,368,397
12065,9350,1186,4551,832,8164,765,368,397
12070,9355,1187,4553,832,8168,765,368,397
12075,9359,1187,4555,832,8172,765,368,397
12080,9362,1187,4556,832,8175,765,368,397
12085,9363,1187,4557,832,8176,765,368,397
12090,9368,1188,4559,832,8180,765,368,397
12095,9370,1188,4559,832,8182,766,368,398
12100,9378,1190,4562,834,8188,766,368,398
12105,9381,1190,4564,834,8191,766,368,398
12110,9386,1191,4568,835,8195,766,368,398
12115,9390,1191,4569,835,8199,766,368,398
12120,9393,1192,4570,836,8201,766,368,398
12125,9394,1192,4570,836,8202,766,368,398
12130,9399,1193,4574,837,8206,766,368,398
12135,9401,1193,4574,837,8208,767,368,399
12140,9409,1195,4578,838,8214,767,368,399
12145,9412,1195,4580,838,8217,767,368,399
12150,9417,1196,4581,838,8221,767,368,399
12155,9421,1196,4582,838,8225,767,368,399
12160,9424,1197,4585,839,8227,767,368,399
12165,9425,1197,4586,839,8228,767,368,399
12170,9430,1198,4588,840,8232,768,368,400
12175,9432,1198,4588,840,8234,769,368,401
12180,9440,1201,4595,843,8238,771,370,401
12185,9443,1202,4597,844,8241,771,370,401
12190,9448,1202,4600,844,8246,771,370,401
12195,9452,1202,4604,844,8249,771,370,401
12200,9455,1203,4605,845,8252,771,370,401
12205,9456,1203,4605,845,8253,771,370,401
12210,9461,1204,4609,845,8257,772,371,401
12215,9463,1204,4611,845,8259,773,372,401
12220,9471,1204,4615,845,8267,773,372,401
12225,9474,1204,4616,845,8270,773,372,401
12230,9479,1204,4621,845,8275,773,372,401
12235,9483,1204,4622,845,8278,773,372,401
12240,9486,1205,4623,846,8281,773,372,401
12245,9487,1205,4624,846,8282,773,372,401
12250,9492,1206,4628,847,8286,773,372,401
12255,9494,1206,4629,847,8288,774,373,401
12260,9502,1207,4634,848,8295,775,374,401
12265,9505,1207,4635,848,8298,775,374,401
12270,9510,1207,4637,848,8303,775,374,401
12275,9514,1207,4639,848,8306,775,374,401
12280,9517,1208,4641,849,8309,775,374,401
12285,9518,1208,4642,849,8310,775,374,401
12290,9523,1209,4646,850,8314,775,374,401
12295,9525,1209,4647,850,8316,776,375,401
12300,9533,1211,4652,852,8321,778,376,402
12305,9536,1212,4653,853,8324,778,376,402
12310,9541,1213,4654,853,8328,778,376,402
12315,9545,1213,4656,853,8332,778,376,402
12320,9548,1214,4657,854,8334,778,376,402
12325,9549,1214,4658,854,8335,778,376,402
12330,9554,1215,4660,854,8339,778,376,402
12335,9556,1215,4661,854,8341,779,376,403
12340,9564,1215,4666,854,8349,779,376,403
12345,9567,1215,4667,854,8352,779,376,403
12350,9572,1216,4669,854,8356,779,376,403
12355,9576,1216,4670,854,8360,779,376,403
12360,9579,1217,4672,855,8362,779,376,403
12365,9580,1217,4672,855,8363,779,376,403
12370,9585,1218,4676,855,8367,779,376,403
12375,9587,1218,4678,855,8369,780,377,403
12380,9595,1219,4684,856,8376,781,378,403
12385,9598,1219,4685,856,8379,781,378,403
12390,9603,1220,4690,857,8383,781,378,403
12395,9607,1220,4691,857,8387,781,378,403
12400,9610,1221,4694,858,8389,781,378,403
12405,9611,1222,4695,859,8389,781,378,403
12410,9616,1223,4697,860,8393,782,378,404
12415,9618,1223,4698,860,8395,783,378,405
12420,9626,1225,4702,862,8401,784,379,405
12425,9629,1225,4704,862,8404,784,379,405
12430,9634,1225,4708,862,8409,784,379,405
12435,9638,1225,4710,862,8413,784,379,405
12440,9641,1225,4710,862,8416,784,379,405
12445,9642,1226,4711,863,8416,784,379,405
12450,9647,1227,4714,863,8420,784,379,405
12455,9649,1227,4714,863,8422,785,379,406
12460,9657,1228,4721,864,8429,785,379,406
12465,9660,1228,4723,864,8432,785,379,406
12470,9665,1228,4726,864,8437,785,379,406
12475,9669,1228,4728,864,8440,785,379,406
12480,9672,1229,4730,865,8443,785,379,406
12485,9673,1229,4730,865,8444,785,379,406
12490,9678,1230,4732,865,8448,785,379,406
12495,9680,1230,4733,865,8450,786,379,407
12500,9688,1231,4736,865,8457,786,379,407
12505,9691,1231,4737,865,8460,786,379,407
12510,9696,1231,4740,865,8465,786,379,407
12515,9700,1231,4742,865,8469,786,379,407
12520,9703,1231,4743,865,8472,786,379,407
12525,9704,1231,4744,865,8473,786,379,407
12530,9709,1232,4745,865,8477,787,379,408
12535,9711,1232,4746,865,8479,788,379,409
12540,9719,1233,4751,866,8486,788,379,409
12545,9722,1233,4752,866,8489,788,379,409
12550,9727,1233,4754,866,8494,788,379,409
12555,9731,1233,4756,866,8497,788,379,409
12560,9734,1234,4759,867,8500,788,379,409
12565,9735,1234,4759,867,8501,788,379,409
12570,9740,1235,4762,868,8505,788,379,409
12575,9742,1235,4762,868,8507,789,379,410
12580,9750,1236,4769,869,8514,789,379,410
12585,9753,1236,4771,869,8517,789,379,410
12590,9758,1236,4772,869,8522,789,379,410
12595,9762,1236,4774,869,8526,789,379,410
12600,9765,1237,4776,870,8528,789,379,410
12605,9766,1238,4777,871,8528,789,379,410
12610,9771,1239,4779,871,8532,789,379,410
12615,9773,1239,4780,871,8534,790,379,411
12620,9781,1241,4783,872,8540,790,379,411
12625,9784,1241,4784,872,8543,790,379,411
12630,9789,1242,4787,872,8547,790,379,411
12635,9793,1242,4789,872,8551,790,379,411
12640,9796,1242,4790,872,8554,790,379,411
12645,9797,1243,4791,873,8554,790,379,411
12650,9802,1244,4793,873,8558,791,379,412
12655,9804,1244,4793,873,8560,792,379,413
12660,9812,1245,4795,874,8567,792,379,413
12665,9815,1245,4796,874,8570,792,379,413
12670,9820,1245,4796,874,8575,792,379,413
12675,9824,1245,4798,874,8579,792,379,413
12680,9827,1245,4799,874,8582,792,379,413
12685,9828,1245,4800,874,8583,792,379,413
12690,9833,1246,4804,874,8587,793,380,413
12695,9835,1246,4805,874,8589,794,381,413
12700,9843,1248,4809,875,8595,794,381,413
12705,9846,1248,4810,875,8598,794,381,413
12710,9851,1248,4811,875,8603,794,381,413
12715,9855,1248,4814,875,8606,794,381,413
12720,9858,1249,4816,876,8609,794,381,413
12725,9859,1249,4817,876,8610,794,381,413
12730,9864,1250,4819,877,8614,794,381,413
12735,9866,1250,4821,877,8616,795,382,413
12740,9874,1252,4825,878,8622,795,382,413
12745,9877,1252,4827,878,8625,795,382,413
12750,9882,1252,4830,878,8630,795,382,413
12755,9886,1252,4833,878,8633,795,382,413
12760,9889,1253,4834,879,8636,795,382,413
12765,9890,1254,4835,880,8636,795,382,413
12770,9895,1255,4837,880,8640,795,382,413
12775,9897,1255,4838,880,8642,796,383,413
12780,9905,1256,4843,881,8649,796,383,413
12785,9908,1256,4845,881,8652,796,383,413
12790,9913,1257,4848,882,8656,796,383,413
12795,9917,1257,4850,882,8660,796,383,413
12800,9920,1257,4852,882,8663,796,383,413
12805,9921,1257,4852,882,8664,796,383,413
12810,9926,1258,4854,882,8668,797,383,414
12815,9928,1258,4855,882,8670,798,383,415
12820,9936,1260,4859,884,8676,798,383,415
12825,9939,1260,4861,884,8679,798,383,415
12830,9944,1261,4862,884,8683,798,383,415
12835,9948,1261,4863,884,8687,798,383,415
12840,9951,1262,4865,885,8689,798,383,415
12845,9952,1262,4865,885,8690,798,383,415
12850,9957,1262,4867,885,8695,798,383,415
12855,9959,1262,4868,885,8697,799,384,415
12860,9967,1263,4871,885,8704,799,384,415
12865,9970,1263,4872,885,8707,799,384,415
12870,9975,1264,4873,885,8711,799,384,415
12875,9979,1264,4874,885,8715,799,384,415
12880,9982,1265,4876,886,8717,799,384,415
12885,9983,1265,4876,886,8718,799,384,415
12890,9988,1265,4878,886,8723,799,384,415
12895,9990,1265,4878,886,8725,800,384,416
12900,9998,1266,4879,886,8732,800,384,416
12905,10001,1266,4880,886,8735,800,384,416
12910,10006,1267,4882,886,8739,800,384,416
12915,10010,1267,4884,886,8743,800,384,416
12920,10013,1268,4885,887,8745,800,384,416
12925,10014,1268,4886,887,8746,800,384,416
12930,10019,1268,4889,887,8751,800,384,416
12935,10021,1268,4891,887,8753,801,385,416
12940,10029,1269,4896,888,8760,801,385,416
12945,10032,1269,4898,888,8763,801,385,416
12950,10037,1270,4900,888,8767,801,385,416
12955,10041,1270,4901,888,8770,801,385,416
12960,10044,1271,4901,889,8773,801,385,416
12965,10045,1271,4901,889,8774,801,385,416
12970,10050,1272,4904,889,8778,801,385,416
12975,10052,1272,4906,889,8780,802,386,416
12980,10060,1273,4909,889,8787,803,386,417
12985,10063,1274,4911,890,8789,803,386,417
12990,10068,1275,4915,890,8793,803,386,417
12995,10072,1275,4916,890,8797,803,386,417
13000,10075,1275,4916,890,8800,803,386,417
13005,10076,1276,4917,891,8800,803,386,417
13010,10081,1277,4920,891,8804,803,386,417
13015,10083,1277,4922,891,8806,804,387,417
13020,10091,1279,4926,892,8812,805,387,418
13025,10094,1279,4926,892,8815,805,387,418
13030,10099,1279,4927,892,8820,805,387,418
13035,10103,1279,4928,892,8824,805,387,418
13040,10106,1279,4929,892,8827,805,387,418
13045,10107,1279,4929,892,8828,805,387,418
13050,10112,1280,4932,893,8832,805,387,418
13055,10114,1280,4934,893,8834,806,388,418
13060,10122,1282,4940,894,8840,806,388,418
13065,10125,1282,4942,894,8843,806,388,418
13070,10130,1282,4946,894,8848,806,388,418
13075,10134,1282,4948,894,8852,806,388,418
13080,10137,1282,4951,894,8855,806,388,418
13085,10138,1282,4951,894,8856,806,388,418
13090,10143,1283,4952,894,8860,806,388,418
13095,10145,1283,4953,894,8862,807,388,419
13100,10153,1283,4957,894,8870,807,388,419
13105,10156,1283,4959,894,8873,807,388,419
13110,10161,1283,4960,894,8878,807,388,419
13115,10165,1283,4962,894,8882,807,388,419
13120,10168,1283,4964,894,8885,807,388,419
13125,10169,1283,4965,894,8886,807,388,419
13130,10174,1284,4969,895,8890,807,388,419
13135,10176,1284,4970,895,8892,808,389,419
13140,10184,1285,4971,896,8899,808,389,419
13145,10187,1285,4973,896,8902,808,389,419
13150,10192,1286,4976,896,8906,808,389,419
13155,10196,1286,4978,896,8910,808,389,419
13160,10199,1286,4979,896,8913,808,389,419
13165,10200,1286,4979,896,8914,808,389,419
13170,10205,1286,4981,896,8919,808,389,419
13175,10207,1286,4981,896,8921,809,389,420
13180,10215,1286,4985,896,8929,810,389,421
13185,10218,1286,4986,896,8932,810,389,421
13190,10223,1287,4989,897,8936,810,389,421
13195,10227,1287,4990,897,8940,810,389,421
13200,10230,1288,4992,898,8942,810,389,421
13205,10231,1288,4992,898,8943,810,389,421
13210,10236,1289,4994,898,8947,811,389,422
13215,10238,1289,4995,898,8949,812,390,422
13220,10246,1291,5001,900,8955,812,390,422
13225,10249,1291,5003,900,8958,812,390,422
13230,10254,1292,5005,901,8962,812,390,422
13235,10258,1292,5006,901,8966,812,390,422
13240,10261,1292,5007,901,8969,812,390,422
13245,10262,1292,5007,901,8970,812,390,422
13250,10267,1293,5008,901,8974,813,390,423
13255,10269,1293,5010,901,8976,814,391,423
13260,10277,1294,5013,901,8983,814,391,423
13265,10280,1294,5013,901,8986,814,391,423
13270,10285,1294,5015,901,8991,814,391,423
13275,10289,1294,5018,901,8994,814,391,423
13280,10292,1295,5019,902,8997,814,391,423
13285,10293,1295,5020,902,8998,814,391,423
13290,10298,1296,5021,902,9002,815,391,424
13295,10300,1296,5022,902,9004,816,392,424
13300,10308,1298,5026,904,9010,816,392,424
13305,10311,1298,5027,904,9013,816,392,424
13310,10316,1298,5032,904,9018,816,392,424
13315,10320,1298,5035,904,9021,816,392,424
13320,10323,1299,5038,905,9024,816,392,424
13325,10324,1299,5039,905,9025,816,392,424
13330,10329,1300,5041,905,9029,816,392,424
13335,10331,1300,5043,905,9031,817,393,424
13340,10339,1301,5045,905,9038,817,393,424
13345,10342,1301,5047,905,9041,817,393,424
13350,10347,1301,5051,905,9046,817,393,424
13355,10351,1301,5053,905,9050,817,393,424
13360,10354,1301,5054,905,9053,817,393,424
13365,10355,1301,5054,905,9054,817,393,424
13370,10360,1302,5056,905,9058,817,393,424
13375,10362,1302,5057,905,9060,818,394,424
13380,10370,1303,5060,906,9067,818,394,424
13385,10373,1303,5062,906,9070,818,394,424
13390,10378,1304,5067,907,9074,818,394,424
13395,10382,1304,5070,907,9078,818,394,424
13400,10385,1305,5073,908,9080,818,394,424
13405,10386,1306,5074,909,9080,818,394,424
13410,10391,1307,5078,910,9084,818,394,424
13415,10393,1307,5079,910,9086,819,395,424
13420,10401,1308,5085,911,9093,819,395,424
13425,10404,1308,5085,911,9096,819,395,424
13430,10409,1309,5089,912,9100,819,395,424
13435,10413,1309,5091,912,9104,819,395,424
13440,10416,1309,5092,912,9107,819,395,424
13445,10417,1309,5093,912,9108,819,395,424
13450,10422,1309,5096,912,9113,820,396,424
13455,10424,1309,5098,912,9115,821,397,424
13460,10432,1310,5102,913,9122,821,397,424
13465,10435,1310,5103,913,9125,821,397,424
13470,10440,1311,5105,913,9129,821,397,424
13475,10444,1311,5105,913,9133,821,397,424
13480,10447,1311,5106,913,9136,821,397,424
13485,10448,1311,5107,913,9137,821,397,424
13490,10453,1311,5108,913,9142,822,397,425
13495,10455,1311,5109,913,9144,823,397,426
13500,10463,1312,5113,913,9151,823,397,426
13505,10466,1312,5114,913,9154,823,397,426
13510,10471,1313,5115,913,9158,823,397,426
13515,10475,1313,5118,913,9162,823,397,426
13520,10478,1314,5120,914,9164,823,397,426
13525,10479,1314,5121,914,9165,823,397,426
13530,10484,1314,5121,914,9170,824,397,427
13535,10486,1314,5123,914,9172,825,398,427
13540,10494,1315,5126,914,9179,825,398,427
13545,10497,1315,5127,914,9182,825,398,427
13550,10502,1316,5129,914,9186,825,398,427
13555,10506,1316,5131,914,9189,825,398,427
13560,10509,1318,5134,916,9191,825,398,427
13565,10510,1319,5135,917,9191,825,398,427
13570,10515,1320,5137,917,9195,826,398,428
13575,10517,1320,5137,917,9197,827,398,429
13580,10525,1322,5140,918,9203,828,399,429
13585,10528,1323,5143,919,9205,828,399,429
13590,10533,1324,5145,920,9209,828,399,429
13595,10537,1324,5148,920,9213,828,399,429
13600,10540,1325,5150,921,9215,828,399,429
13605,10541,1326,5151,922,9215,828,399,429
13610,10546,1327,5155,923,9219,828,399,429
13615,10548,1327,5156,923,9221,829,399,430
13620,10556,1328,5161,924,9228,830,400,430
13625,10559,1328,5164,924,9231,830,400,430
13630,10564,1328,5166,924,9236,830,400,430
13635,10568,1328,5168,924,9240,830,400,430
13640,10571,1328,5168,924,9243,830,400,430
13645,10572,1328,5168,924,9244,830,400,430
13650,10577,1329,5172,924,9248,830,400,430
13655,10579,1329,5173,924,9250,831,400,431
13660,10587,1331,5176,925,9256,831,400,431
13665,10590,1331,5176,925,9259,831,400,431
13670,10595,1331,5177,925,9264,831,400,431
13675,10599,1331,5177,925,9268,831,400,431
13680,10602,1331,5179,925,9271,831,400,431
13685,10603,1331,5180,925,9272,831,400,431
13690,10608,1332,5182,926,9276,831,400,431
13695,10610,1332,5184,926,9278,832,401,431
13700,10618,1335,5188,929,9283,833,401,432
13705,10621,1335,5191,929,9286,833,401,432
13710,10626,1335,5194,929,9291,833,401,432
13715,10630,1335,5197,929,9295,833,401,432
13720,10633,1335,5200,929,9298,833,401,432
13725,10634,1335,5200,929,9299,833,401,432
13730,10639,1336,5202,929,9303,834,401,433
13735,10641,1336,5202,929,9305,835,401,434
13740,10649,1337,5204,930,9312,837,402,435
13745,10652,1337,5205,930,9315,837,402,435
13750,10657,1338,5206,931,9319,837,402,435
13755,10661,1338,5208,931,9322,837,402,435
13760,10664,1339,5210,932,9325,837,402,435
13765,10665,1339,5210,932,9326,837,402,435
13770,10670,1339,5213,932,9331,837,402,435
13775,10672,1339,5215,932,9333,838,403,435
13780,10680,1339,5218,932,9341,838,403,435
13785,10683,1339,5219,932,9344,838,403,435
13790,10688,1340,5222,933,9348,838,403,435
13795,10692,1340,5223,933,9352,838,403,435
13800,10695,1340,5224,933,9355,838,403,435
13805,10696,1340,5225,933,9356,838,403,435
13810,10701,1340,5228,933,9361,838,403,435
13815,10703,1340,5230,933,9363,839,404,435
13820,10711,1340,5234,933,9371,839,404,435
13825,10714,1340,5234,933,9374,839,404,435
13830,10719,1341,5236,933,9378,839,404,435
13835,10723,1341,5238,933,9381,839,404,435
13840,10726,1343,5241,935,9383,839,404,435
13845,10727,1343,5242,935,9384,839,404,435
13850,10732,1344,5245,936,9388,840,405,435
13855,10734,1344,5246,936,9390,841,405,436
13860,10742,1345,5250,937,9396,843,406,437
13865,10745,1346,5252,938,9399,843,406,437
13870,10750,1346,5253,938,9404,843,406,437
13875,10754,1346,5254,938,9408,843,406,437
13880,10757,1346,5256,938,9411,843,406,437
13885,10758,1346,5256,938,9412,843,406,437
13890,10763,1347,5259,939,9416,843,406,437
13895,10765,1347,5260,939,9418,844,406,438
13900,10773,1349,5264,941,9424,844,406,438
13905,10776,1349,5265,941,9427,844,406,438
13910,10781,1349,5267,941,9432,844,406,438
13915,10785,1349,5271,941,9436,844,406,438
13920,10788,1349,5273,941,9439,844,406,438
13925,10789,1349,5274,941,9440,844,406,438
13930,10794,1350,5276,941,9444,844,406,438
13935,10796,1350,5278,941,9446,845,407,438
13940,10804,1352,5282,942,9452,845,407,438
13945,10807,1352,5284,942,9455,845,407,438
13950,10812,1352,5287,942,9460,845,407,438
13955,10816,1352,5290,942,9464,845,407,438
13960,10819,1352,5291,942,9467,845,407,438
13965,10820,1352,5292,942,9468,845,407,438
13970,10825,1353,5294,943,9472,846,407,439
13975,10827,1353,5295,943,9474,847,407,440
13980,10835,1356,5300,945,9479,849,409,440
13985,10838,1356,5301,945,9482,849,409,440
13990,10843,1357,5303,945,9486,849,409,440
13995,10847,1357,5303,945,9490,849,409,440
14000,10850,1357,5303,945,9493,849,409,440
14005,10851,1357,5303,945,9494,849,409,440
14010,10856,1358,5304,946,9498,849,409,440
14015,10858,1358,5305,946,9500,850,410,440
14020,10866,1359,5311,947,9507,850,410,440
14025,10869,1359,5312,947,9510,850,410,440
14030,10874,1360,5315,947,9514,850,410,440
14035,10878,1360,5317,947,9518,850,410,440
14040,10881,1360,5318,947,9521,850,410,440
14045,10882,1360,5319,947,9522,850,410,440
14050,10887,1361,5322,948,9526,850,410,440
14055,10889,1361,5323,948,9528,851,410,441
14060,10897,1362,5328,949,9535,851,410,441
14065,10900,1362,5331,949,9538,851,410,441
14070,10905,1363,5334,949,9542,851,410,441
14075,10909,1363,5336,949,9545,851,410,441
14080,10912,1364,5336,950,9548,851,410,441
14085,10913,1364,5337,950,9549,851,410,441
14090,10918,1365,5340,950,9553,851,410,441
14095,10920,1365,5341,950,9555,852,410,442
14100,10928,1368,5346,953,9559,854,411,443
14105,10931,1369,5347,954,9562,854,411,443
14110,10936,1369,5351,954,9567,854,411,443
14115,10940,1369,5352,954,9571,854,411,443
14120,10943,1369,5354,954,9574,854,411,443
14125,10944,1369,5355,954,9575,854,411,443
14130,10949,1370,5359,954,9579,854,411,443
14135,10951,1370,5361,954,9581,855,412,443
14140,10959,1372,5367,955,9587,855,412,443
14145,10962,1372,5368,955,9590,855,412,443
14150,10967,1372,5369,955,9595,855,412,443
14155,10971,1372,5372,955,9599,855,412,443
14160,10974,1372,5373,955,9602,855,412,443
14165,10975,1373,5374,956,9602,855,412,443
14170,10980,1374,5377,957,9606,855,412,443
14175,10982,1374,5378,957,9608,856,413,443
14180,10990,1375,5381,957,9615,856,413,443
14185,10993,1375,5384,957,9618,856,413,443
14190,10998,1375,5387,957,9623,856,413,443
14195,11002,1375,5390,957,9627,856,413,443
14200,11005,1375,5393,957,9630,856,413,443
14205,11006,1375,5393,957,9631,856,413,443
14210,11011,1376,5396,958,9635,856,413,443
14215,11013,1376,5397,958,9637,857,414,443
14220,11021,1377,5401,959,9644,859,415,444
14225,11024,1377,5402,959,9647,859,415,444
14230,11029,1378,5405,959,9651,859,415,444
14235,11033,1378,5409,959,9654,859,415,444
14240,11036,1379,5409,960,9657,859,415,444
14245,11037,1380,5410,961,9657,859,415,444
14250,11042,1381,5410,961,9661,859,415,444
14255,11044,1381,5411,961,9663,860,416,444
14260,11052,1381,5415,961,9671,860,416,444
14265,11055,1381,5416,961,9674,860,416,444
14270,11060,1382,5419,961,9678,860,416,444
14275,11064,1382,5421,961,9682,860,416,444
14280,11067,1382,5422,961,9685,860,416,444
14285,11068,1382,5422,961,9686,860,416,444
14290,11073,1383,5425,961,9690,860,416,444
14295,11075,1383,5426,961,9692,861,416,445
14300,11083,1383,5429,961,9700,861,416,445
14305,11086,1383,5431,961,9703,861,416,445
14310,11091,1384,5432,961,9707,861,416,445
14315,11095,1384,5434,961,9711,861,416,445
14320,11098,1385,5437,962,9713,861,416,445
14325,11099,1385,5438,962,9714,861,416,445
14330,11104,1386,5440,963,9718,861,416,445
14335,11106,1386,5440,963,9720,862,416,446
14340,11114,1388,5444,964,9725,864,418,446
14345,11117,1389,5446,965,9728,864,418,446
14350,11122,1389,5449,965,9733,864,418,446
14355,11126,1389,5450,965,9737,864,418,446
14360,11129,1389,5453,965,9740,864,418,446
14365,11130,1389,5454,965,9741,864,418,446
14370,11135,1390,5456,965,9745,864,418,446
14375,11137,1390,5456,965,9747,865,418,447
14380,11145,1390,5461,965,9755,865,418,447
14385,11148,1390,5462,965,9758,865,418,447
14390,11153,1390,5466,965,9763,865,418,447
14395,11157,1390,5466,965,9767,865,418,447
14400,11160,1390,5468,965,9770,865,418,447
14405,11161,1391,5469,966,9770,865,418,447
14410,11166,1392,5471,967,9774,865,418,447
14415,11168,1392,5472,967,9776,866,418,448
14420,11176,1394,5474,969,9782,868,418,450
14425,11179,1394,5475,969,9785,868,418,450
14430,11184,1394,5477,969,9790,868,418,450
14435,11188,1394,5479,969,9794,868,418,450
14440,11191,1394,5480,969,9797,868,418,450
14445,11192,1395,5481,970,9797,868,418,450
14450,11197,1396,5485,970,9801,868,418,450
14455,11199,1396,5486,970,9803,869,418,451
14460,11207,1399,5489,972,9807,871,418,453
14465,11210,1400,5492,973,9810,871,418,453
14470,11215,1401,5494,974,9814,871,418,453
14475,11219,1401,5497,974,9817,871,418,453
14480,11222,1403,5499,976,9819,871,418,453
14485,11223,1403,5499,976,9820,871,418,453
14490,11228,1404,5503,977,9824,871,418,453
14495,11230,1404,5503,977,9826,872,418,454
14500,11238,1405,5509,978,9833,873,419,454
14505,11241,1405,5511,978,9836,873,419,454
14510,11246,1406,5513,978,9840,873,419,454
14515,11250,1406,5515,978,9844,873,419,454
14520,11253,1407,5518,979,9846,873,419,454
14525,11254,1407,5519,979,9847,873,419,454
14530,11259,1408,5523,979,9851,873,419,454
14535,11261,1408,5524,979,9853,874,419,455
14540,11269,1410,5529,980,9859,874,419,455
14545,11272,1410,5530,980,9862,874,419,455
14550,11277,1410,5532,980,9867,874,419,455
14555,11281,1410,5533,980,9871,874,419,455
14560,11284,1410,5536,980,9874,874,419,455
14565,11285,1411,5537,981,9874,874,419,455
14570,11290,1412,5538,981,9878,874,419,455
14575,11292,1412,5539,981,9880,875,420,455
14580,11300,1413,5542,982,9887,876,421,455
14585,11303,1413,5543,982,9890,876,421,455
14590,11308,1413,5544,982,9895,876,421,455
14595,11312,1413,5547,982,9899,876,421,455
14600,11315,1413,5550,982,9902,876,421,455
14605,11316,1414,5551,983,9902,876,421,455
14610,11321,1415,5553,983,9906,876,421,455
14615,11323,1415,5553,983,9908,877,421,456
14620,11331,1417,5557,985,9914,877,421,456
14625,11334,1417,5559,985,9917,877,421,456
14630,11339,1418,5561,985,9921,877,421,456
14635,11343,1418,5563,985,9925,877,421,456
14640,11346,1418,5563,985,9928,877,421,456
14645,11347,1418,5563,985,9929,877,421,456
14650,11352,1419,5565,985,9933,877,421,456
14655,11354,1419,5566,985,9935,878,421,457
14660,11362,1420,5567,985,9942,878,421,457
14665,11365,1420,5569,985,9945,878,421,457
14670,11370,1421,5571,986,9949,878,421,457
14675,11374,1421,5573,986,9953,878,421,457
14680,11377,1421,5574,986,9956,878,421,457
14685,11378,1421,5574,986,9957,878,421,457
14690,11383,1422,5576,987,9961,878,421,457
14695,11385,1422,5577,987,9963,879,421,458
14700,11393,1425,5581,989,9968,880,422,458
14705,11396,1425,5583,989,9971,880,422,458
14710,11401,1426,5584,990,9975,880,422,458
14715,11405,1426,5585,990,9979,880,422,458
14720,11408,1426,5587,990,9982,880,422,458
14725,11409,1426,5588,990,9983,880,422,458
14730,11414,1427,5590,990,9987,881,423,458
14735,11416,1427,5591,990,9989,882,423,459
14740,11424,1427,5593,990,9997,882,423,459
14745,11427,1427,5594,990,10000,882,423,459
14750,11432,1428,5596,990,10004,882,423,459
14755,11436,1428,5597,990,10008,882,423,459
14760,11439,1429,5599,991,10010,882,423,459
14765,11440,1430,5600,992,10010,882,423,459
14770,11445,1431,5604,993,10014,882,423,459
14775,11447,1431,5605,993,10016,883,424,459
14780,11455,1431,5607,993,10024,884,424,460
14785,11458,1431,5608,993,10027,884,424,460
14790,11463,1432,5611,994,10031,884,424,460
14795,11467,1432,5614,994,10035,884,424,460
14800,11470,1433,5616,995,10037,884,424,460
14805,11471,1433,5616,995,10038,884,424,460
14810,11476,1434,5619,996,10042,884,424,460
14815,11478,1434,5620,996,10044,885,425,460
14820,11486,1436,5623,998,10050,887,425,462
14825,11489,1436,5626,998,10053,887,425,462
14830,11494,1436,5629,998,10058,887,425,462
14835,11498,1436,5629,998,10062,887,425,462
14840,11501,1436,5631,998,10065,887,425,462
14845,11502,1436,5631,998,10066,887,425,462
14850,11507,1437,5633,999,10070,887,425,462
14855,11509,1437,5635,999,10072,888,426,462
14860,11517,1439,5636,1000,10078,888,426,462
14865,11520,1439,5637,1000,10081,888,426,462
14870,11525,1439,5639,1000,10086,888,426,462
14875,11529,1439,5641,1000,10090,888,426,462
14880,11532,1439,5641,1000,10093,888,426,462
14885,11533,1439,5641,1000,10094,888,426,462
14890,11538,1440,5643,1000,10098,889,426,463
14895,11540,1440,5644,1000,10100,890,427,463
14900,11548,1441,5644,1000,10107,890,427,463
14905,11551,1441,5645,1000,10110,890,427,463
14910,11556,1441,5649,1000,10115,890,427,463
14915,11560,1441,5650,1000,10118,890,427,463
14920,11563,1442,5652,1001,10121,890,427,463
14925,11564,1442,5652,1001,10122,890,427,463
14930,11569,1443,5653,1001,10126,890,427,463
14935,11571,1443,5653,1001,10128,891,427,464
14940,11579,1445,5656,1002,10133,893,427,466
14945,11582,1446,5656,1003,10136,893,427,466
14950,11587,1447,5658,1003,10140,893,427,466
14955,11591,1447,5659,1003,10144,893,427,466
14960,11594,1447,5661,1003,10147,893,427,466
14965,11595,1447,5661,1003,10148,893,427,466
14970,11600,1448,5663,1004,10152,893,427,466
14975,11602,1448,5665,1004,10154,894,428,466
14980,11610,1449,5668,1005,10161,894,428,466
14985,11613,1449,5670,1005,10164,894,428,466
14990,11618,1450,5673,1005,10168,894,428,466
14995,11622,1450,5675,1005,10172,894,428,466
15000,11625,1450,5675,1005,10175,894,428,466
15005,11626,1451,5676,1006,10175,894,428,466
15010,11631,1452,5678,1006,10179,894,428,466
15015,11633,1452,5679,1006,10181,895,428,467
15020,11641,1453,5683,1007,10188,895,428,467
15025,11644,1453,5684,1007,10191,895,428,467
15030,11649,1454,5687,1008,10195,895,428,467
15035,11653,1454,5689,1008,10199,895,428,467
15040,11656,1455,5691,1009,10201,895,428,467
15045,11657,1455,5691,1009,10202,895,428,467
15050,11662,1456,5691,1009,10206,895,428,467
15055,11664,1456,5692,1009,10208,896,428,468
15060,11672,1459,5697,1012,10213,898,428,470
15065,11675,1459,5698,1012,10216,898,428,470
15070,11680,1460,5700,1013,10220,898,428,470
15075,11684,1460,5703,1013,10223,898,428,470
15080,11687,1462,5704,1015,10225,898,428,470
15085,11688,1462,5704,1015,10226,898,428,470
15090,11693,1463,5705,1015,10230,899,428,471
15095,11695,1463,5705,1015,10232,900,428,472
15100,11703,1463,5707,1015,10240,900,428,472
15105,11706,1463,5709,1015,10243,900,428,472
15110,11711,1464,5713,1015,10247,900,428,472
15115,11715,1464,5717,1015,10250,900,428,472
15120,11718,1465,5718,1016,10253,900,428,472
15125,11719,1465,5719,1016,10254,900,428,472
15130,11724,1466,5720,1016,10258,900,428,472
15135,11726,1466,5720,1016,10260,901,428,473
15140,11734,1466,5725,1016,10268,901,428,473
15145,11737,1466,5728,1016,10271,901,428,473
15150,11742,1466,5731,1016,10276,901,428,473
15155,11746,1466,5733,1016,10280,901,428,473
15160,11749,1466,5735,1016,10283,901,428,473
15165,11750,1466,5736,1016,10284,901,428,473
15170,11755,1467,5739,1017,10288,901,428,473
15175,11757,1467,5740,1017,10290,902,429,473
15180,11765,1470,5744,1020,10295,904,429,475
15185,11768,1470,5745,1020,10298,904,429,475
15190,11773,1470,5747,1020,10303,904,429,475
15195,11777,1470,5749,1020,10307,904,429,475
15200,11780,1470,5750,1020,10310,904,429,475
15205,11781,1470,5750,1020,10311,904,429,475
15210,11786,1471,5753,1020,10315,904,429,475
15215,11788,1471,5753,1020,10317,905,429,476
15220,11796,1472,5756,1021,10324,905,429,476
15225,11799,1472,5758,1021,10327,905,429,476
15230,11804,1473,5759,1021,10331,905,429,476
15235,11808,1473,5759,1021,10335,905,429,476
15240,11811,1473,5760,1021,10338,905,429,476
15245,11812,1473,5760,1021,10339,905,429,476
15250,11817,1474,5762,1022,10343,905,429,476
15255,11819,1474,5764,1022,10345,906,430,476
15260,11827,1475,5768,1023,10352,906,430,476
15265,11830,1475,5771,1023,10355,906,430,476
15270,11835,1476,5775,1024,10359,906,430,476
15275,11839,1476,5775,1024,10363,906,430,476
15280,11842,1476,5777,1024,10366,906,430,476
15285,11843,1476,5777,1024,10367,906,430,476
15290,11848,1477,5779,1024,10371,906,430,476
15295,11850,1477,5780,1024,10373,907,430,477
15300,11858,1479,5783,1025,10378,909,431,478
15305,11861,1481,5786,1027,10380,909,431,478
15310,11866,1482,5790,1028,10384,909,431,478
15315,11870,1482,5793,1028,10388,909,431,478
15320,11873,1482,5793,1028,10391,909,431,478
15325,11874,1482,5793,1028,10392,909,431,478
15330,11879,1483,5797,1028,10396,909,431,478
15335,11881,1483,5798,1028,10398,910,432,478
15340,11889,1484,5803,1029,10405,911,432,479
15345,11892,1484,5805,1029,10408,911,432,479
15350,11897,1485,5808,1030,10412,911,432,479
15355,11901,1485,5811,1030,10416,911,432,479
15360,11904,1486,5813,1031,10418,911,432,479
15365,11905,1486,5813,1031,10419,911,432,479
15370,11910,1487,5815,1031,10423,912,433,479
15375,11912,1487,5816,1031,10425,913,433,480
15380,11920,1488,5823,1032,10432,913,433,480
15385,11923,1488,5825,1032,10435,913,433,480
15390,11928,1489,5827,1032,10439,913,433,480
15395,11932,1489,5829,1032,10443,913,433,480
15400,11935,1489,5830,1032,10446,913,433,480
15405,11936,1489,5831,1032,10447,913,433,480
15410,11941,1490,5832,1033,10451,914,433,481
15415,11943,1490,5832,1033,10453,915,433,482
15420,11951,1493,5837,1036,10458,916,433,483
15425,11954,1493,5838,1036,10461,916,433,483
15430,11959,1493,5841,1036,10466,916,433,483
15435,11963,1493,5843,1036,10469,916,433,483
15440,11966,1494,5845,1037,10472,916,433,483
15445,11967,1495,5846,1038,10472,916,433,483
15450,11972,1496,5846,1038,10476,916,433,483
15455,11974,1496,5847,1038,10478,917,433,484
15460,11982,1497,5851,1038,10485,917,433,484
15465,11985,1497,5853,1038,10488,917,433,484
15470,11990,1497,5856,1038,10493,917,433,484
15475,11994,1497,5857,1038,10497,917,433,484
15480,11997,1497,5857,1038,10500,917,433,484
15485,11998,1497,5857,1038,10501,917,433,484
15490,12003,1498,5860,1039,10505,917,433,484
15495,12005,1498,5862,1039,10507,918,434,484
15500,12013,1500,5866,1040,10513,918,434,484
15505,12016,1500,5868,1040,10516,918,434,484
15510,12021,1501,5870,1041,10520,918,434,484
15515,12025,1501,5873,1041,10523,918,434,484
15520,12028,1502,5875,1042,10526,918,434,484
15525,12029,1502,5876,1042,10527,918,434,484
15530,12034,1503,5878,1042,10531,918,434,484
15535,12036,1503,5879,1042,10533,919,435,484
15540,12044,1504,5883,1043,10540,920,436,484
15545,12047,1504,5885,1043,10543,920,436,484
15550,12052,1505,5885,1043,10547,920,436,484
15555,12056,1505,5887,1043,10551,920,436,484
15560,12059,1506,5890,1044,10553,920,436,484
15565,12060,1506,5891,1044,10554,920,436,484
15570,12065,1507,5894,1045,10558,920,436,484
15575,12067,1507,5895,1045,10560,921,437,484
15580,12075,1508,5899,1045,10567,921,437,484
15585,12078,1508,5901,1045,10570,921,437,484
15590,12083,1509,5904,1046,10574,921,437,484
15595,12087,1509,5905,1046,10578,921,437,484
15600,12090,1510,5908,1047,10580,921,437,484
15605,12091,1511,5909,1048,10580,921,437,484
15610,12096,1512,5914,1049,10584,922,438,484
15615,12098,1512,5914,1049,10586,923,438,485
15620,12106,1513,5917,1049,10593,924,438,486
15625,12109,1514,5918,1050,10595,924,438,486
15630,12114,1515,5919,1050,10599,924,438,486
15635,12118,1515,5921,1050,10603,924,438,486
15640,12121,1516,5924,1051,10605,924,438,486
15645,12122,1517,5925,1052,10605,924,438,486
15650,12127,1518,5929,1053,10609,925,439,486
15655,12129,1518,5930,1053,10611,926,439,487
15660,12137,1520,5936,1054,10616,928,441,487
15665,12140,1521,5937,1055,10619,928,441,487
15670,12145,1522,5939,1056,10623,928,441,487
15675,12149,1522,5939,1056,10627,928,441,487
15680,12152,1523,5941,1057,10629,928,441,487
15685,12153,1523,5941,1057,10630,928,441,487
15690,12158,1524,5944,1058,10634,928,441,487
15695,12160,1524,5944,1058,10636,929,441,488
15700,12168,1525,5949,1059,10643,929,441,488
15705,12171,1525,5951,1059,10646,929,441,488
15710,12176,1526,5953,1060,10650,929,441,488
15715,12180,1526,5955,1060,10654,929,441,488
15720,12183,1526,5956,1060,10657,929,441,488
15725,12184,1526,5957,1060,10658,929,441,488
15730,12189,1527,5959,1060,10662,929,441,488
15735,12191,1527,5959,1060,10664,930,441,489
15740,12199,1527,5960,1060,10672,930,441,489
15745,12202,1527,5961,1060,10675,930,441,489
15750,12207,1527,5966,1060,10680,930,441,489
15755,12211,1527,5966,1060,10684,930,441,489
15760,12214,1527,5967,1060,10687,930,441,489
15765,12215,1528,5968,1061,10687,930,441,489
15770,12220,1529,5972,1062,10691,930,441,489
15775,12222,1529,5973,1062,10693,931,441,490
15780,12230,1532,5978,1065,10698,933,442,491
15785,12233,1532,5978,1065,10701,933,442,491
15790,12238,1532,5981,1065,10706,933,442,491
15795,12242,1532,5984,1065,10710,933,442,491
15800,12245,1532,5986,1065,10713,933,442,491
15805,12246,1532,5987,1065,10714,933,442,491
15810,12251,1532,5987,1065,10719,933,442,491
15815,12253,1532,5989,1065,10721,934,443,491
15820,12261,1533,5992,1065,10728,934,443,491
15825,12264,1533,5992,1065,10731,934,443,491
15830,12269,1534,5992,1065,10735,934,443,491
15835,12273,1534,5993,1065,10739,934,443,491
15840,12276,1535,5995,1066,10741,934,443,491
15845,12277,1535,5995,1066,10742,934,443,491
15850,12282,1535,5996,1066,10747,934,443,491
15855,12284,1535,5996,1066,10749,935,443,492
15860,12292,1536,6001,1067,10756,935,443,492
15865,12295,1536,6002,1067,10759,935,443,492
15870,12300,1537,6003,1067,10763,935,443,492
15875,12304,1537,6004,1067,10767,935,443,492
15880,12307,1538,6005,1068,10769,935,443,492
15885,12308,1538,6005,1068,10770,935,443,492
15890,12313,1539,6006,1068,10774,935,443,492
15895,12315,1539,6006,1068,10776,936,443,493
15900,12323,1541,6010,1070,10782,938,445,493
15905,12326,1541,6012,1070,10785,938,445,493
15910,12331,1541,6015,1070,10790,938,445,493
15915,12335,1541,6016,1070,10794,938,445,493
15920,12338,1541,6018,1070,10797,938,445,493
15925,12339,1541,6018,1070,10798,938,445,493
15930,12344,1542,6020,1070,10802,938,445,493
15935,12346,1542,6022,1070,10804,939,446,493
15940,12354,1543,6024,1070,10811,939,446,493
15945,12357,1543,6024,1070,10814,939,446,493
15950,12362,1543,6025,1070,10819,939,446,493
15955,12366,1543,6026,1070,10823,939,446,493
15960,12369,1543,6028,1070,10826,939,446,493
15965,12370,1543,6028,1070,10827,939,446,493
15970,12375,1544,6031,1071,10831,939,446,493
15975,12377,1544,6031,1071,10833,940,446,494
15980,12385,1545,6032,1071,10840,940,446,494
15985,12388,1545,6032,1071,10843,940,446,494
15990,12393,1545,6033,1071,10848,940,446,494
15995,12397,1545,6036,1071,10852,940,446,494
16000,12400,1545,6036,1071,10855,940,446,494
16005,12401,1545,6036,1071,10856,940,446,494
16010,12406,1546,6038,1071,10860,941,447,494
16015,12408,1546,6040,1071,10862,942,448,494
16020,12416,1548,6042,1072,10868,944,448,496
16025,12419,1548,6044,1072,10871,944,448,496
16030,12424,1549,6045,1072,10875,944,448,496
16035,12428,1549,6046,1072,10878,944,448,496
16040,12431,1551,6048,1074,10880,944,448,496
16045,12432,1551,6048,1074,10881,944,448,496
16050,12437,1552,6050,1075,10885,944,448,496
16055,12439,1552,6051,1075,10887,945,449,496
16060,12447,1553,6054,1076,10894,945,449,496
16065,12450,1553,6055,1076,10897,945,449,496
16070,12455,1554,6060,1077,10901,945,449,496
16075,12459,1554,6063,1077,10904,945,449,496
16080,12462,1555,6065,1078,10907,945,449,496
16085,12463,1555,6065,1078,10908,945,449,496
16090,12468,1556,6065,1078,10912,946,449,497
16095,12470,1556,6065,1078,10914,947,449,498
16100,12478,1556,6066,1078,10922,947,449,498
16105,12481,1556,6068,1078,10925,947,449,498
16110,12486,1556,6072,1078,10930,947,449,498
16115,12490,1556,6074,1078,10934,947,449,498
16120,12493,1556,6076,1078,10937,947,449,498
16125,12494,1556,6076,1078,10938,947,449,498
16130,12499,1557,6078,1078,10942,948,450,498
16135,12501,1557,6080,1078,10944,949,451,498
16140,12509,1560,6083,1080,10949,951,451,500
16145,12512,1560,6084,1080,10952,951,451,500
16150,12517,1560,6084,1080,10957,951,451,500
16155,12521,1560,6085,1080,10960,951,451,500
16160,12524,1561,6088,1081,10963,951,451,500
16165,12525,1561,6088,1081,10964,951,451,500
16170,12530,1562,6091,1081,10968,951,451,500
16175,12532,1562,6092,1081,10970,952,452,500
16180,12540,1563,6096,1081,10977,952,452,500
16185,12543,1563,6097,1081,10980,952,452,500
16190,12548,1564,6101,1082,10984,952,452,500
16195,12552,1564,6102,1082,10987,952,452,500
16200,12555,1565,6102,1083,10990,952,452,500
16205,12556,1565,6102,1083,10991,952,452,500
16210,12561,1566,6104,1083,10995,952,452,500
16215,12563,1566,6106,1083,10997,953,453,500
16220,12571,1568,6109,1084,11003,953,453,500
16225,12574,1568,6110,1084,11006,953,453,500
16230,12579,1569,6113,1085,11010,953,453,500
16235,12583,1569,6116,1085,11014,953,453,500
16240,12586,1569,6117,1085,11017,953,453,500
16245,12587,1570,6118,1086,11017,953,453,500
16250,12592,1571,6119,1086,11021,953,453,500
16255,12594,1571,6120,1086,11023,954,453,501
16260,12602,1572,6125,1087,11030,956,454,502
16265,12605,1573,6127,1088,11032,956,454,502
16270,12610,1574,6130,1089,11036,956,454,502
16275,12614,1574,6132,1089,11040,956,454,502
16280,12617,1575,6134,1090,11042,956,454,502
16285,12618,1575,6134,1090,11043,956,454,502
16290,12623,1576,6136,1090,11047,956,454,502
16295,12625,1576,6138,1090,11049,957,455,502
16300,12633,1578,6143,1091,11055,959,456,503
16305,12636,1579,6144,1092,11057,959,456,503
16310,12641,1580,6147,1093,11061,959,456,503
16315,12645,1580,6148,1093,11065,959,456,503
16320,12648,1581,6149,1094,11067,959,456,503
16325,12649,1581,6149,1094,11068,959,456,503
16330,12654,1582,6152,1095,11072,960,457,503
16335,12656,1582,6152,1095,11074,961,457,504
16340,12664,1582,6155,1095,11082,961,457,504
16345,12667,1582,6158,1095,11085,961,457,504
16350,12672,1583,6159,1095,11089,961,457,504
16355,12676,1583,6162,1095,11092,961,457,504
16360,12679,1584,6163,1096,11095,961,457,504
16365,12680,1584,6164,1096,11096,961,457,504
16370,12685,1585,6167,1097,11100,961,457,504
16375,12687,1585,6168,1097,11102,962,458,504
16380,12695,1585,6171,1097,11110,962,458,504
16385,12698,1585,6174,1097,11113,962,458,504
16390,12703,1586,6175,1097,11117,962,458,504
16395,12707,1586,6175,1097,11121,962,458,504
16400,12710,1587,6177,1098,11123,962,458,504
16405,12711,1587,6177,1098,11124,962,458,504
16410,12716,1588,6179,1099,11128,962,458,504
16415,12718,1588,6179,1099,11130,963,458,505
16420,12726,1589,6181,1100,11137,963,458,505
16425,12729,1589,6183,1100,11140,963,458,505
16430,12734,1590,6186,1101,11144,963,458,505
16435,12738,1590,6188,1101,11148,963,458,505
16440,12741,1590,6188,1101,11151,963,458,505
16445,12742,1591,6189,1102,11151,963,458,505
16450,12747,1592,6189,1102,11155,963,458,505
16455,12749,1592,6189,1102,11157,964,458,506
16460,12757,1593,6190,1102,11164,964,458,506
16465,12760,1593,6192,1102,11167,964,458,506
16470,12765,1594,6195,1103,11171,964,458,506
16475,12769,1594,6197,1103,11175,964,458,506
16480,12772,1595,6198,1104,11177,964,458,506
16485,12773,1596,6199,1105,11177,964,458,506
16490,12778,1597,6200,1105,11181,964,458,506
16495,12780,1597,6201,1105,11183,965,458,507
16500,12788,1598,6206,1106,11190,965,458,507
16505,12791,1598,6207,1106,11193,965,458,507
16510,12796,1599,6210,1106,11197,965,458,507
16515,12800,1599,6213,1106,11200,965,458,507
16520,12803,1600,6214,1107,11203,965,458,507
16525,12804,1600,6214,1107,11204,965,458,507
16530,12809,1601,6216,1108,11208,965,458,507
16535,12811,1601,6217,1108,11210,966,458,508
16540,12819,1602,6220,1109,11217,966,458,508
16545,12822,1602,6222,1109,11220,966,458,508
16550,12827,1603,6226,1110,11224,966,458,508
16555,12831,1603,6228,1110,11227,966,458,508
16560,12834,1605,6230,1112,11229,966,458,508
16565,12835,1605,6230,1112,11230,966,458,508
16570,12840,1606,6232,1113,11234,967,458,509
16575,12842,1606,6234,1113,11236,968,459,509
16580,12850,1608,6239,1114,11242,969,460,509
16585,12853,1609,6241,1115,11244,969,460,509
16590,12858,1609,6243,1115,11249,969,460,509
16595,12862,1609,6244,1115,11253,969,460,509
16600,12865,1609,6247,1115,11256,969,460,509
16605,12866,1609,6247,1115,11257,969,460,509
16610,12871,1610,6251,1115,11261,969,460,509
16615,12873,1610,6252,1115,11263,970,460,510
16620,12881,1612,6256,1117,11269,971,460,511
16625,12884,1612,6258,1117,11272,971,460,511
16630,12889,1612,6260,1117,11277,971,460,511
16635,12893,1612,6262,1117,11280,971,460,511
16640,12896,1613,6263,1118,11283,971,460,511
16645,12897,1613,6264,1118,11284,971,460,511
16650,12902,1614,6266,1119,11288,971,460,511
16655,12904,1614,6267,1119,11290,972,461,511
16660,12912,1615,6271,1119,11297,972,461,511
16665,12915,1615,6272,1119,11300,972,461,511
16670,12920,1616,6273,1119,11304,972,461,511
16675,12924,1616,6275,1119,11307,972,461,511
16680,12927,1617,6275,1120,11310,972,461,511
16685,12928,1617,6275,1120,11311,972,461,511
16690,12933,1617,6278,1120,11316,973,461,512
16695,12935,1617,6280,1120,11318,974,462,512
16700,12943,1617,6283,1120,11326,974,462,512
16705,12946,1617,6285,1120,11329,974,462,512
16710,12951,1618,6287,1120,11333,974,462,512
16715,12955,1618,6290,1120,11337,974,462,512
16720,12958,1619,6292,1121,11339,974,462,512
16725,12959,1619,6292,1121,11340,974,462,512
16730,12964,1619,6294,1121,11345,974,462,512
16735,12966,1619,6296,1121,11347,975,463,512
16740,12974,1619,6301,1121,11355,975,463,512
16745,12977,1619,6303,1121,11358,975,463,512
16750,12982,1620,6307,1122,11362,975,463,512
16755,12986,1620,6310,1122,11366,975,463,512
16760,12989,1620,6311,1122,11369,975,463,512
16765,12990,1620,6312,1122,11370,975,463,512
16770,12995,1620,6315,1122,11375,976,464,512
16775,12997,1620,6317,1122,11377,977,465,512
16780,13005,1620,6321,1122,11385,977,465,512
16785,13008,1620,6323,1122,11388,977,465,512
16790,13013,1621,6325,1122,11392,977,465,512
16795,13017,1621,6328,1122,11395,977,465,512
16800,13020,1622,6328,1123,11398,977,465,512
16805,13021,1622,6329,1123,11399,977,465,512
16810,13026,1623,6332,1124,11403,978,465,513
16815,13028,1623,6334,1124,11405,979,466,513
16820,13036,1625,6339,1125,11411,979,466,513
16825,13039,1625,6341,1125,11414,979,466,513
16830,13044,1625,6344,1125,11419,979,466,513
16835,13048,1625,6346,1125,11423,979,466,513
16840,13051,1625,6348,1125,11426,979,466,513
16845,13052,1626,6349,1126,11426,979,466,513
16850,13057,1627,6352,1127,11430,979,466,513
16855,13059,1627,6353,1127,11432,980,467,513
16860,13067,1628,6358,1128,11439,980,467,513
16865,13070,1628,6358,1128,11442,980,467,513
16870,13075,1628,6361,1128,11447,980,467,513
16875,13079,1628,6363,1128,11451,980,467,513
16880,13082,1628,6364,1128,11454,980,467,513
16885,13083,1628,6364,1128,11455,980,467,513
16890,13088,1629,6366,1129,11459,981,467,514
16895,13090,1629,6367,1129,11461,982,467,515
16900,13098,1630,6368,1129,11468,982,467,515
16905,13101,1630,6368,1129,11471,982,467,515
16910,13106,1632,6371,1130,11474,982,467,515
16915,13110,1632,6373,1130,11477,982,467,515
16920,13113,1633,6373,1131,11480,982,467,515
16925,13114,1633,6373,1131,11481,982,467,515
16930,13119,1634,6376,1131,11485,983,468,515
16935,13121,1634,6377,1131,11487,984,469,515
16940,13129,1635,6382,1132,11494,984,469,515
16945,13132,1635,6384,1132,11497,984,469,515
16950,13137,1636,6386,1133,11501,984,469,515
16955,13141,1636,6387,1133,11505,984,469,515
16960,13144,1636,6387,1133,11508,984,469,515
16965,13145,1636,6387,1133,11509,984,469,515
16970,13150,1637,6389,1134,11513,984,469,515
16975,13152,1637,6390,1134,11515,985,470,515
16980,13160,1638,6394,1135,11522,985,470,515
16985,13163,1638,6395,1135,11525,985,470,515
16990,13168,1639,6398,1136,11529,985,470,515
16995,13172,1639,6399,1136,11533,985,470,515
17000,13175,1640,6402,1137,11535,985,470,515
17005,13176,1640,6402,1137,11536,985,470,515
17010,13181,1641,6405,1137,11540,985,470,515
17015,13183,1641,6407,1137,11542,986,471,515
17020,13191,1641,6410,1137,11550,986,471,515
17025,13194,1641,6413,1137,11553,986,471,515
17030,13199,1642,6414,1138,11557,986,471,515
17035,13203,1642,6416,1138,11561,986,471,515
17040,13206,1642,6417,1138,11564,986,471,515
17045,13207,1642,6417,1138,11565,986,471,515
17050,13212,1643,6420,1139,11569,987,471,516
17055,13214,1643,6421,1139,11571,988,472,516
17060,13222,1644,6423,1139,11578,988,472,516
17065,13225,1644,6424,1139,11581,988,472,516
17070,13230,1644,6427,1139,11586,988,472,516
17075,13234,1644,6430,1139,11589,988,472,516
17080,13237,1645,6432,1140,11592,988,472,516
17085,13238,1645,6432,1140,11593,988,472,516
17090,13243,1646,6433,1140,11597,989,472,517
17095,13245,1646,6434,1140,11599,990,473,517
17100,13253,1647,6440,1141,11606,990,473,517
17105,13256,1647,6442,1141,11609,990,473,517
17110,13261,1647,6443,1141,11614,990,473,517
17115,13265,1647,6445,1141,11618,990,473,517
17120,13268,1647,6445,1141,11621,990,473,517
17125,13269,1647,6445,1141,11622,990,473,517
17130,13274,1648,6446,1141,11626,990,473,517
17135,13276,1648,6446,1141,11628,991,473,518
17140,13284,1649,6449,1141,11635,991,473,518
17145,13287,1649,6451,1141,11638,991,473,518
17150,13292,1650,6453,1141,11642,991,473,518
17155,13296,1650,6455,1141,11646,991,473,518
17160,13299,1651,6457,1142,11648,991,473,518
17165,13300,1652,6458,1143,11648,991,473,518
17170,13305,1653,6462,1144,11652,992,474,518
17175,13307,1653,6463,1144,11654,993,474,519
17180,13315,1654,6465,1145,11661,994,474,520
17185,13318,1655,6466,1146,11663,994,474,520
17190,13323,1656,6468,1146,11667,994,474,520
17195,13327,1656,6472,1146,11671,994,474,520
17200,13330,1657,6474,1147,11673,994,474,520
17205,13331,1658,6475,1148,11673,994,474,520
17210,13336,1659,6479,1149,11677,994,474,520
17215,13338,1659,6480,1149,11679,995,474,521
17220,13346,1661,6486,1151,11685,996,475,521
17225,13349,1662,6488,1152,11687,996,475,521
17230,13354,1663,6490,1153,11691,996,475,521
17235,13358,1663,6490,1153,11695,996,475,521
17240,13361,1664,6491,1154,11697,996,475,521
17245,13362,1665,6492,1155,11697,996,475,521
17250,13367,1666,6495,1156,11701,997,475,522
17255,13369,1666,6496,1156,11703,998,475,523
17260,13377,1668,6501,1158,11709,999,475,524
17265,13380,1668,6502,1158,11712,999,475,524
17270,13385,1669,6503,1158,11716,999,475,524
17275,13389,1669,6504,1158,11720,999,475,524
17280,13392,1670,6507,1159,11722,999,475,524
17285,13393,1670,6507,1159,11723,999,475,524
17290,13398,1671,6511,1160,11727,999,475,524
17295,13400,1671,6513,1160,11729,1000,476,524
17300,13408,1671,6517,1160,11737,1000,476,524
17305,13411,1671,6519,1160,11740,1000,476,524
17310,13416,1671,6523,1160,11745,1000,476,524
17315,13420,1671,6526,1160,11748,1000,476,524
17320,13423,1672,6528,1161,11751,1000,476,524
17325,13424,1672,6529,1161,11752,1000,476,524
17330,13429,1673,6530,1161,11756,1000,476,524
17335,13431,1673,6531,1161,11758,1001,477,524
17340,13439,1673,6536,1161,11766,1001,477,524
17345,13442,1673,6538,1161,11769,1001,477,524
17350,13447,1673,6538,1161,11774,1001,477,524
17355,13451,1673,6541,1161,11778,1001,477,524
17360,13454,1673,6541,1161,11781,1001,477,524
17365,13455,1673,6541,1161,11782,1001,477,524
17370,13460,1674,6544,1161,11786,1001,477,524
17375,13462,1674,6545,1161,11788,1002,478,524
17380,13470,1674,6550,1161,11796,1002,478,524
17385,13473,1674,6553,1161,11799,1002,478,524
17390,13478,1674,6555,1161,11804,1002,478,524
17395,13482,1674,6556,1161,11808,1002,478,524
17400,13485,1674,6556,1161,11811,1002,478,524
17405,13486,1674,6556,1161,11812,1002,478,524
17410,13491,1675,6558,1161,11816,1003,479,524
17415,13493,1675,6560,1161,11818,1004,480,524
17420,13501,1676,6563,1161,11825,1004,480,524
17425,13504,1676,6566,1161,11828,1004,480,524
17430,13509,1677,6568,1161,11832,1004,480,524
17435,13513,1677,6570,1161,11836,1004,480,524
17440,13516,1678,6572,1162,11838,1004,480,524
17445,13517,1679,6573,1163,11838,1004,480,524
17450,13522,1680,6575,1163,11842,1005,481,524
17455,13524,1680,6577,1163,11844,1006,482,524
17460,13532,1681,6582,1163,11851,1006,482,524
17465,13535,1681,6585,1163,11854,1006,482,524
17470,13540,1682,6589,1163,11858,1006,482,524
17475,13544,1682,6590,1163,11862,1006,482,524
17480,13547,1682,6590,1163,11865,1006,482,524
17485,13548,1682,6591,1163,11866,1006,482,524
17490,13553,1683,6592,1164,11870,1006,482,524
17495,13555,1683,6594,1164,11872,1007,483,524
17500,13563,1684,6598,1164,11879,1007,483,524
17505,13566,1684,6600,1164,11882,1007,483,524
17510,13571,1685,6603,1164,11886,1007,483,524
17515,13575,1685,6605,1164,11890,1007,483,524
17520,13578,1685,6607,1164,11893,1007,483,524
17525,13579,1686,6608,1165,11893,1007,483,524
17530,13584,1687,6612,1166,11897,1007,483,524
17535,13586,1687,6613,1166,11899,1008,484,524
17540,13594,1687,6616,1166,11907,1008,484,524
17545,13597,1687,6618,1166,11910,1008,484,524
17550,13602,1688,6621,1166,11914,1008,484,524
17555,13606,1688,6622,1166,11918,1008,484,524
17560,13609,1689,6623,1167,11920,1008,484,524
17565,13610,1689,6623,1167,11921,1008,484,524
17570,13615,1690,6624,1168,11925,1009,484,525
17575,13617,1690,6626,1168,11927,1010,485,525
17580,13625,1690,6628,1168,11935,1010,485,525
17585,13628,1690,6631,1168,11938,1010,485,525
17590,13633,1690,6634,1168,11943,1010,485,525
17595,13637,1690,6634,1168,11947,1010,485,525
17600,13640,1690,6635,1168,11950,1010,485,525
17605,13641,1690,6635,1168,11951,1010,485,525
17610,13646,1691,6638,1168,11955,1010,485,525
17615,13648,1691,6639,1168,11957,1011,486,525
17620,13656,1691,6642,1168,11965,1011,486,525
17625,13659,1691,6643,1168,11968,1011,486,525
17630,13664,1692,6647,1169,11972,1011,486,525
17635,13668,1692,6647,1169,11976,1011,486,525
17640,13671,1692,6649,1169,11979,1011,486,525
17645,13672,1692,6650,1169,11980,1011,486,525
17650,13677,1693,6652,1169,11984,1011,486,525
17655,13679,1693,6653,1169,11986,1012,486,526
17660,13687,1694,6658,1169,11993,1012,486,526
17665,13690,1694,6659,1169,11996,1012,486,526
17670,13695,1694,6661,1169,12001,1012,486,526
17675,13699,1694,6664,1169,12005,1012,486,526
17680,13702,1694,6664,1169,12008,1012,486,526
17685,13703,1695,6665,1170,12008,1012,486,526
17690,13708,1696,6667,1171,12012,1012,486,526
17695,13710,1696,6667,1171,12014,1013,486,527
17700,13718,1697,6669,1172,12021,1013,486,527
17705,13721,1697,6671,1172,12024,1013,486,527
17710,13726,1698,6673,1172,12028,1013,486,527
17715,13730,1698,6673,1172,12032,1013,486,527
17720,13733,1698,6674,1172,12035,1013,486,527
17725,13734,1698,6674,1172,12036,1013,486,527
17730,13739,1699,6677,1173,12040,1013,486,527
17735,13741,1699,6677,1173,12042,1014,486,528
17740,13749,1701,6683,1174,12048,1014,486,528
17745,13752,1701,6683,1174,12051,1014,486,528
17750,13757,1702,6684,1174,12055,1014,486,528
17755,13761,1702,6685,1174,12058,1014,486,528
17760,13764,1703,6687,1175,12061,1014,486,528
17765,13765,1703,6687,1175,12062,1014,486,528
17770,13770,1704,6688,1175,12066,1014,486,528
17775,13772,1704,6688,1175,12068,1015,486,529
17780,13780,1706,6693,1176,12074,1015,486,529
17785,13783,1706,6695,1176,12077,1015,486,529
17790,13788,1707,6698,1177,12081,1015,486,529
17795,13792,1707,6700,1177,12085,1015,486,529
17800,13795,1708,6701,1178,12087,1015,486,529
17805,13796,1708,6701,1178,12088,1015,486,529
17810,13801,1709,6705,1179,12092,1015,486,529
17815,13803,1709,6707,1179,12094,1016,487,529
17820,13811,1710,6710,1180,12101,1016,487,529
17825,13814,1710,6713,1180,12104,1016,487,529
17830,13819,1711,6715,1181,12108,1016,487,529
17835,13823,1711,6718,1181,12112,1016,487,529
17840,13826,1711,6719,1181,12115,1016,487,529
17845,13827,1711,6720,1181,12116,1016,487,529
17850,13832,1712,6721,1182,12120,1016,487,529
17855,13834,1712,6722,1182,12122,1017,488,529
17860,13842,1713,6727,1183,12129,1017,488,529
17865,13845,1713,6728,1183,12132,1017,488,529
17870,13850,1714,6729,1183,12136,1017,488,529
17875,13854,1714,6730,1183,12140,1017,488,529
17880,13857,1714,6732,1183,12143,1017,488,529
17885,13858,1714,6732,1183,12144,1017,488,529
17890,13863,1715,6733,1183,12148,1017,488,529
17895,13865,1715,6734,1183,12150,1018,489,529
17900,13873,1716,6736,1183,12157,1018,489,529
17905,13876,1716,6737,1183,12160,1018,489,529
17910,13881,1717,6739,1184,12164,1018,489,529
17915,13885,1717,6741,1184,12168,1018,489,529
17920,13888,1717,6741,1184,12171,1018,489,529
17925,13889,1717,6741,1184,12172,1018,489,529
17930,13894,1718,6743,1184,12176,1018,489,529
17935,13896,1718,6744,1184,12178,1019,489,530
17940,13904,1719,6746,1184,12185,1019,489,530
17945,13907,1719,6747,1184,12188,1019,489,530
17950,13912,1720,6751,1185,12192,1019,489,530
17955,13916,1720,6753,1185,12196,1019,489,530
17960,13919,1720,6753,1185,12199,1019,489,530
17965,13920,1720,6754,1185,12200,1019,489,530
17970,13925,1721,6754,1185,12204,1019,489,530
17975,13927,1721,6755,1185,12206,1020,489,531
17980,13935,1722,6758,1186,12213,1020,489,531
17985,13938,1722,6759,1186,12216,1020,489,531
17990,13943,1723,6762,1187,12220,1020,489,531
17995,13947,1723,6765,1187,12223,1020,489,531
18000,13950,1725,6766,1189,12225,1020,489,531
18005,13951,1725,6767,1189,12226,1020,489,531
18010,13956,1726,6769,1189,12230,1021,490,531
18015,13958,1726,6770,1189,12232,1022,490,532
18020,13966,1726,6772,1189,12240,1022,490,532
18025,13969,1726,6773,1189,12243,1022,490,532
18030,13974,1727,6774,1189,12247,1022,490,532
18035,13978,1727,6777,1189,12251,1022,490,532
18040,13981,1727,6778,1189,12254,1022,490,532
18045,13982,1727,6778,1189,12255,1022,490,532
18050,13987,1728,6782,1189,12259,1023,491,532
18055,13989,1728,6783,1189,12261,1024,492,532
18060,13997,1728,6787,1189,12269,1024,492,532
18065,14000,1728,6787,1189,12272,1024,492,532
18070,14005,1729,6789,1189,12276,1024,492,532
18075,14009,1729,6790,1189,12280,1024,492,532
18080,14012,1729,6791,1189,12283,1024,492,532
18085,14013,1729,6791,1189,12284,1024,492,532
18090,14018,1730,6795,1190,12288,1024,492,532
18095,14020,1730,6796,1190,12290,1025,493,532
18100,14028,1730,6799,1190,12298,1025,493,532
18105,14031,1730,6799,1190,12301,1025,493,532
18110,14036,1731,6801,1191,12305,1025,493,532
18115,14040,1731,6802,1191,12308,1025,493,532
18120,14043,1732,6802,1192,12311,1025,493,532
18125,14044,1732,6802,1192,12312,1025,493,532
18130,14049,1733,6805,1193,12316,1026,493,533
18135,14051,1733,6806,1193,12318,1027,494,533
18140,14059,1734,6810,1194,12324,1028,494,534
18145,14062,1735,6812,1195,12327,1028,494,534
18150,14067,1735,6815,1195,12332,1028,494,534
18155,14071,1735,6818,1195,12335,1028,494,534
18160,14074,1736,6820,1196,12338,1028,494,534
18165,14075,1736,6820,1196,12339,1028,494,534
18170,14080,1737,6822,1196,12343,1029,494,535
18175,14082,1737,6823,1196,12345,1030,495,535
18180,14090,1740,6829,1198,12349,1031,496,535
18185,14093,1741,6832,1199,12352,1031,496,535
18190,14098,1741,6834,1199,12357,1031,496,535
18195,14102,1741,6834,1199,12361,1031,496,535
18200,14105,1741,6837,1199,12364,1031,496,535
18205,14106,1741,6838,1199,12365,1031,496,535
18210,14111,1742,6838,1199,12369,1032,496,536
18215,14113,1742,6838,1199,12371,1033,496,537
18220,14121,1743,6843,1199,12378,1033,496,537
18225,14124,1743,6843,1199,12381,1033,496,537
18230,14129,1744,6845,1200,12385,1033,496,537
18235,14133,1744,6847,1200,12389,1033,496,537
18240,14136,1744,6849,1200,12392,1033,496,537
18245,14137,1744,6850,1200,12393,1033,496,537
18250,14142,1745,6853,1201,12397,1034,496,538
18255,14144,1745,6853,1201,12399,1035,496,539
18260,14152,1746,6856,1202,12406,1035,496,539
18265,14155,1746,6856,1202,12409,1035,496,539
18270,14160,1747,6858,1203,12413,1035,496,539
18275,14164,1747,6860,1203,12417,1035,496,539
18280,14167,1748,6863,1204,12419,1035,496,539
18285,14168,1748,6863,1204,12420,1035,496,539
18290,14173,1749,6864,1204,12424,1035,496,539
18295,14175,1749,6864,1204,12426,1036,496,540
18300,14183,1751,6868,1206,12431,1037,497,540
18305,14186,1752,6868,1207,12434,1037,497,540
18310,14191,1753,6870,1207,12438,1037,497,540
18315,14195,1753,6872,1207,12442,1037,497,540
18320,14198,1754,6873,1208,12444,1037,497,540
18325,14199,1754,6873,1208,12445,1037,497,540
18330,14204,1755,6874,1208,12449,1038,497,541
18335,14206,1755,6876,1208,12451,1039,498,541
18340,14214,1756,6878,1209,12458,1039,498,541
18345,14217,1756,6880,1209,12461,1039,498,541
18350,14222,1757,6883,1210,12465,1039,498,541
18355,14226,1757,6886,1210,12469,1039,498,541
18360,14229,1757,6886,1210,12472,1039,498,541
18365,14230,1757,6886,1210,12473,1039,498,541
18370,14235,1758,6887,1211,12477,1039,498,541
18375,14237,1758,6889,1211,12479,1040,499,541
18380,14245,1760,6895,1213,12485,1040,499,541
18385,14248,1760,6897,1213,12488,1040,499,541
18390,14253,1761,6899,1214,12492,1040,499,541
18395,14257,1761,6901,1214,12495,1040,499,541
18400,14260,1763,6903,1216,12497,1040,499,541
18405,14261,1763,6904,1216,12498,1040,499,541
18410,14266,1764,6909,1217,12502,1040,499,541
18415,14268,1764,6911,1217,12504,1041,500,541
18420,14276,1765,6914,1217,12510,1042,500,542
18425,14279,1766,6916,1218,12513,1042,500,542
18430,14284,1766,6920,1218,12518,1042,500,542
18435,14288,1766,6922,1218,12522,1042,500,542
18440,14291,1766,6924,1218,12525,1042,500,542
18445,14292,1766,6924,1218,12526,1042,500,542
18450,14297,1767,6926,1218,12530,1042,500,542
18455,14299,1767,6927,1218,12532,1043,500,543
18460,14307,1767,6930,1218,12540,1043,500,543
18465,14310,1767,6931,1218,12543,1043,500,543
18470,14315,1767,6933,1218,12548,1043,500,543
18475,14319,1767,6935,1218,12551,1043,500,543
18480,14322,1768,6937,1219,12554,1043,500,543
18485,14323,1769,6938,1220,12554,1043,500,543
18490,14328,1770,6942,1221,12558,1044,501,543
18495,14330,1770,6944,1221,12560,1045,502,543
18500,14338,1772,6947,1222,12566,1046,503,543
18505,14341,1773,6948,1223,12568,1046,503,543
18510,14346,1773,6950,1223,12573,1046,503,543
18515,14350,1773,6953,1223,12577,1046,503,543
18520,14353,1773,6953,1223,12580,1046,503,543
18525,14354,1773,6953,1223,12581,1046,503,543
18530,14359,1774,6955,1223,12585,1047,503,544
18535,14361,1774,6955,1223,12587,1048,503,545
18540,14369,1776,6956,1224,12593,1050,503,547
18545,14372,1776,6958,1224,12596,1050,503,547
18550,14377,1777,6958,1224,12600,1050,503,547
18555,14381,1777,6962,1224,12604,1050,503,547
18560,14384,1778,6965,1225,12606,1050,503,547
18565,14385,1778,6966,1225,12607,1050,503,547
18570,14390,1779,6967,1225,12611,1050,503,547
18575,14392,1779,6967,1225,12613,1051,503,548
18580,14400,1779,6972,1225,12621,1051,503,548
18585,14403,1779,6974,1225,12624,1051,503,548
18590,14408,1780,6976,1225,12628,1051,503,548
18595,14412,1780,6976,1225,12632,1051,503,548
18600,14415,1780,6977,1225,12635,1051,503,548
18605,14416,1780,6978,1225,12636,1051,503,548
18610,14421,1781,6979,1225,12640,1051,503,548
18615,14423,1781,6980,1225,12642,1052,503,549
18620,14431,1782,6985,1226,12649,1052,503,549
18625,14434,1782,6986,1226,12652,1052,503,549
18630,14439,1783,6988,1226,12656,1052,503,549
18635,14443,1783,6991,1226,12660,1052,503,549
18640,14446,1784,6993,1227,12662,1052,503,549
18645,14447,1785,6994,1228,12662,1052,503,549
18650,14452,1786,6996,1229,12666,1052,503,549
18655,14454,1786,6998,1229,12668,1053,504,549
18660,14462,1787,7001,1230,12674,1054,504,550
18665,14465,1789,7003,1232,12676,1054,504,550
18670,14470,1789,7006,1232,12681,1054,504,550
18675,14474,1789,7009,1232,12684,1054,504,550
18680,14477,1790,7010,1233,12687,1054,504,550
18685,14478,1791,7011,1234,12687,1054,504,550
18690,14483,1792,7012,1234,12691,1054,504,550
18695,14485,1792,7013,1234,12693,1055,504,551
18700,14493,1794,7015,1235,12699,1056,505,551
18705,14496,1795,7016,1236,12701,1056,505,551
18710,14501,1795,7019,1236,12706,1056,505,551
18715,14505,1795,7020,1236,12710,1056,505,551
18720,14508,1795,7021,1236,12713,1056,505,551
18725,14509,1795,7021,1236,12714,1056,505,551
18730,14514,1796,7024,1236,12718,1056,505,551
18735,14516,1796,7024,1236,12720,1057,505,552
18740,14524,1797,7028,1237,12727,1057,505,552
18745,14527,1797,7029,1237,12730,1057,505,552
18750,14532,1797,7031,1237,12735,1057,505,552
18755,14536,1797,7033,1237,12739,1057,505,552
18760,14539,1797,7035,1237,12742,1057,505,552
18765,14540,1797,7035,1237,12743,1057,505,552
18770,14545,1798,7038,1237,12747,1057,505,552
18775,14547,1798,7039,1237,12749,1058,506,552
18780,14555,1800,7044,1239,12754,1059,507,552
18785,14558,1801,7046,1240,12757,1059,507,552
18790,14563,1802,7049,1241,12761,1059,507,552
18795,14567,1802,7050,1241,12764,1059,507,552
18800,14570,1803,7052,1242,12767,1059,507,552
18805,14571,1803,7052,1242,12768,1059,507,552
18810,14576,1804,7056,1242,12772,1060,508,552
18815,14578,1804,7057,1242,12774,1061,509,552
18820,14586,1804,7062,1242,12782,1061,509,552
18825,14589,1804,7065,1242,12785,1061,509,552
18830,14594,1805,7070,1243,12789,1061,509,552
18835,14598,1805,7070,1243,12793,1061,509,552
18840,14601,1806,7072,1244,12795,1061,509,552
18845,14602,1807,7073,1245,12795,1061,509,552
18850,14607,1808,7076,1245,12799,1062,510,552
18855,14609,1808,7076,1245,12801,1063,510,553
18860,14617,1810,7079,1246,12807,1063,510,553
18865,14620,1810,7079,1246,12810,1063,510,553
18870,14625,1811,7081,1246,12814,1063,510,553
18875,14629,1811,7082,1246,12818,1063,510,553
18880,14632,1811,7083,1246,12821,1063,510,553
18885,14633,1812,7084,1247,12821,1063,510,553
18890,14638,1813,7086,1247,12825,1064,510,554
18895,14640,1813,7087,1247,12827,1065,510,555
18900,14648,1814,7090,1247,12834,1066,510,556
18905,14651,1814,7091,1247,12837,1066,510,556
18910,14656,1815,7095,1248,12841,1066,510,556
18915,14660,1815,7096,1248,12845,1066,510,556
18920,14663,1816,7097,1249,12847,1066,510,556
18925,14664,1816,7097,1249,12848,1066,510,556
18930,14669,1817,7099,1250,12852,1066,510,556
18935,14671,1817,7101,1250,12854,1067,511,556
18940,14679,1818,7103,1250,12861,1067,511,556
18945,14682,1818,7105,1250,12864,1067,511,556
18950,14687,1819,7107,1251,12868,1067,511,556
18955,14691,1819,7109,1251,12872,1067,511,556
18960,14694,1819,7109,1251,12875,1067,511,556
18965,14695,1819,7110,1251,12876,1067,511,556
18970,14700,1820,7111,1251,12880,1067,511,556
18975,14702,1820,7113,1251,12882,1068,512,556
18980,14710,1822,7119,1252,12888,1068,512,556
18985,14713,1822,7120,1252,12891,1068,512,556
18990,14718,1822,7121,1252,12896,1068,512,556
18995,14722,1822,7122,1252,12899,1068,512,556
19000,14725,1823,7124,1253,12902,1068,512,556
19005,14726,1823,7124,1253,12903,1068,512,556
19010,14731,1824,7128,1254,12907,1069,512,557
19015,14733,1824,7129,1254,12909,1070,513,557
19020,14741,1825,7134,1255,12916,1071,513,558
19025,14744,1825,7134,1255,12919,1071,513,558
19030,14749,1825,7136,1255,12924,1071,513,558
19035,14753,1825,7138,1255,12928,1071,513,558
19040,14756,1825,7141,1255,12931,1071,513,558
19045,14757,1825,7141,1255,12932,1071,513,558
19050,14762,1826,7145,1256,12936,1072,514,558
19055,14764,1826,7146,1256,12938,1073,515,558
19060,14772,1827,7150,1256,12945,1074,515,559
19065,14775,1828,7153,1257,12947,1074,515,559
19070,14780,1829,7157,1258,12951,1074,515,559
19075,14784,1829,7159,1258,12955,1074,515,559
19080,14787,1830,7161,1259,12957,1074,515,559
19085,14788,1831,7162,1260,12957,1074,515,559
19090,14793,1832,7164,1260,12961,1075,516,559
19095,14795,1832,7166,1260,12963,1076,517,559
19100,14803,1833,7170,1261,12970,1076,517,559
19105,14806,1833,7172,1261,12973,1076,517,559
19110,14811,1834,7173,1261,12977,1076,517,559
19115,14815,1834,7176,1261,12981,1076,517,559
19120,14818,1835,7177,1262,12983,1076,517,559
19125,14819,1835,7177,1262,12984,1076,517,559
19130,14824,1836,7181,1262,12988,1077,518,559
19135,14826,1836,7182,1262,12990,1078,519,559
19140,14834,1837,7185,1262,12997,1078,519,559
19145,14837,1837,7186,1262,13000,1078,519,559
19150,14842,1838,7186,1262,13004,1078,519,559
19155,14846,1838,7187,1262,13008,1078,519,559
19160,14849,1839,7189,1263,13010,1078,519,559
19165,14850,1839,7189,1263,13011,1078,519,559
19170,14855,1840,7192,1264,13015,1078,519,559
19175,14857,1840,7194,1264,13017,1079,520,559
19180,14865,1841,7198,1265,13024,1079,520,559
19185,14868,1841,7200,1265,13027,1079,520,559
19190,14873,1842,7200,1265,13031,1079,520,559
19195,14877,1842,7201,1265,13035,1079,520,559
19200,14880,1842,7201,1265,13038,1079,520,559
19205,14881,1842,7201,1265,13039,1079,520,559
19210,14886,1843,7203,1266,13043,1079,520,559
19215,14888,1843,7205,1266,13045,1080,521,559
19220,14896,1844,7209,1267,13052,1080,521,559
19225,14899,1844,7211,1267,13055,1080,521,559
19230,14904,1844,7214,1267,13060,1080,521,559
19235,14908,1844,7216,1267,13063,1080,521,559
19240,14911,1845,7217,1268,13066,1080,521,559
19245,14912,1845,7217,1268,13067,1080,521,559
19250,14917,1846,7218,1268,13071,1081,522,559
19255,14919,1846,7219,1268,13073,1082,522,560
19260,14927,1847,7220,1269,13080,1083,522,561
19265,14930,1847,7222,1269,13083,1083,522,561
19270,14935,1847,7225,1269,13088,1083,522,561
19275,14939,1847,7227,1269,13091,1083,522,561
19280,14942,1848,7229,1270,13094,1083,522,561
19285,14943,1849,7230,1271,13094,1083,522,561
19290,14948,1850,7233,1271,13098,1083,522,561
19295,14950,1850,7233,1271,13100,1084,522,562
19300,14958,1851,7237,1272,13107,1084,522,562
19305,14961,1851,7239,1272,13110,1084,522,562
19310,14966,1852,7240,1272,13114,1084,522,562
19315,14970,1852,7242,1272,13118,1084,522,562
19320,14973,1852,7244,1272,13121,1084,522,562
19325,14974,1852,7245,1272,13122,1084,522,562
19330,14979,1853,7248,1273,13126,1084,522,562
19335,14981,1853,7250,1273,13128,1085,523,562
19340,14989,1854,7253,1273,13135,1085,523,562
19345,14992,1854,7254,1273,13138,1085,523,562
19350,14997,1855,7255,1274,13142,1085,523,562
19355,15001,1855,7256,1274,13146,1085,523,562
19360,15004,1855,7256,1274,13149,1085,523,562
19365,15005,1855,7257,1274,13150,1085,523,562
19370,15010,1856,7259,1274,13154,1086,523,563
19375,15012,1856,7260,1274,13156,1087,524,563
19380,15020,1857,7263,1275,13163,1088,525,563
19385,15023,1858,7265,1276,13165,1088,525,563
19390,15028,1858,7268,1276,13170,1088,525,563
19395,15032,1858,7270,1276,13173,1088,525,563
19400,15035,1859,7271,1277,13176,1088,525,563
19405,15036,1859,7272,1277,13177,1088,525,563
19410,15041,1860,7274,1277,13181,1088,525,563
19415,15043,1860,7274,1277,13183,1089,525,564
19420,15051,1862,7280,1279,13189,1090,526,564
19425,15054,1863,7283,1280,13191,1090,526,564
19430,15059,1863,7285,1280,13196,1090,526,564
19435,15063,1863,7286,1280,13199,1090,526,564
19440,15066,1864,7289,1281,13202,1090,526,564
19445,15067,1865,7290,1282,13202,1090,526,564
19450,15072,1866,7293,1282,13206,1091,526,565
19455,15074,1866,7295,1282,13208,1092,527,565
19460,15082,1866,7298,1282,13216,1092,527,565
19465,15085,1866,7299,1282,13219,1092,527,565
19470,15090,1866,7300,1282,13224,1092,527,565
19475,15094,1866,7303,1282,13228,1092,527,565
19480,15097,1866,7304,1282,13231,1092,527,565
19485,15098,1866,7304,1282,13232,1092,527,565
19490,15103,1867,7306,1283,13236,1093,527,566
19495,15105,1867,7307,1283,13238,1094,528,566
19500,15113,1868,7313,1284,13245,1094,528,566
19505,15116,1868,7314,1284,13248,1094,528,566
19510,15121,1869,7317,1284,13252,1094,528,566
19515,15125,1869,7319,1284,13255,1094,528,566
19520,15128,1871,7321,1286,13257,1094,528,566
19525,15129,1871,7322,1286,13258,1094,528,566
19530,15134,1872,7324,1287,13262,1094,528,566
19535,15136,1872,7324,1287,13264,1095,528,567
19540,15144,1873,7331,1288,13271,1095,528,567
19545,15147,1873,7333,1288,13274,1095,528,567
19550,15152,1874,7336,1289,13278,1095,528,567
19555,15156,1874,7338,1289,13282,1095,528,567
19560,15159,1875,7340,1290,13284,1095,528,567
19565,15160,1876,7341,1291,13284,1095,528,567
19570,15165,1877,7344,1292,13288,1096,528,568
19575,15167,1877,7346,1292,13290,1097,529,568
19580,15175,1878,7349,1293,13297,1098,529,569
19585,15178,1878,7349,1293,13300,1098,529,569
19590,15183,1878,7351,1293,13305,1098,529,569
19595,15187,1878,7353,1293,13309,1098,529,569
19600,15190,1878,7354,1293,13312,1098,529,569
19605,15191,1879,7355,1294,13312,1098,529,569
19610,15196,1880,7356,1294,13316,1099,529,570
19615,15198,1880,7356,1294,13318,1100,529,571
19620,15206,1881,7356,1294,13325,1101,529,572
19625,15209,1881,7358,1294,13328,1101,529,572
19630,15214,1881,7362,1294,13333,1101,529,572
19635,15218,1881,7365,1294,13337,1101,529,572
19640,15221,1881,7367,1294,13340,1101,529,572
19645,15222,1881,7368,1294,13341,1101,529,572
19650,15227,1882,7370,1294,13345,1102,529,573
19655,15229,1882,7372,1294,13347,1103,530,573
19660,15237,1883,7373,1294,13354,1103,530,573
19665,15240,1883,7373,1294,13357,1103,530,573
19670,15245,1884,7375,1294,13361,1103,530,573
19675,15249,1884,7378,1294,13364,1103,530,573
19680,15252,1886,7381,1296,13366,1103,530,573
19685,15253,1886,7382,1296,13367,1103,530,573
19690,15258,1887,7384,1296,13371,1103,530,573
19695,15260,1887,7384,1296,13373,1104,530,574
19700,15268,1888,7386,1296,13380,1104,530,574
19705,15271,1888,7387,1296,13383,1104,530,574
19710,15276,1889,7389,1296,13387,1104,530,574
19715,15280,1889,7391,1296,13390,1104,530,574
19720,15283,1890,7391,1297,13393,1104,530,574
19725,15284,1890,7391,1297,13394,1104,530,574
19730,15289,1891,7392,1297,13398,1104,530,574
19735,15291,1891,7392,1297,13400,1105,530,575
19740,15299,1892,7395,1298,13407,1106,530,576
19745,15302,1892,7396,1298,13410,1106,530,576
19750,15307,1892,7399,1298,13415,1106,530,576
19755,15311,1892,7402,1298,13419,1106,530,576
19760,15314,1892,7405,1298,13422,1106,530,576
19765,15315,1892,7405,1298,13423,1106,530,576
19770,15320,1893,7407,1298,13427,1106,530,576
19775,15322,1893,7409,1298,13429,1107,531,576
19780,15330,1895,7413,1299,13435,1107,531,576
19785,15333,1895,7415,1299,13438,1107,531,576
19790,15338,1895,7417,1299,13443,1107,531,576
19795,15342,1895,7418,1299,13447,1107,531,576
19800,15345,1895,7421,1299,13450,1107,531,576
19805,15346,1895,7421,1299,13451,1107,531,576
19810,15351,1896,7425,1300,13455,1107,531,576
19815,15353,1896,7425,1300,13457,1108,531,577
19820,15361,1898,7431,1301,13463,1108,531,577
19825,15364,1898,7434,1301,13466,1108,531,577
19830,15369,1898,7436,1301,13471,1108,531,577
19835,15373,1898,7438,1301,13475,1108,531,577
19840,15376,1898,7439,1301,13478,1108,531,577
19845,15377,1898,7440,1301,13479,1108,531,577
19850,15382,1899,7443,1301,13483,1108,531,577
19855,15384,1899,7443,1301,13485,1109,531,578
19860,15392,1901,7448,1303,13491,1110,532,578
19865,15395,1901,7448,1303,13494,1110,532,578
19870,15400,1902,7451,1304,13498,1110,532,578
19875,15404,1902,7452,1304,13502,1110,532,578
19880,15407,1903,7454,1305,13504,1110,532,578
19885,15408,1903,7455,1305,13505,1110,532,578
19890,15413,1904,7457,1306,13509,1110,532,578
19895,15415,1904,7457,1306,13511,1111,532,579
19900,15423,1905,7459,1306,13518,1112,533,579
19905,15426,1906,7461,1307,13520,1112,533,579
19910,15431,1907,7462,1307,13524,1112,533,579
19915,15435,1907,7463,1307,13528,1112,533,579
19920,15438,1907,7465,1307,13531,1112,533,579
19925,15439,1907,7465,1307,13532,1112,533,579
19930,15444,1908,7469,1308,13536,1112,533,579
19935,15446,1908,7470,1308,13538,1113,533,580
19940,15454,1908,7473,1308,13546,1114,533,581
19945,15457,1908,7474,1308,13549,1114,533,581
19950,15462,1909,7476,1308,13553,1114,533,581
19955,15466,1909,7478,1308,13557,1114,533,581
19960,15469,1909,7478,1308,13560,1114,533,581
19965,15470,1910,7479,1309,13560,1114,533,581
19970,15475,1911,7481,1310,13564,1114,533,581
19975,15477,1911,7483,1310,13566,1115,534,581
19980,15485,1912,7488,1311,13572,1116,534,582
19985,15488,1913,7489,1312,13575,1116,534,582
19990,15493,1914,7493,1312,13579,1116,534,582
19995,15497,1914,7495,1312,13583,1116,534,582
20000,15500,1914,7496,1312,13586,1116,534,582
20005,15501,1914,7496,1312,13587,1116,534,582
20010,15506,1915,7498,1312,13591,1116,534,582
20015,15508,1915,7500,1312,13593,1117,535,582
20020,15516,1917,7504,1313,13599,1117,535,582
20025,15519,1917,7506,1313,13602,1117,535,582
20030,15524,1918,7508,1313,13606,1117,535,582
20035,15528,1918,7510,1313,13610,1117,535,582
20040,15531,1919,7511,1314,13612,1117,535,582
20045,15532,1919,7512,1314,13613,1117,535,582
20050,15537,1920,7514,1314,13617,1118,535,583
20055,15539,1920,7515,1314,13619,1119,535,584
20060,15547,1923,7520,1316,13624,1120,536,584
20065,15550,1923,7522,1316,13627,1120,536,584
20070,15555,1923,7524,1316,13632,1120,536,584
20075,15559,1923,7526,1316,13636,1120,536,584
20080,15562,1923,7528,1316,13639,1120,536,584
20085,15563,1923,7529,1316,13640,1120,536,584
20090,15568,1924,7531,1316,13644,1121,536,585
20095,15570,1924,7532,1316,13646,1122,536,586
20100,15578,1926,7537,1317,13652,1124,537,587
20105,15581,1926,7538,1317,13655,1124,537,587
20110,15586,1926,7541,1317,13660,1124,537,587
20115,15590,1926,7544,1317,13663,1124,537,587
20120,15593,1927,7544,1318,13666,1124,537,587
20125,15594,1928,7545,1319,13666,1124,537,587
20130,15599,1929,7548,1320,13670,1125,538,587
20135,15601,1929,7550,1320,13672,1126,539,587
20140,15609,1929,7554,1320,13680,1126,539,587
20145,15612,1929,7556,1320,13683,1126,539,587
20150,15617,1930,7560,1321,13687,1126,539,587
20155,15621,1930,7561,1321,13691,1126,539,587
20160,15624,1931,7564,1322,13693,1126,539,587
20165,15625,1931,7564,1322,13694,1126,539,587
20170,15630,1932,7568,1323,13698,1127,540,587
20175,15632,1932,7569,1323,13700,1128,541,587
20180,15640,1935,7576,1326,13704,1130,543,587
20185,15643,1936,7577,1327,13707,1130,543,587
20190,15648,1937,7580,1328,13711,1130,543,587
20195,15652,1937,7582,1328,13715,1130,543,587
20200,15655,1938,7584,1329,13717,1130,543,587
20205,15656,1938,7584,1329,13718,1130,543,587
20210,15661,1939,7586,1330,13722,1131,543,588
20215,15663,1939,7588,1330,13724,1132,544,588
20220,15671,1942,7594,1333,13728,1134,545,589
20225,15674,1943,7597,1334,13731,1134,545,589
20230,15679,1944,7601,1335,13735,1134,545,589
20235,15683,1944,7601,1335,13739,1134,545,589
20240,15686,1945,7604,1336,13741,1134,545,589
20245,15687,1945,7605,1336,13742,1134,545,589
20250,15692,1946,7607,1337,13746,1134,545,589
20255,15694,1946,7607,1337,13748,1135,545,590
20260,15702,1947,7610,1338,13755,1135,545,590
20265,15705,1947,7611,1338,13758,1135,545,590
20270,15710,1948,7614,1339,13762,1135,545,590
20275,15714,1948,7615,1339,13766,1135,545,590
20280,15717,1949,7617,1340,13768,1135,545,590
20285,15718,1950,7618,1341,13768,1135,545,590
20290,15723,1951,7621,1341,13772,1135,545,590
20295,15725,1951,7623,1341,13774,1136,546,590
20300,15733,1952,7626,1341,13781,1136,546,590
20305,15736,1952,7627,1341,13784,1136,546,590
20310,15741,1953,7631,1341,13788,1136,546,590
20315,15745,1953,7632,1341,13791,1136,546,590
20320,15748,1954,7634,1342,13794,1136,546,590
20325,15749,1955,7635,1343,13794,1136,546,590
20330,15754,1956,7639,1344,13798,1137,547,590
20335,15756,1956,7639,1344,13800,1138,547,591
20340,15764,1957,7643,1344,13807,1140,549,591
20345,15767,1957,7643,1344,13810,1140,549,591
20350,15772,1957,7646,1344,13815,1140,549,591
20355,15776,1957,7648,1344,13819,1140,549,591
20360,15779,1957,7650,1344,13822,1140,549,591
20365,15780,1957,7650,1344,13823,1140,549,591
20370,15785,1957,7654,1344,13828,1140,549,591
20375,15787,1957,7654,1344,13830,1141,549,592
20380,15795,1959,7658,1345,13836,1142,550,592
20385,15798,1960,7659,1346,13838,1142,550,592
20390,15803,1960,7661,1346,13843,1142,550,592
20395,15807,1960,7661,1346,13847,1142,550,592
20400,15810,1960,7661,1346,13850,1142,550,592
20405,15811,1960,7662,1346,13851,1142,550,592
20410,15816,1960,7665,1346,13856,1143,551,592
20415,15818,1960,7666,1346,13858,1144,552,592
20420,15826,1962,7673,1348,13864,1144,552,592
20425,15829,1962,7675,1348,13867,1144,552,592
20430,15834,1962,7677,1348,13872,1144,552,592
20435,15838,1962,7679,1348,13876,1144,552,592
20440,15841,1962,7680,1348,13879,1144,552,592
20445,15842,1962,7680,1348,13880,1144,552,592
20450,15847,1963,7684,1349,13884,1145,553,592
20455,15849,1963,7685,1349,13886,1146,554,592
20460,15857,1965,7689,1351,13892,1147,555,592
20465,15860,1965,7692,1351,13895,1147,555,592
20470,15865,1966,7693,1352,13899,1147,555,592
20475,15869,1966,7697,1352,13903,1147,555,592
20480,15872,1967,7699,1353,13905,1147,555,592
20485,15873,1967,7699,1353,13906,1147,555,592
20490,15878,1968,7702,1353,13910,1148,556,592
20495,15880,1968,7703,1353,13912,1149,556,593
20500,15888,1969,7705,1354,13919,1149,556,593
20505,15891,1969,7706,1354,13922,1149,556,593
20510,15896,1970,7708,1354,13926,1149,556,593
20515,15900,1970,7709,1354,13930,1149,556,593
20520,15903,1970,7711,1354,13933,1149,556,593
20525,15904,1970,7711,1354,13934,1149,556,593
20530,15909,1971,7714,1355,13938,1150,557,593
20535,15911,1971,7715,1355,13940,1151,558,593
20540,15919,1971,7718,1355,13948,1151,558,593
20545,15922,1971,7719,1355,13951,1151,558,593
20550,15927,1972,7720,1355,13955,1151,558,593
20555,15931,1972,7720,1355,13959,1151,558,593
20560,15934,1973,7722,1356,13961,1151,558,593
20565,15935,1973,7722,1356,13962,1151,558,593
20570,15940,1974,7725,1357,13966,1152,559,593
20575,15942,1974,7725,1357,13968,1153,559,594
20580,15950,1977,7730,1359,13972,1155,560,595
20585,15953,1978,7730,1360,13975,1155,560,595
20590,15958,1978,7732,1360,13980,1155,560,595
20595,15962,1978,7735,1360,13984,1155,560,595
20600,15965,1978,7736,1360,13987,1155,560,595
20605,15966,1978,7737,1360,13988,1155,560,595
20610,15971,1979,7740,1361,13992,1155,560,595
20615,15973,1979,7742,1361,13994,1156,561,595
20620,15981,1979,7747,1361,14002,1156,561,595
20625,15984,1979,7749,1361,14005,1156,561,595
20630,15989,1979,7754,1361,14010,1156,561,595
20635,15993,1979,7757,1361,14014,1156,561,595
20640,15996,1979,7758,1361,14017,1156,561,595
20645,15997,1979,7758,1361,14018,1156,561,595
20650,16002,1980,7760,1361,14022,1156,561,595
20655,16004,1980,7762,1361,14024,1157,562,595
20660,16012,1980,7767,1361,14032,1157,562,595
20665,16015,1980,7768,1361,14035,1157,562,595
20670,16020,1980,7771,1361,14040,1157,562,595
20675,16024,1980,7775,1361,14043,1157,562,595
20680,16027,1981,7777,1362,14046,1157,562,595
20685,16028,1981,7777,1362,14047,1157,562,595
20690,16033,1982,7780,1362,14051,1157,562,595
20695,16035,1982,7780,1362,14053,1158,562,596
20700,16043,1983,7783,1363,14059,1160,562,598
20705,16046,1984,7785,1364,14062,1160,562,598
20710,16051,1985,7790,1365,14066,1160,562,598
20715,16055,1985,7792,1365,14070,1160,562,598
20720,16058,1985,7793,1365,14073,1160,562,598
20725,16059,1985,7794,1365,14074,1160,562,598
20730,16064,1986,7796,1366,14078,1160,562,598
20735,16066,1986,7798,1366,14080,1161,563,598
20740,16074,1987,7800,1366,14087,1161,563,598
20745,16077,1987,7801,1366,14090,1161,563,598
20750,16082,1988,7803,1367,14094,1161,563,598
20755,16086,1988,7806,1367,14098,1161,563,598
20760,16089,1989,7809,1368,14100,1161,563,598
20765,16090,1989,7809,1368,14101,1161,563,598
20770,16095,1990,7812,1369,14105,1162,564,598
20775,16097,1990,7812,1369,14107,1163,564,599
20780,16105,1991,7818,1370,14114,1163,564,599
20785,16108,1991,7820,1370,14117,1163,564,599
20790,16113,1992,7823,1371,14121,1163,564,599
20795,16117,1992,7824,1371,14125,1163,564,599
20800,16120,1993,7826,1372,14127,1163,564,599
20805,16121,1993,7827,1372,14128,1163,564,599
20810,16126,1994,7830,1372,14132,1164,564,600
20815,16128,1994,7832,1372,14134,1165,565,600
20820,16136,1997,7839,1375,14138,1167,567,600
20825,16139,1998,7841,1376,14141,1167,567,600
20830,16144,1999,7843,1377,14145,1167,567,600
20835,16148,1999,7847,1377,14148,1167,567,600
20840,16151,2000,7848,1378,14151,1167,567,600
20845,16152,2001,7849,1379,14151,1167,567,600
20850,16157,2002,7852,1379,14155,1168,568,600
20855,16159,2002,7853,1379,14157,1169,569,600
20860,16167,2003,7857,1379,14164,1169,569,600
20865,16170,2003,7857,1379,14167,1169,569,600
20870,16175,2004,7859,1379,14171,1169,569,600
20875,16179,2004,7860,1379,14175,1169,569,600
20880,16182,2005,7861,1380,14177,1169,569,600
20885,16183,2005,7861,1380,14178,1169,569,600
20890,16188,2006,7864,1381,14182,1169,569,600
20895,16190,2006,7864,1381,14184,1170,569,601
20900,16198,2007,7866,1381,14191,1170,569,601
20905,16201,2007,7868,1381,14194,1170,569,601
20910,16206,2007,7870,1381,14199,1170,569,601
20915,16210,2007,7873,1381,14203,1170,569,601
20920,16213,2007,7874,1381,14206,1170,569,601
20925,16214,2007,7875,1381,14207,1170,569,601
20930,16219,2008,7879,1382,14211,1170,569,601
20935,16221,2008,7881,1382,14213,1171,570,601
20940,16229,2010,7884,1383,14219,1173,571,602
20945,16232,2010,7886,1383,14222,1173,571,602
20950,16237,2010,7887,1383,14227,1173,571,602
20955,16241,2010,7889,1383,14231,1173,571,602
20960,16244,2010,7891,1383,14234,1173,571,602
20965,16245,2010,7891,1383,14235,1173,571,602
20970,16250,2011,7893,1384,14239,1173,571,602
20975,16252,2011,7894,1384,14241,1174,572,602
20980,16260,2011,7899,1384,14249,1174,572,602
20985,16263,2011,7901,1384,14252,1174,572,602
20990,16268,2012,7902,1384,14256,1174,572,602
20995,16272,2012,7904,1384,14260,1174,572,602
21000,16275,2012,7904,1384,14263,1174,572,602
21005,16276,2013,7905,1385,14263,1174,572,602
21010,16281,2014,7907,1385,14267,1175,573,602
21015,16283,2014,7908,1385,14269,1176,574,602
21020,16291,2015,7912,1386,14276,1176,574,602
21025,16294,2015,7915,1386,14279,1176,574,602
21030,16299,2016,7918,1387,14283,1176,574,602
21035,16303,2016,7919,1387,14286,1176,574,602
21040,16306,2017,7921,1388,14289,1176,574,602
21045,16307,2018,7922,1389,14289,1176,574,602
21050,16312,2019,7924,1389,14293,1177,574,603
21055,16314,2019,7926,1389,14295,1178,575,603
21060,16322,2022,7930,1391,14300,1180,576,604
21065,16325,2022,7931,1391,14303,1180,576,604
21070,16330,2023,7934,1392,14307,1180,576,604
21075,16334,2023,7937,1392,14311,1180,576,604
21080,16337,2023,7938,1392,14314,1180,576,604
21085,16338,2023,7939,1392,14315,1180,576,604
21090,16343,2024,7941,1392,14319,1180,576,604
21095,16345,2024,7941,1392,14321,1181,576,605
21100,16353,2025,7944,1392,14328,1181,576,605
21105,16356,2025,7945,1392,14331,1181,576,605
21110,16361,2026,7947,1392,14335,1181,576,605
21115,16365,2026,7950,1392,14339,1181,576,605
21120,16368,2026,7952,1392,14342,1181,576,605
21125,16369,2026,7952,1392,14343,1181,576,605
21130,16374,2027,7954,1392,14347,1181,576,605
21135,16376,2027,7956,1392,14349,1182,577,605
21140,16384,2028,7959,1393,14356,1182,577,605
21145,16387,2028,7961,1393,14359,1182,577,605
21150,16392,2029,7963,1393,14363,1182,577,605
21155,16396,2029,7966,1393,14367,1182,577,605
21160,16399,2030,7968,1394,14369,1182,577,605
21165,16400,2030,7969,1394,14370,1182,577,605
21170,16405,2031,7971,1395,14374,1182,577,605
21175,16407,2031,7972,1395,14376,1183,578,605
21180,16415,2033,7977,1397,14382,1185,580,605
21185,16418,2033,7978,1397,14385,1185,580,605
21190,16423,2034,7980,1398,14389,1185,580,605
21195,16427,2034,7984,1398,14392,1185,580,605
21200,16430,2036,7986,1400,14394,1185,580,605
21205,16431,2036,7986,1400,14395,1185,580,605
21210,16436,2037,7986,1400,14399,1185,580,605
21215,16438,2037,7987,1400,14401,1186,581,605
21220,16446,2038,7990,1400,14408,1187,582,605
21225,16449,2039,7993,1401,14410,1187,582,605
21230,16454,2040,7996,1401,14414,1187,582,605
21235,16458,2040,7997,1401,14417,1187,582,605
21240,16461,2042,7998,1403,14419,1187,582,605
21245,16462,2042,7999,1403,14420,1187,582,605
21250,16467,2043,8001,1404,14424,1187,582,605
21255,16469,2043,8002,1404,14426,1188,583,605
21260,16477,2045,8007,1406,14432,1189,584,605
21265,16480,2045,8009,1406,14435,1189,584,605
21270,16485,2045,8012,1406,14440,1189,584,605
21275,16489,2045,8012,1406,14444,1189,584,605
21280,16492,2045,8013,1406,14447,1189,584,605
21285,16493,2045,8013,1406,14448,1189,584,605
21290,16498,2046,8015,1406,14452,1190,585,605
21295,16500,2046,8015,1406,14454,1191,585,606
21300,16508,2047,8019,1407,14461,1193,586,607
21305,16511,2047,8020,1407,14464,1193,586,607
21310,16516,2047,8023,1407,14469,1193,586,607
21315,16520,2047,8025,1407,14473,1193,586,607
21320,16523,2047,8027,1407,14476,1193,586,607
21325,16524,2047,8027,1407,14477,1193,586,607
21330,16529,2048,8028,1408,14481,1194,586,608
21335,16531,2048,8028,1408,14483,1195,586,609
21340,16539,2050,8032,1409,14489,1196,587,609
21345,16542,2050,8032,1409,14492,1196,587,609
21350,16547,2050,8037,1409,14497,1196,587,609
21355,16551,2050,8040,1409,14501,1196,587,609
21360,16554,2050,8041,1409,14504,1196,587,609
21365,16555,2050,8041,1409,14505,1196,587,609
21370,16560,2050,8044,1409,14510,1196,587,609
21375,16562,2050,8046,1409,14512,1197,588,609
21380,16570,2051,8048,1409,14519,1197,588,609
21385,16573,2051,8051,1409,14522,1197,588,609
21390,16578,2052,8053,1410,14526,1197,588,609
21395,16582,2052,8054,1410,14530,1197,588,609
21400,16585,2052,8054,1410,14533,1197,588,609
21405,16586,2052,8055,1410,14534,1197,588,609
21410,16591,2052,8058,1410,14539,1197,588,609
21415,16593,2052,8058,1410,14541,1198,588,610
21420,16601,2053,8060,1410,14548,1199,589,610
21425,16604,2053,8062,1410,14551,1199,589,610
21430,16609,2054,8064,1410,14555,1199,589,610
21435,16613,2054,8067,1410,14558,1199,589,610
21440,16616,2055,8069,1411,14561,1199,589,610
21445,16617,2055,8069,1411,14562,1199,589,610
21450,16622,2055,8070,1411,14567,1199,589,610
21455,16624,2055,8072,1411,14569,1200,590,610
21460,16632,2056,8075,1411,14576,1200,590,610
21465,16635,2056,8076,1411,14579,1200,590,610
21470,16640,2057,8078,1411,14583,1200,590,610
21475,16644,2057,8080,1411,14587,1200,590,610
21480,16647,2058,8082,1412,14589,1200,590,610
21485,16648,2058,8082,1412,14590,1200,590,610
21490,16653,2059,8084,1412,14594,1200,590,610
21495,16655,2059,8085,1412,14596,1201,590,611
21500,16663,2061,8090,1414,14602,1201,590,611
21505,16666,2061,8091,1414,14605,1201,590,611
21510,16671,2061,8092,1414,14610,1201,590,611
21515,16675,2061,8095,1414,14614,1201,590,611
21520,16678,2061,8096,1414,14617,1201,590,611
21525,16679,2061,8097,1414,14618,1201,590,611
21530,16684,2062,8100,1414,14622,1202,591,611
21535,16686,2062,8102,1414,14624,1203,592,611
21540,16694,2063,8105,1415,14631,1204,593,611
21545,16697,2063,8105,1415,14634,1204,593,611
21550,16702,2063,8107,1415,14639,1204,593,611
21555,16706,2063,8108,1415,14643,1204,593,611
21560,16709,2063,8108,1415,14646,1204,593,611
21565,16710,2063,8109,1415,14647,1204,593,611
21570,16715,2064,8111,1416,14651,1204,593,611
21575,16717,2064,8112,1416,14653,1205,593,612
21580,16725,2065,8114,1416,14660,1206,594,612
21585,16728,2065,8114,1416,14663,1206,594,612
21590,16733,2066,8117,1417,14667,1206,594,612
21595,16737,2066,8118,1417,14671,1206,594,612
21600,16740,2066,8118,1417,14674,1206,594,612
21605,16741,2066,8118,1417,14675,1206,594,612
21610,16746,2067,8120,1418,14679,1206,594,612
21615,16748,2067,8120,1418,14681,1207,594,613
21620,16756,2068,8125,1419,14688,1207,594,613
21625,16759,2068,8128,1419,14691,1207,594,613
21630,16764,2069,8130,1419,14695,1207,594,613
21635,16768,2069,8131,1419,14699,1207,594,613
21640,16771,2069,8131,1419,14702,1207,594,613
21645,16772,2070,8132,1420,14702,1207,594,613
21650,16777,2071,8134,1421,14706,1208,594,614
21655,16779,2071,8136,1421,14708,1209,595,614
21660,16787,2072,8139,1422,14715,1209,595,614
21665,16790,2072,8140,1422,14718,1209,595,614
21670,16795,2072,8142,1422,14723,1209,595,614
21675,16799,2072,8143,1422,14726,1209,595,614
21680,16802,2073,8145,1423,14729,1209,595,614
21685,16803,2073,8146,1423,14730,1209,595,614
21690,16808,2074,8148,1423,14734,1210,596,614
21695,16810,2074,8150,1423,14736,1211,597,614
21700,16818,2074,8154,1423,14744,1211,597,614
21705,16821,2074,8156,1423,14747,1211,597,614
21710,16826,2074,8159,1423,14752,1211,597,614
21715,16830,2074,8162,1423,14756,1211,597,614
21720,16833,2074,8162,1423,14759,1211,597,614
21725,16834,2074,8163,1423,14760,1211,597,614
21730,16839,2075,8166,1423,14764,1211,597,614
21735,16841,2075,8167,1423,14766,1212,597,615
21740,16849,2076,8169,1423,14773,1213,598,615
21745,16852,2077,8172,1424,14775,1213,598,615
21750,16857,2077,8174,1424,14780,1213,598,615
21755,16861,2077,8175,1424,14784,1213,598,615
21760,16864,2077,8176,1424,14787,1213,598,615
21765,16865,2077,8177,1424,14788,1213,598,615
21770,16870,2078,8178,1424,14792,1213,598,615
21775,16872,2078,8179,1424,14794,1214,599,615
21780,16880,2080,8183,1425,14800,1215,600,615
21785,16883,2080,8184,1425,14803,1215,600,615
21790,16888,2081,8187,1426,14807,1215,600,615
21795,16892,2081,8190,1426,14810,1215,600,615
21800,16895,2083,8191,1428,14812,1215,600,615
21805,16896,2083,8191,1428,14813,1215,600,615
21810,16901,2084,8193,1429,14817,1215,600,615
21815,16903,2084,8195,1429,14819,1216,601,615
21820,16911,2085,8200,1430,14826,1216,601,615
21825,16914,2085,8202,1430,14829,1216,601,615
21830,16919,2086,8205,1430,14833,1216,601,615
21835,16923,2086,8206,1430,14837,1216,601,615
21840,16926,2087,8209,1431,14839,1216,601,615
21845,16927,2087,8209,1431,14840,1216,601,615
21850,16932,2088,8211,1431,14844,1216,601,615
21855,16934,2088,8212,1431,14846,1217,601,616
21860,16942,2089,8215,1431,14853,1217,601,616
21865,16945,2089,8216,1431,14856,1217,601,616
21870,16950,2090,8217,1431,14860,1217,601,616
21875,16954,2090,8220,1431,14864,1217,601,616
21880,16957,2091,8221,1432,14866,1217,601,616
21885,16958,2092,8222,1433,14866,1217,601,616
21890,16963,2093,8225,1434,14870,1217,601,616
21895,16965,2093,8226,1434,14872,1218,601,617
21900,16973,2095,8229,1435,14878,1219,601,618
21905,16976,2095,8231,1435,14881,1219,601,618
21910,16981,2096,8233,1436,14885,1219,601,618
21915,16985,2096,8235,1436,14889,1219,601,618
21920,16988,2097,8237,1437,14891,1219,601,618
21925,16989,2098,8238,1438,14891,1219,601,618
21930,16994,2099,8240,1438,14895,1219,601,618
21935,16996,2099,8240,1438,14897,1220,601,619
21940,17004,2100,8244,1439,14904,1220,601,619
21945,17007,2100,8246,1439,14907,1220,601,619
21950,17012,2101,8249,1440,14911,1220,601,619
21955,17016,2101,8251,1440,14915,1220,601,619
21960,17019,2101,8251,1440,14918,1220,601,619
21965,17020,2101,8251,1440,14919,1220,601,619
21970,17025,2102,8253,1441,14923,1221,602,619
21975,17027,2102,8254,1441,14925,1222,603,619
21980,17035,2103,8258,1442,14932,1222,603,619
21985,17038,2103,8259,1442,14935,1222,603,619
21990,17043,2104,8262,1442,14939,1222,603,619
21995,17047,2104,8266,1442,14942,1222,603,619
22000,17050,2105,8267,1443,14945,1222,603,619
22005,17051,2105,8267,1443,14946,1222,603,619
22010,17056,2106,8270,1444,14950,1222,603,619
22015,17058,2106,8272,1444,14952,1223,604,619
22020,17066,2107,8276,1444,14959,1224,605,619
22025,17069,2107,8277,1444,14962,1224,605,619
22030,17074,2107,8281,1444,14967,1224,605,619
22035,17078,2107,8282,1444,14971,1224,605,619
22040,17081,2107,8285,1444,14974,1224,605,619
22045,17082,2107,8285,1444,14975,1224,605,619
22050,17087,2108,8288,1444,14979,1224,605,619
22055,17089,2108,8290,1444,14981,1225,606,619
22060,17097,2110,8293,1446,14987,1225,606,619
22065,17100,2110,8295,1446,14990,1225,606,619
22070,17105,2110,8298,1446,14995,1225,606,619
22075,17109,2110,8300,1446,14999,1225,606,619
22080,17112,2110,8303,1446,15002,1225,606,619
22085,17113,2110,8303,1446,15003,1225,606,619
22090,17118,2111,8306,1447,15007,1226,607,619
22095,17120,2111,8307,1447,15009,1227,607,620
22100,17128,2113,8310,1449,15015,1227,607,620
22105,17131,2113,8311,1449,15018,1227,607,620
22110,17136,2113,8312,1449,15023,1227,607,620
22115,17140,2113,8315,1449,15026,1227,607,620
22120,17143,2114,8315,1450,15029,1227,607,620
22125,17144,2114,8315,1450,15030,1227,607,620
22130,17149,2115,8319,1451,15034,1227,607,620
22135,17151,2115,8319,1451,15036,1228,607,621
22140,17159,2117,8322,1452,15042,1229,608,621
22145,17162,2117,8325,1452,15045,1229,608,621
22150,17167,2118,8329,1452,15049,1229,608,621
22155,17171,2118,8332,1452,15052,1229,608,621
22160,17174,2119,8334,1453,15055,1229,608,621
22165,17175,2119,8335,1453,15056,1229,608,621
22170,17180,2120,8338,1454,15060,1230,609,621
22175,17182,2120,8339,1454,15062,1231,609,622
22180,17190,2120,8343,1454,15070,1231,609,622
22185,17193,2120,8346,1454,15073,1231,609,622
22190,17198,2121,8347,1454,15077,1231,609,622
22195,17202,2121,8349,1454,15081,1231,609,622
22200,17205,2122,8351,1455,15083,1231,609,622
22205,17206,2122,8352,1455,15084,1231,609,622
22210,17211,2123,8353,1455,15088,1232,610,622
22215,17213,2123,8354,1455,15090,1233,610,623
22220,17221,2125,8356,1457,15096,1234,610,624
22225,17224,2125,8357,1457,15099,1234,610,624
22230,17229,2126,8359,1458,15103,1234,610,624
22235,17233,2126,8361,1458,15107,1234,610,624
22240,17236,2127,8363,1459,15109,1234,610,624
22245,17237,2127,8363,1459,15110,1234,610,624
22250,17242,2128,8364,1459,15114,1235,610,625
22255,17244,2128,8365,1459,15116,1236,610,626
22260,17252,2130,8369,1461,15122,1238,611,627
22265,17255,2130,8370,1461,15125,1238,611,627
22270,17260,2130,8371,1461,15130,1238,611,627
22275,17264,2130,8371,1461,15134,1238,611,627
22280,17267,2130,8373,1461,15137,1238,611,627
22285,17268,2130,8374,1461,15138,1238,611,627
22290,17273,2130,8377,1461,15143,1238,611,627
22295,17275,2130,8379,1461,15145,1239,612,627
22300,17283,2130,8380,1461,15153,1239,612,627
22305,17286,2130,8381,1461,15156,1239,612,627
22310,17291,2130,8382,1461,15161,1239,612,627
22315,17295,2130,8385,1461,15165,1239,612,627
22320,17298,2130,8386,1461,15168,1239,612,627
22325,17299,2130,8386,1461,15169,1239,612,627
22330,17304,2130,8389,1461,15174,1239,612,627
22335,17306,2130,8390,1461,15176,1240,612,628
22340,17314,2130,8394,1461,15184,1240,612,628
22345,17317,2130,8397,1461,15187,1240,612,628
22350,17322,2130,8401,1461,15192,1240,612,628
22355,17326,2130,8403,1461,15196,1240,612,628
22360,17329,2130,8404,1461,15199,1240,612,628
22365,17330,2130,8405,1461,15200,1240,612,628
22370,17335,2131,8407,1462,15204,1240,612,628
22375,17337,2131,8409,1462,15206,1241,613,628
22380,17345,2133,8411,1463,15212,1243,614,629
22385,17348,2133,8412,1463,15215,1243,614,629
22390,17353,2134,8416,1464,15219,1243,614,629
22395,17357,2134,8417,1464,15223,1243,614,629
22400,17360,2134,8418,1464,15226,1243,614,629
22405,17361,2134,8418,1464,15227,1243,614,629
22410,17366,2135,8418,1464,15231,1244,614,630
22415,17368,2135,8418,1464,15233,1245,614,631
22420,17376,2138,8421,1467,15238,1245,614,631
22425,17379,2138,8421,1467,15241,1245,614,631
22430,17384,2139,8424,1467,15245,1245,614,631
22435,17388,2139,8425,1467,15249,1245,614,631
22440,17391,2139,8425,1467,15252,1245,614,631
22445,17392,2139,8425,1467,15253,1245,614,631
22450,17397,2140,8427,1468,15257,1246,614,632
22455,17399,2140,8429,1468,15259,1247,615,632
22460,17407,2142,8432,1469,15265,1247,615,632
22465,17410,2142,8433,1469,15268,1247,615,632
22470,17415,2143,8436,1469,15272,1247,615,632
22475,17419,2143,8439,1469,15276,1247,615,632
22480,17422,2144,8441,1470,15278,1247,615,632
22485,17423,2144,8441,1470,15279,1247,615,632
22490,17428,2145,8443,1470,15283,1248,615,633
22495,17430,2145,8444,1470,15285,1249,616,633
22500,17438,2146,8448,1470,15292,1250,616,634
22505,17441,2146,8450,1470,15295,1250,616,634
22510,17446,2146,8452,1470,15300,1250,616,634
22515,17450,2146,8455,1470,15303,1250,616,634
22520,17453,2147,8455,1471,15306,1250,616,634
22525,17454,2147,8455,1471,15307,1250,616,634
22530,17459,2148,8457,1471,15311,1250,616,634
22535,17461,2148,8458,1471,15313,1251,617,634
22540,17469,2148,8461,1471,15321,1251,617,634
22545,17472,2148,8462,1471,15324,1251,617,634
22550,17477,2148,8464,1471,15329,1251,617,634
22555,17481,2148,8467,1471,15333,1251,617,634
22560,17484,2148,8470,1471,15336,1251,617,634
22565,17485,2149,8471,1472,15336,1251,617,634
22570,17490,2150,8473,1473,15340,1252,617,635
22575,17492,2150,8474,1473,15342,1253,618,635
22580,17500,2150,8476,1473,15350,1253,618,635
22585,17503,2150,8479,1473,15353,1253,618,635
22590,17508,2150,8481,1473,15358,1253,618,635
22595,17512,2150,8483,1473,15361,1253,618,635
22600,17515,2151,8486,1474,15364,1253,618,635
22605,17516,2151,8486,1474,15365,1253,618,635
22610,17521,2152,8487,1474,15369,1254,618,636
22615,17523,2152,8488,1474,15371,1255,618,637
22620,17531,2153,8490,1475,15378,1257,619,638
22625,17534,2154,8493,1476,15380,1257,619,638
22630,17539,2155,8496,1476,15384,1257,619,638
22635,17543,2155,8498,1476,15388,1257,619,638
22640,17546,2155,8500,1476,15391,1257,619,638
22645,17547,2155,8501,1476,15392,1257,619,638
22650,17552,2156,8503,1476,15396,1258,620,638
22655,17554,2156,8503,1476,15398,1259,620,639
22660,17562,2157,8506,1476,15405,1260,621,639
22665,17565,2158,8509,1477,15407,1260,621,639
22670,17570,2159,8512,1478,15411,1260,621,639
22675,17574,2159,8513,1478,15415,1260,621,639
22680,17577,2160,8516,1479,15417,1260,621,639
22685,17578,2160,8516,1479,15418,1260,621,639
22690,17583,2161,8520,1479,15422,1260,621,639
22695,17585,2161,8521,1479,15424,1261,621,640
22700,17593,2162,8523,1480,15431,1262,621,641
22705,17596,2163,8524,1481,15433,1262,621,641
22710,17601,2164,8527,1481,15437,1262,621,641
22715,17605,2164,8530,1481,15441,1262,621,641
22720,17608,2165,8533,1482,15443,1262,621,641
22725,17609,2165,8534,1482,15444,1262,621,641
22730,17614,2166,8536,1483,15448,1262,621,641
22735,17616,2166,8537,1483,15450,1263,622,641
22740,17624,2167,8539,1483,15456,1265,622,643
22745,17627,2168,8540,1484,15459,1265,622,643
22750,17632,2168,8541,1484,15464,1265,622,643
22755,17636,2168,8543,1484,15468,1265,622,643
22760,17639,2168,8546,1484,15471,1265,622,643
22765,17640,2169,8547,1485,15471,1265,622,643
22770,17645,2170,8548,1485,15475,1266,622,644
22775,17647,2170,8550,1485,15477,1267,623,644
22780,17655,2170,8556,1485,15485,1267,623,644
22785,17658,2170,8557,1485,15488,1267,623,644
22790,17663,2170,8561,1485,15493,1267,623,644
22795,17667,2170,8562,1485,15497,1267,623,644
22800,17670,2170,8562,1485,15500,1267,623,644
22805,17671,2170,8563,1485,15501,1267,623,644
22810,17676,2171,8566,1486,15505,1267,623,644
22815,17678,2171,8567,1486,15507,1268,623,645
22820,17686,2171,8571,1486,15515,1268,623,645
22825,17689,2171,8571,1486,15518,1268,623,645
22830,17694,2171,8571,1486,15523,1268,623,645
22835,17698,2171,8573,1486,15526,1268,623,645
22840,17701,2172,8575,1487,15529,1268,623,645
22845,17702,2172,8575,1487,15530,1268,623,645
22850,17707,2173,8578,1487,15534,1268,623,645
22855,17709,2173,8579,1487,15536,1269,624,645
22860,17717,2174,8583,1488,15542,1271,625,646
22865,17720,2175,8584,1489,15545,1271,625,646
22870,17725,2176,8587,1490,15549,1271,625,646
22875,17729,2176,8589,1490,15553,1271,625,646
22880,17732,2177,8590,1491,15555,1271,625,646
22885,17733,2177,8591,1491,15556,1271,625,646
22890,17738,2178,8593,1492,15560,1271,625,646
22895,17740,2178,8594,1492,15562,1272,625,647
22900,17748,2179,8597,1492,15569,1273,626,647
22905,17751,2179,8597,1492,15572,1273,626,647
22910,17756,2180,8602,1493,15576,1273,626,647
22915,17760,2180,8602,1493,15580,1273,626,647
22920,17763,2181,8603,1494,15582,1273,626,647
22925,17764,2181,8603,1494,15583,1273,626,647
22930,17769,2182,8606,1494,15587,1273,626,647
22935,17771,2182,8607,1494,15589,1274,627,647
22940,17779,2183,8611,1494,15596,1274,627,647
22945,17782,2183,8611,1494,15599,1274,627,647
22950,17787,2184,8614,1495,15603,1274,627,647
22955,17791,2184,8616,1495,15607,1274,627,647
22960,17794,2184,8617,1495,15610,1274,627,647
22965,17795,2184,8617,1495,15611,1274,627,647
22970,17800,2185,8619,1495,15615,1274,627,647
22975,17802,2185,8619,1495,15617,1275,627,648
22980,17810,2188,8624,1498,15622,1276,627,649
22985,17813,2188,8626,1498,15625,1276,627,649
22990,17818,2189,8628,1498,15629,1276,627,649
22995,17822,2189,8630,1498,15633,1276,627,649
23000,17825,2189,8631,1498,15636,1276,627,649
23005,17826,2189,8632,1498,15637,1276,627,649
23010,17831,2190,8633,1498,15641,1276,627,649
23015,17833,2190,8634,1498,15643,1277,628,649
23020,17841,2190,8638,1498,15651,1277,628,649
23025,17844,2190,8641,1498,15654,1277,628,649
23030,17849,2191,8643,1498,15658,1277,628,649
23035,17853,2191,8645,1498,15662,1277,628,649
23040,17856,2191,8646,1498,15665,1277,628,649
23045,17857,2191,8647,1498,15666,1277,628,649
23050,17862,2192,8650,1499,15670,1278,628,650
23055,17864,2192,8651,1499,15672,1279,628,651
23060,17872,2194,8655,1501,15678,1279,628,651
23065,17875,2194,8656,1501,15681,1279,628,651
23070,17880,2194,8659,1501,15686,1279,628,651
23075,17884,2194,8662,1501,15689,1279,628,651
23080,17887,2195,8664,1502,15692,1279,628,651
23085,17888,2195,8665,1502,15693,1279,628,651
23090,17893,2196,8667,1502,15697,1280,629,651
23095,17895,2196,8668,1502,15699,1281,629,652
23100,17903,2198,8674,1504,15704,1282,630,652
23105,17906,2199,8674,1505,15707,1282,630,652
23110,17911,2199,8677,1505,15712,1282,630,652
23115,17915,2199,8678,1505,15716,1282,630,652
23120,17918,2199,8679,1505,15719,1282,630,652
23125,17919,2199,8679,1505,15720,1282,630,652
23130,17924,2200,8681,1505,15724,1283,631,652
23135,17926,2200,8682,1505,15726,1284,632,652
23140,17934,2202,8688,1507,15732,1284,632,652
23145,17937,2202,8690,1507,15735,1284,632,652
23150,17942,2203,8692,1508,15739,1284,632,652
23155,17946,2203,8693,1508,15743,1284,632,652
23160,17949,2204,8696,1509,15745,1284,632,652
23165,17950,2204,8697,1509,15746,1284,632,652
23170,17955,2205,8699,1509,15750,1284,632,652
23175,17957,2205,8699,1509,15752,1285,632,653
23180,17965,2206,8705,1510,15759,1286,632,654
23185,17968,2207,8707,1511,15761,1286,632,654
23190,17973,2208,8710,1511,15765,1286,632,654
23195,17977,2208,8712,1511,15769,1286,632,654
23200,17980,2208,8714,1511,15772,1286,632,654
23205,17981,2208,8714,1511,15773,1286,632,654
23210,17986,2209,8716,1512,15777,1286,632,654
23215,17988,2209,8718,1512,15779,1287,633,654
23220,17996,2211,8723,1514,15784,1289,634,655
23225,17999,2212,8724,1515,15787,1289,634,655
23230,18004,2213,8727,1516,15791,1289,634,655
23235,18008,2213,8729,1516,15795,1289,634,655
23240,18011,2214,8731,1517,15797,1289,634,655
23245,18012,2214,8732,1517,15798,1289,634,655
23250,18017,2215,8735,1517,15802,1289,634,655
23255,18019,2215,8736,1517,15804,1290,634,656
23260,18027,2217,8743,1519,15809,1291,635,656
23265,18030,2218,8744,1520,15812,1291,635,656
23270,18035,2219,8747,1520,15816,1291,635,656
23275,18039,2219,8748,1520,15820,1291,635,656
23280,18042,2220,8750,1521,15822,1291,635,656
23285,18043,2220,8750,1521,15823,1291,635,656
23290,18048,2221,8755,1522,15827,1291,635,656
23295,18050,2221,8755,1522,15829,1292,635,657
23300,18058,2221,8759,1522,15837,1292,635,657
23305,18061,2221,8762,1522,15840,1292,635,657
23310,18066,2221,8764,1522,15845,1292,635,657
23315,18070,2221,8768,1522,15848,1292,635,657
23320,18073,2222,8770,1523,15851,1292,635,657
23325,18074,2223,8771,1524,15851,1292,635,657
23330,18079,2224,8772,1524,15855,1292,635,657
23335,18081,2224,8772,1524,15857,1293,635,658
23340,18089,2225,8774,1524,15864,1294,635,659
23345,18092,2225,8774,1524,15867,1294,635,659
23350,18097,2225,8776,1524,15872,1294,635,659
23355,18101,2225,8777,1524,15876,1294,635,659
23360,18104,2225,8778,1524,15879,1294,635,659
23365,18105,2225,8779,1524,15880,1294,635,659
23370,18110,2226,8782,1525,15884,1295,636,659
23375,18112,2226,8783,1525,15886,1296,637,659
23380,18120,2228,8786,1527,15892,1297,637,660
23385,18123,2228,8788,1527,15895,1297,637,660
23390,18128,2229,8791,1528,15899,1297,637,660
23395,18132,2229,8792,1528,15903,1297,637,660
23400,18135,2229,8793,1528,15906,1297,637,660
23405,18136,2229,8794,1528,15907,1297,637,660
23410,18141,2230,8797,1529,15911,1297,637,660
23415,18143,2230,8799,1529,15913,1298,638,660
23420,18151,2231,8802,1529,15920,1298,638,660
23425,18154,2231,8805,1529,15923,1298,638,660
23430,18159,2232,8808,1530,15927,1298,638,660
23435,18163,2232,8809,1530,15931,1298,638,660
23440,18166,2232,8809,1530,15934,1298,638,660
23445,18167,2232,8809,1530,15935,1298,638,660
23450,18172,2233,8810,1530,15939,1298,638,660
23455,18174,2233,8811,1530,15941,1299,638,661
23460,18182,2235,8815,1531,15947,1300,638,662
23465,18185,2235,8816,1531,15950,1300,638,662
23470,18190,2236,8820,1532,15954,1300,638,662
23475,18194,2236,8823,1532,15958,1300,638,662
23480,18197,2236,8824,1532,15961,1300,638,662
23485,18198,2237,8825,1533,15961,1300,638,662
23490,18203,2238,8829,1534,15965,1300,638,662
23495,18205,2238,8830,1534,15967,1301,638,663
23500,18213,2239,8832,1534,15974,1301,638,663
23505,18216,2239,8833,1534,15977,1301,638,663
23510,18221,2240,8836,1535,15981,1301,638,663
23515,18225,2240,8839,1535,15985,1301,638,663
23520,18228,2240,8841,1535,15988,1301,638,663
23525,18229,2241,8842,1536,15988,1301,638,663
23530,18234,2242,8845,1537,15992,1302,639,663
23535,18236,2242,8845,1537,15994,1303,639,664
23540,18244,2243,8850,1538,16001,1303,639,664
23545,18247,2243,8853,1538,16004,1303,639,664
23550,18252,2244,8855,1539,16008,1303,639,664
23555,18256,2244,8857,1539,16012,1303,639,664
23560,18259,2244,8858,1539,16015,1303,639,664
23565,18260,2245,8859,1540,16015,1303,639,664
23570,18265,2246,8860,1540,16019,1304,639,665
23575,18267,2246,8861,1540,16021,1305,640,665
23580,18275,2247,8867,1540,16028,1306,641,665
23585,18278,2247,8868,1540,16031,1306,641,665
23590,18283,2248,8871,1541,16035,1306,641,665
23595,18287,2248,8872,1541,16039,1306,641,665
23600,18290,2248,8873,1541,16042,1306,641,665
23605,18291,2248,8873,1541,16043,1306,641,665
23610,18296,2249,8873,1541,16047,1306,641,665
23615,18298,2249,8873,1541,16049,1307,641,666
23620,18306,2251,8878,1543,16055,1307,641,666
23625,18309,2251,8878,1543,16058,1307,641,666
23630,18314,2252,8881,1544,16062,1307,641,666
23635,18318,2252,8883,1544,16065,1307,641,666
23640,18321,2254,8885,1546,16067,1307,641,666
23645,18322,2254,8885,1546,16068,1307,641,666
23650,18327,2254,8888,1546,16073,1308,642,666
23655,18329,2254,8889,1546,16075,1309,643,666
23660,18337,2256,8893,1547,16081,1309,643,666
23665,18340,2256,8895,1547,16084,1309,643,666
23670,18345,2256,8898,1547,16089,1309,643,666
23675,18349,2256,8899,1547,16093,1309,643,666
23680,18352,2256,8901,1547,16096,1309,643,666
23685,18353,2256,8901,1547,16097,1309,643,666
23690,18358,2256,8904,1547,16102,1309,643,666
23695,18360,2256,8905,1547,16104,1310,644,666
23700,18368,2258,8910,1548,16110,1311,645,666
23705,18371,2258,8912,1548,16113,1311,645,666
23710,18376,2258,8914,1548,16118,1311,645,666
23715,18380,2258,8917,1548,16122,1311,645,666
23720,18383,2258,8919,1548,16125,1311,645,666
23725,18384,2258,8920,1548,16126,1311,645,666
23730,18389,2258,8923,1548,16131,1311,645,666
23735,18391,2258,8925,1548,16133,1312,646,666
23740,18399,2260,8930,1549,16139,1312,646,666
23745,18402,2260,8931,1549,16142,1312,646,666
23750,18407,2260,8934,1549,16147,1312,646,666
23755,18411,2260,8937,1549,16150,1312,646,666
23760,18414,2261,8939,1550,16153,1312,646,666
23765,18415,2262,8940,1551,16153,1312,646,666
23770,18420,2263,8944,1551,16157,1312,646,666
23775,18422,2263,8944,1551,16159,1313,646,667
23780,18430,2265,8950,1553,16165,1313,646,667
23785,18433,2265,8951,1553,16168,1313,646,667
23790,18438,2266,8953,1553,16172,1313,646,667
23795,18442,2266,8955,1553,16175,1313,646,667
23800,18445,2268,8956,1555,16177,1313,646,667
23805,18446,2268,8956,1555,16178,1313,646,667
23810,18451,2269,8961,1556,16182,1313,646,667
23815,18453,2269,8962,1556,16184,1314,646,668
23820,18461,2270,8967,1557,16191,1315,647,668
23825,18464,2270,8968,1557,16194,1315,647,668
23830,18469,2270,8971,1557,16199,1315,647,668
23835,18473,2270,8971,1557,16203,1315,647,668
23840,18476,2270,8972,1557,16206,1315,647,668
23845,18477,2270,8972,1557,16207,1315,647,668
23850,18482,2271,8974,1558,16211,1316,647,669
23855,18484,2271,8976,1558,16213,1317,648,669
23860,18492,2273,8978,1559,16219,1317,648,669
23865,18495,2273,8980,1559,16222,1317,648,669
23870,18500,2273,8980,1559,16227,1317,648,669
23875,18504,2273,8984,1559,16231,1317,648,669
23880,18507,2273,8986,1559,16234,1317,648,669
23885,18508,2273,8987,1559,16235,1317,648,669
23890,18513,2274,8989,1559,16239,1318,649,669
23895,18515,2274,8990,1559,16241,1319,650,669
23900,18523,2274,8993,1559,16249,1319,650,669
23905,18526,2274,8994,1559,16252,1319,650,669
23910,18531,2274,8997,1559,16257,1319,650,669
23915,18535,2274,8998,1559,16261,1319,650,669
23920,18538,2274,8999,1559,16264,1319,650,669
23925,18539,2274,9000,1559,16265,1319,650,669
23930,18544,2275,9001,1560,16269,1320,650,670
23935,18546,2275,9001,1560,16271,1321,650,671
23940,18554,2275,9005,1560,16279,1322,650,672
23945,18557,2275,9006,1560,16282,1322,650,672
23950,18562,2275,9011,1560,16287,1322,650,672
23955,18566,2275,9013,1560,16290,1322,650,672
23960,18569,2276,9015,1561,16293,1322,650,672
23965,18570,2277,9016,1562,16293,1322,650,672
23970,18575,2278,9020,1563,16297,1322,650,672
23975,18577,2278,9021,1563,16299,1323,650,673
23980,18585,2280,9025,1565,16305,1324,650,674
23985,18588,2280,9026,1565,16308,1324,650,674
23990,18593,2281,9029,1566,16312,1324,650,674
23995,18597,2281,9032,1566,16316,1324,650,674
24000,18600,2281,9032,1566,16319,1324,650,674
24005,18601,2281,9033,1566,16320,1324,650,674
24010,18606,2281,9035,1566,16325,1324,650,674
24015,18608,2281,9035,1566,16327,1325,650,675
24020,18616,2282,9038,1567,16334,1325,650,675
24025,18619,2282,9040,1567,16337,1325,650,675
24030,18624,2283,9042,1568,16341,1325,650,675
24035,18628,2283,9043,1568,16345,1325,650,675
24040,18631,2284,9045,1569,16347,1325,650,675
24045,18632,2284,9046,1569,16348,1325,650,675
24050,18637,2284,9046,1569,16353,1326,650,676
24055,18639,2284,9046,1569,16355,1327,650,677
24060,18647,2286,9053,1571,16361,1328,651,677
24065,18650,2286,9055,1571,16364,1328,651,677
24070,18655,2287,9059,1571,16368,1328,651,677
24075,18659,2287,9060,1571,16372,1328,651,677
24080,18662,2287,9061,1571,16375,1328,651,677
24085,18663,2287,9061,1571,16376,1328,651,677
24090,18668,2287,9065,1571,16381,1328,651,677
24095,18670,2287,9066,1571,16383,1329,651,678
24100,18678,2287,9072,1571,16391,1329,651,678
24105,18681,2287,9072,1571,16394,1329,651,678
24110,18686,2288,9074,1572,16398,1329,651,678
24115,18690,2288,9076,1572,16402,1329,651,678
24120,18693,2288,9076,1572,16405,1329,651,678
24125,18694,2288,9076,1572,16406,1329,651,678
24130,18699,2289,9078,1573,16410,1329,651,678
24135,18701,2289,9078,1573,16412,1330,651,679
24140,18709,2289,9082,1573,16420,1330,651,679
24145,18712,2289,9082,1573,16423,1330,651,679
24150,18717,2290,9085,1573,16427,1330,651,679
24155,18721,2290,9087,1573,16431,1330,651,679
24160,18724,2290,9089,1573,16434,1330,651,679
24165,18725,2290,9089,1573,16435,1330,651,679
24170,18730,2291,9094,1574,16439,1331,652,679
24175,18732,2291,9096,1574,16441,1332,653,679
24180,18740,2293,9101,1576,16446,1334,654,680
24185,18743,2294,9104,1577,16449,1334,654,680
24190,18748,2294,9106,1577,16454,1334,654,680
24195,18752,2294,9109,1577,16457,1334,654,680
24200,18755,2295,9109,1578,16460,1334,654,680
24205,18756,2295,9109,1578,16461,1334,654,680
24210,18761,2296,9113,1579,16465,1334,654,680
24215,18763,2296,9113,1579,16467,1335,654,681
24220,18771,2298,9115,1580,16473,1335,654,681
24225,18774,2298,9117,1580,16476,1335,654,681
24230,18779,2298,9118,1580,16481,1335,654,681
24235,18783,2298,9118,1580,16485,1335,654,681
24240,18786,2298,9120,1580,16488,1335,654,681
24245,18787,2298,9121,1580,16489,1335,654,681
24250,18792,2299,9123,1580,16493,1335,654,681
24255,18794,2299,9125,1580,16495,1336,655,681
24260,18802,2300,9132,1581,16502,1336,655,681
24265,18805,2300,9132,1581,16505,1336,655,681
24270,18810,2300,9135,1581,16510,1336,655,681
24275,18814,2300,9136,1581,16514,1336,655,681
24280,18817,2300,9137,1581,16517,1336,655,681
24285,18818,2300,9137,1581,16518,1336,655,681
24290,18823,2301,9139,1581,16522,1336,655,681
24295,18825,2301,9139,1581,16524,1337,655,682
24300,18833,2302,9142,1582,16530,1339,656,683
24305,18836,2303,9144,1583,16533,1339,656,683
24310,18841,2304,9148,1584,16537,1339,656,683
24315,18845,2304,9151,1584,16541,1339,656,683
24320,18848,2304,9153,1584,16544,1339,656,683
24325,18849,2305,9154,1585,16544,1339,656,683
24330,18854,2306,9156,1586,16548,1339,656,683
24335,18856,2306,9158,1586,16550,1340,657,683
24340,18864,2307,9162,1586,16557,1340,657,683
24345,18867,2307,9164,1586,16560,1340,657,683
24350,18872,2308,9167,1587,16564,1340,657,683
24355,18876,2308,9170,1587,16568,1340,657,683
24360,18879,2309,9173,1588,16570,1340,657,683
24365,18880,2309,9173,1588,16571,1340,657,683
24370,18885,2310,9176,1589,16575,1340,657,683
24375,18887,2310,9178,1589,16577,1341,658,683
24380,18895,2311,9179,1589,16584,1341,658,683
24385,18898,2311,9180,1589,16587,1341,658,683
24390,18903,2312,9185,1590,16591,1341,658,683
24395,18907,2312,9188,1590,16595,1341,658,683
24400,18910,2313,9189,1591,16597,1341,658,683
24405,18911,2313,9189,1591,16598,1341,658,683
24410,18916,2314,9191,1591,16602,1342,659,683
24415,18918,2314,9192,1591,16604,1343,660,683
24420,18926,2316,9195,1592,16610,1345,661,684
24425,18929,2316,9197,1592,16613,1345,661,684
24430,18934,2317,9199,1592,16617,1345,661,684
24435,18938,2317,9201,1592,16620,1345,661,684
24440,18941,2318,9201,1593,16623,1345,661,684
24445,18942,2318,9202,1593,16624,1345,661,684
24450,18947,2319,9206,1594,16628,1346,662,684
24455,18949,2319,9207,1594,16630,1347,662,685
24460,18957,2319,9209,1594,16638,1347,662,685
24465,18960,2319,9210,1594,16641,1347,662,685
24470,18965,2320,9211,1595,16645,1347,662,685
24475,18969,2320,9215,1595,16648,1347,662,685
24480,18972,2322,9217,1597,16650,1347,662,685
24485,18973,2322,9217,1597,16651,1347,662,685
24490,18978,2323,9221,1598,16655,1347,662,685
24495,18980,2323,9222,1598,16657,1348,663,685
24500,18988,2323,9226,1598,16665,1348,663,685
24505,18991,2323,9227,1598,16668,1348,663,685
24510,18996,2323,9228,1598,16673,1348,663,685
24515,19000,2323,9229,1598,16677,1348,663,685
24520,19003,2323,9230,1598,16680,1348,663,685
24525,19004,2323,9230,1598,16681,1348,663,685
24530,19009,2324,9232,1598,16685,1348,663,685
24535,19011,2324,9232,1598,16687,1349,663,686
24540,19019,2327,9236,1600,16692,1351,664,687
24545,19022,2327,9238,1600,16695,1351,664,687
24550,19027,2327,9240,1600,16700,1351,664,687
24555,19031,2327,9241,1600,16704,1351,664,687
24560,19034,2327,9244,1600,16707,1351,664,687
24565,19035,2327,9245,1600,16708,1351,664,687
24570,19040,2328,9247,1600,16712,1351,664,687
24575,19042,2328,9248,1600,16714,1352,664,688
24580,19050,2330,9252,1601,16720,1352,664,688
24585,19053,2330,9254,1601,16723,1352,664,688
24590,19058,2331,9254,1601,16727,1352,664,688
24595,19062,2331,9256,1601,16731,1352,664,688
24600,19065,2331,9256,1601,16734,1352,664,688
24605,19066,2331,9257,1601,16735,1352,664,688
24610,19071,2332,9259,1601,16739,1353,664,689
24615,19073,2332,9261,1601,16741,1354,665,689
24620,19081,2333,9266,1601,16748,1354,665,689
24625,19084,2333,9266,1601,16751,1354,665,689
24630,19089,2334,9270,1602,16755,1354,665,689
24635,19093,2334,9274,1602,16758,1354,665,689
24640,19096,2336,9276,1604,16760,1354,665,689
24645,19097,2337,9277,1605,16760,1354,665,689
24650,19102,2338,9279,1606,16764,1355,665,690
24655,19104,2338,9280,1606,16766,1356,666,690
24660,19112,2339,9283,1606,16773,1358,668,690
24665,19115,2339,9283,1606,16776,1358,668,690
24670,19120,2340,9287,1607,16780,1358,668,690
24675,19124,2340,9290,1607,16784,1358,668,690
24680,19127,2341,9292,1608,16786,1358,668,690
24685,19128,2342,9293,1609,16786,1358,668,690
24690,19133,2343,9296,1610,16790,1358,668,690
24695,19135,2343,9297,1610,16792,1359,669,690
24700,19143,2344,9302,1611,16799,1359,669,690
24705,19146,2344,9303,1611,16802,1359,669,690
24710,19151,2345,9304,1612,16806,1359,669,690
24715,19155,2345,9305,1612,16810,1359,669,690
24720,19158,2345,9306,1612,16813,1359,669,690
24725,19159,2345,9306,1612,16814,1359,669,690
24730,19164,2346,9309,1612,16818,1359,669,690
24735,19166,2346,9310,1612,16820,1360,670,690
24740,19174,2347,9312,1612,16827,1360,670,690
24745,19177,2347,9314,1612,16830,1360,670,690
24750,19182,2348,9317,1613,16834,1360,670,690
24755,19186,2348,9319,1613,16838,1360,670,690
24760,19189,2349,9321,1614,16840,1360,670,690
24765,19190,2350,9322,1615,16840,1360,670,690
24770,19195,2351,9326,1616,16844,1360,670,690
24775,19197,2351,9328,1616,16846,1361,671,690
24780,19205,2352,9333,1617,16852,1363,673,690
24785,19208,2353,9334,1618,16855,1363,673,690
24790,19213,2354,9336,1618,16859,1363,673,690
24795,19217,2354,9337,1618,16863,1363,673,690
24800,19220,2355,9340,1619,16865,1363,673,690
24805,19221,2355,9340,1619,16866,1363,673,690
24810,19226,2356,9342,1620,16870,1364,673,691
24815,19228,2356,9342,1620,16872,1365,673,692
24820,19236,2357,9346,1620,16879,1365,673,692
24825,19239,2357,9346,1620,16882,1365,673,692
24830,19244,2358,9348,1620,16886,1365,673,692
24835,19248,2358,9350,1620,16890,1365,673,692
24840,19251,2358,9350,1620,16893,1365,673,692
24845,19252,2358,9351,1620,16894,1365,673,692
24850,19257,2359,9353,1620,16898,1366,674,692
24855,19259,2359,9355,1620,16900,1367,675,692
24860,19267,2360,9358,1621,16907,1367,675,692
24865,19270,2360,9360,1621,16910,1367,675,692
24870,19275,2361,9363,1621,16914,1367,675,692
24875,19279,2361,9365,1621,16918,1367,675,692
24880,19282,2361,9366,1621,16921,1367,675,692
24885,19283,2361,9366,1621,16922,1367,675,692
24890,19288,2362,9368,1621,16926,1368,676,692
24895,19290,2362,9368,1621,16928,1369,676,693
24900,19298,2364,9371,1623,16933,1371,676,695
24905,19301,2365,9373,1624,16936,1371,676,695
24910,19306,2366,9374,1625,16940,1371,676,695
24915,19310,2366,9376,1625,16944,1371,676,695
24920,19313,2366,9377,1625,16947,1371,676,695
24925,19314,2366,9377,1625,16948,1371,676,695
24930,19319,2367,9380,1626,16952,1372,676,696
24935,19321,2367,9381,1626,16954,1373,676,697
24940,19329,2368,9385,1627,16961,1373,676,697
24945,19332,2368,9387,1627,16964,1373,676,697
24950,19337,2369,9391,1628,16968,1373,676,697
24955,19341,2369,9392,1628,16972,1373,676,697
24960,19344,2370,9394,1629,16974,1373,676,697
24965,19345,2370,9394,1629,16975,1373,676,697
24970,19350,2371,9397,1630,16979,1374,677,697
24975,19352,2371,9398,1630,16981,1375,678,697
24980,19360,2373,9402,1632,16987,1375,678,697
24985,19363,2373,9402,1632,16990,1375,678,697
24990,19368,2373,9406,1632,16995,1375,678,697
24995,19372,2373,9409,1632,16998,1375,678,697
25000,19375,2374,9409,1633,17001,1375,678,697
25005,19376,2374,9409,1633,17002,1375,678,697
25010,19381,2375,9413,1633,17006,1375,678,697
25015,19383,2375,9414,1633,17008,1376,679,697
25020,19391,2376,9417,1634,17015,1378,679,699
25025,19394,2376,9417,1634,17018,1378,679,699
25030,19399,2376,9420,1634,17023,1378,679,699
25035,19403,2376,9422,1634,17026,1378,679,699
25040,19406,2377,9423,1635,17029,1378,679,699
25045,19407,2377,9424,1635,17030,1378,679,699
25050,19412,2378,9426,1635,17034,1378,679,699
25055,19414,2378,9428,1635,17036,1379,680,699
25060,19422,2378,9433,1635,17044,1379,680,699
25065,19425,2378,9434,1635,17047,1379,680,699
25070,19430,2378,9435,1635,17052,1379,680,699
25075,19434,2378,9439,1635,17055,1379,680,699
25080,19437,2379,9440,1636,17058,1379,680,699
25085,19438,2379,9440,1636,17059,1379,680,699
25090,19443,2380,9443,1637,17063,1379,680,699
25095,19445,2380,9444,1637,17065,1380,681,699
25100,19453,2380,9449,1637,17073,1380,681,699
25105,19456,2380,9451,1637,17076,1380,681,699
25110,19461,2381,9454,1637,17080,1380,681,699
25115,19465,2381,9455,1637,17083,1380,681,699
25120,19468,2382,9456,1638,17086,1380,681,699
25125,19469,2383,9457,1639,17086,1380,681,699
25130,19474,2384,9460,1640,17090,1381,682,699
25135,19476,2384,9460,1640,17092,1382,682,700
25140,19484,2387,9464,1642,17097,1384,682,702
25145,19487,2387,9466,1642,17100,1384,682,702
25150,19492,2388,9470,1642,17104,1384,682,702
25155,19496,2388,9471,1642,17108,1384,682,702
25160,19499,2389,9472,1643,17110,1384,682,702
25165,19500,2389,9472,1643,17111,1384,682,702
25170,19505,2390,9473,1643,17115,1384,682,702
25175,19507,2390,9475,1643,17117,1385,683,702
25180,19515,2390,9478,1643,17125,1385,683,702
25185,19518,2390,9480,1643,17128,1385,683,702
25190,19523,2391,9484,1643,17132,1385,683,702
25195,19527,2391,9486,1643,17135,1385,683,702
25200,19530,2392,9488,1644,17138,1385,683,702
25205,19531,2392,9489,1644,17139,1385,683,702
25210,19536,2393,9490,1645,17143,1385,683,702
25215,19538,2393,9490,1645,17145,1386,683,703
25220,19546,2393,9496,1645,17153,1386,683,703
25225,19549,2393,9499,1645,17156,1386,683,703
25230,19554,2394,9500,1645,17160,1386,683,703
25235,19558,2394,9501,1645,17164,1386,683,703
25240,19561,2395,9502,1646,17166,1386,683,703
25245,19562,2395,9503,1646,17167,1386,683,703
25250,19567,2396,9505,1646,17171,1386,683,703
25255,19569,2396,9506,1646,17173,1387,684,703
25260,19577,2398,9510,1648,17178,1389,684,705
25265,19580,2399,9512,1649,17181,1389,684,705
25270,19585,2399,9514,1649,17186,1389,684,705
25275,19589,2399,9517,1649,17190,1389,684,705
25280,19592,2399,9517,1649,17193,1389,684,705
25285,19593,2400,9518,1650,17193,1389,684,705
25290,19598,2401,9521,1650,17197,1389,684,705
25295,19600,2401,9523,1650,17199,1390,685,705
25300,19608,2403,9525,1651,17205,1390,685,705
25305,19611,2403,9526,1651,17208,1390,685,705
25310,19616,2403,9528,1651,17213,1390,685,705
25315,19620,2403,9529,1651,17217,1390,685,705
25320,19623,2403,9530,1651,17220,1390,685,705
25325,19624,2403,9531,1651,17221,1390,685,705
25330,19629,2404,9533,1652,17225,1390,685,705
25335,19631,2404,9534,1652,17227,1391,685,706
25340,19639,2406,9540,1654,17233,1391,685,706
25345,19642,2406,9541,1654,17236,1391,685,706
25350,19647,2406,9542,1654,17241,1391,685,706
25355,19651,2406,9543,1654,17245,1391,685,706
25360,19654,2406,9544,1654,17248,1391,685,706
25365,19655,2406,9545,1654,17249,1391,685,706
25370,19660,2407,9549,1655,17253,1392,686,706
25375,19662,2407,9549,1655,17255,1393,686,707
25380,19670,2409,9554,1657,17260,1395,687,708
25385,19673,2410,9555,1658,17263,1395,687,708
25390,19678,2411,9557,1658,17267,1395,687,708
25395,19682,2411,9559,1658,17271,1395,687,708
25400,19685,2411,9560,1658,17274,1395,687,708
25405,19686,2411,9561,1658,17275,1395,687,708
25410,19691,2412,9564,1658,17279,1396,688,708
25415,19693,2412,9565,1658,17281,1397,688,709
25420,19701,2413,9570,1659,17288,1397,688,709
25425,19704,2413,9571,1659,17291,1397,688,709
25430,19709,2414,9573,1659,17295,1397,688,709
25435,19713,2414,9575,1659,17299,1397,688,709
25440,19716,2415,9577,1660,17301,1397,688,709
25445,19717,2415,9577,1660,17302,1397,688,709
25450,19722,2416,9578,1661,17306,1397,688,709
25455,19724,2416,9579,1661,17308,1398,688,710
25460,19732,2416,9585,1661,17316,1398,688,710
25465,19735,2416,9587,1661,17319,1398,688,710
25470,19740,2416,9590,1661,17324,1398,688,710
25475,19744,2416,9594,1661,17327,1398,688,710
25480,19747,2417,9596,1662,17330,1398,688,710
25485,19748,2418,9597,1663,17330,1398,688,710
25490,19753,2419,9599,1664,17334,1398,688,710
25495,19755,2419,9600,1664,17336,1399,689,710
25500,19763,2422,9604,1666,17340,1401,690,711
25505,19766,2423,9604,1667,17343,1401,690,711
25510,19771,2423,9607,1667,17348,1401,690,711
25515,19775,2423,9608,1667,17352,1401,690,711
25520,19778,2423,9611,1667,17355,1401,690,711
25525,19779,2423,9612,1667,17356,1401,690,711
25530,19784,2423,9613,1667,17361,1401,690,711
25535,19786,2423,9614,1667,17363,1402,690,712
25540,19794,2424,9617,1667,17370,1402,690,712
25545,19797,2424,9619,1667,17373,1402,690,712
25550,19802,2425,9621,1668,17377,1402,690,712
25555,19806,2425,9625,1668,17381,1402,690,712
25560,19809,2426,9628,1669,17383,1402,690,712
25565,19810,2426,9628,1669,17384,1402,690,712
25570,19815,2427,9630,1670,17388,1403,690,713
25575,19817,2427,9631,1670,17390,1404,691,713
25580,19825,2429,9634,1671,17396,1405,691,714
25585,19828,2429,9636,1671,17399,1405,691,714
25590,19833,2430,9637,1671,17403,1405,691,714
25595,19837,2430,9640,1671,17406,1405,691,714
25600,19840,2432,9641,1673,17408,1405,691,714
25605,19841,2433,9642,1674,17408,1405,691,714
25610,19846,2434,9646,1675,17412,1406,691,715
25615,19848,2434,9646,1675,17414,1407,691,716
25620,19856,2437,9651,1677,17419,1408,692,716
25625,19859,2437,9652,1677,17422,1408,692,716
25630,19864,2437,9657,1677,17427,1408,692,716
25635,19868,2437,9658,1677,17431,1408,692,716
25640,19871,2437,9660,1677,17434,1408,692,716
25645,19872,2437,9661,1677,17435,1408,692,716
25650,19877,2437,9663,1677,17440,1408,692,716
25655,19879,2437,9663,1677,17442,1409,692,717
25660,19887,2438,9666,1677,17449,1410,692,718
25665,19890,2438,9668,1677,17452,1410,692,718
25670,19895,2438,9670,1677,17457,1410,692,718
25675,19899,2438,9673,1677,17461,1410,692,718
25680,19902,2438,9674,1677,17464,1410,692,718
25685,19903,2438,9674,1677,17465,1410,692,718
25690,19908,2438,9676,1677,17470,1410,692,718
25695,19910,2438,9677,1677,17472,1411,693,718
25700,19918,2439,9680,1677,17479,1411,693,718
25705,19921,2439,9682,1677,17482,1411,693,718
25710,19926,2439,9684,1677,17487,1411,693,718
25715,19930,2439,9686,1677,17491,1411,693,718
25720,19933,2439,9687,1677,17494,1411,693,718
25725,19934,2440,9688,1678,17494,1411,693,718
25730,19939,2441,9690,1678,17498,1411,693,718
25735,19941,2441,9691,1678,17500,1412,694,718
25740,19949,2442,9693,1679,17507,1412,694,718
25745,19952,2442,9695,1679,17510,1412,694,718
25750,19957,2443,9697,1679,17514,1412,694,718
25755,19961,2443,9697,1679,17518,1412,694,718
25760,19964,2443,9699,1679,17521,1412,694,718
25765,19965,2443,9699,1679,17522,1412,694,718
25770,19970,2444,9702,1679,17526,1412,694,718
25775,19972,2444,9703,1679,17528,1413,695,718
25780,19980,2445,9707,1679,17535,1413,695,718
25785,19983,2445,9708,1679,17538,1413,695,718
25790,19988,2446,9709,1679,17542,1413,695,718
25795,19992,2446,9710,1679,17546,1413,695,718
25800,19995,2446,9712,1679,17549,1413,695,718
25805,19996,2446,9713,1679,17550,1413,695,718
25810,20001,2447,9715,1679,17554,1413,695,718
25815,20003,2447,9716,1679,17556,1414,696,718
25820,20011,2449,9720,1680,17562,1415,696,719
25825,20014,2450,9721,1681,17564,1415,696,719
25830,20019,2450,9725,1681,17569,1415,696,719
25835,20023,2450,9728,1681,17573,1415,696,719
25840,20026,2450,9729,1681,17576,1415,696,719
25845,20027,2450,9729,1681,17577,1415,696,719
25850,20032,2451,9730,1681,17581,1415,696,719
25855,20034,2451,9731,1681,17583,1416,697,719
25860,20042,2452,9735,1682,17589,1418,699,719
25865,20045,2453,9736,1683,17592,1418,699,719
25870,20050,2453,9738,1683,17597,1418,699,719
25875,20054,2453,9741,1683,17601,1418,699,719
25880,20057,2453,9743,1683,17604,1418,699,719
25885,20058,2453,9744,1683,17605,1418,699,719
25890,20063,2454,9749,1684,17609,1419,700,719
25895,20065,2454,9749,1684,17611,1420,700,720
25900,20073,2454,9754,1684,17619,1420,700,720
25905,20076,2454,9756,1684,17622,1420,700,720
25910,20081,2455,9758,1685,17626,1420,700,720
25915,20085,2455,9760,1685,17630,1420,700,720
25920,20088,2456,9762,1686,17632,1420,700,720
25925,20089,2456,9762,1686,17633,1420,700,720
25930,20094,2457,9765,1686,17637,1420,700,720
25935,20096,2457,9767,1686,17639,1421,701,720
25940,20104,2459,9772,1688,17645,1422,701,721
25945,20107,2459,9773,1688,17648,1422,701,721
25950,20112,2460,9774,1688,17652,1422,701,721
25955,20116,2460,9774,1688,17656,1422,701,721
25960,20119,2460,9775,1688,17659,1422,701,721
25965,20120,2461,9776,1689,17659,1422,701,721
25970,20125,2462,9777,1689,17663,1422,701,721
25975,20127,2462,9777,1689,17665,1423,701,722
25980,20135,2464,9781,1690,17671,1424,701,723
25985,20138,2464,9783,1690,17674,1424,701,723
25990,20143,2464,9786,1690,17679,1424,701,723
25995,20147,2464,9787,1690,17683,1424,701,723
26000,20150,2464,9788,1690,17686,1424,701,723
26005,20151,2464,9788,1690,17687,1424,701,723
26010,20156,2465,9790,1691,17691,1424,701,723
26015,20158,2465,9791,1691,17693,1425,702,723
26020,20166,2466,9794,1692,17700,1425,702,723
26025,20169,2466,9794,1692,17703,1425,702,723
26030,20174,2466,9795,1692,17708,1425,702,723
26035,20178,2466,9798,1692,17712,1425,702,723
26040,20181,2466,9800,1692,17715,1425,702,723
26045,20182,2466,9801,1692,17716,1425,702,723
26050,20187,2467,9802,1693,17720,1426,702,724
26055,20189,2467,9803,1693,17722,1427,703,724
26060,20197,2468,9808,1693,17729,1427,703,724
26065,20200,2468,9810,1693,17732,1427,703,724
26070,20205,2468,9811,1693,17737,1427,703,724
26075,20209,2468,9813,1693,17741,1427,703,724
26080,20212,2468,9815,1693,17744,1427,703,724
26085,20213,2469,9816,1694,17744,1427,703,724
26090,20218,2470,9819,1694,17748,1428,704,724
26095,20220,2470,9820,1694,17750,1429,705,724
26100,20228,2472,9822,1696,17756,1429,705,724
26105,20231,2472,9823,1696,17759,1429,705,724
26110,20236,2473,9827,1697,17763,1429,705,724
26115,20240,2473,9829,1697,17767,1429,705,724
26120,20243,2473,9829,1697,17770,1429,705,724
26125,20244,2474,9830,1698,17770,1429,705,724
26130,20249,2475,9831,1698,17774,1429,705,724
26135,20251,2475,9833,1698,17776,1430,706,724
26140,20259,2476,9836,1698,17783,1430,706,724
26145,20262,2476,9836,1698,17786,1430,706,724
26150,20267,2477,9839,1699,17790,1430,706,724
26155,20271,2477,9841,1699,17793,1430,706,724
26160,20274,2478,9842,1700,17796,1430,706,724
26165,20275,2478,9843,1700,17797,1430,706,724
26170,20280,2479,9845,1700,17801,1430,706,724
26175,20282,2479,9845,1700,17803,1431,706,725
26180,20290,2480,9846,1700,17810,1431,706,725
26185,20293,2480,9846,1700,17813,1431,706,725
26190,20298,2480,9848,1700,17818,1431,706,725
26195,20302,2480,9850,1700,17822,1431,706,725
26200,20305,2480,9852,1700,17825,1431,706,725
26205,20306,2480,9853,1700,17826,1431,706,725
26210,20311,2481,9855,1701,17830,1431,706,725
26215,20313,2481,9856,1701,17832,1432,706,726
26220,20321,2483,9858,1702,17838,1433,706,727
26225,20324,2483,9860,1702,17841,1433,706,727
26230,20329,2483,9863,1702,17846,1433,706,727
26235,20333,2483,9866,1702,17850,1433,706,727
26240,20336,2483,9867,1702,17853,1433,706,727
26245,20337,2483,9868,1702,17854,1433,706,727
26250,20342,2484,9870,1703,17858,1433,706,727
26255,20344,2484,9870,1703,17860,1434,706,728
26260,20352,2485,9873,1703,17867,1434,706,728
26265,20355,2485,9874,1703,17870,1434,706,728
26270,20360,2486,9875,1703,17874,1434,706,728
26275,20364,2486,9878,1703,17877,1434,706,728
26280,20367,2487,9880,1704,17880,1434,706,728
26285,20368,2488,9881,1705,17880,1434,706,728
26290,20373,2489,9883,1706,17884,1434,706,728
26295,20375,2489,9884,1706,17886,1435,707,728
26300,20383,2490,9890,1707,17893,1435,707,728
26305,20386,2490,9892,1707,17896,1435,707,728
26310,20391,2491,9894,1708,17900,1435,707,728
26315,20395,2491,9897,1708,17903,1435,707,728
26320,20398,2493,9899,1710,17905,1435,707,728
26325,20399,2493,9899,1710,17906,1435,707,728
26330,20404,2494,9900,1711,17910,1435,707,728
26335,20406,2494,9900,1711,17912,1436,707,729
26340,20414,2495,9906,1712,17919,1437,708,729
26345,20417,2496,9907,1713,17921,1437,708,729
26350,20422,2497,9909,1713,17925,1437,708,729
26355,20426,2497,9911,1713,17928,1437,708,729
26360,20429,2499,9912,1715,17930,1437,708,729
26365,20430,2499,9912,1715,17931,1437,708,729
26370,20435,2500,9915,1716,17935,1438,709,729
26375,20437,2500,9915,1716,17937,1439,709,730
26380,20445,2501,9920,1717,17944,1440,709,731
26385,20448,2501,9922,1717,17947,1440,709,731
26390,20453,2502,9924,1718,17951,1440,709,731
26395,20457,2502,9924,1718,17955,1440,709,731
26400,20460,2502,9924,1718,17958,1440,709,731
26405,20461,2502,9925,1718,17959,1440,709,731
26410,20466,2503,9930,1719,17963,1440,709,731
26415,20468,2503,9932,1719,17965,1441,710,731
26420,20476,2503,9934,1719,17973,1441,710,731
26425,20479,2503,9936,1719,17976,1441,710,731
26430,20484,2503,9939,1719,17981,1441,710,731
26435,20488,2503,9940,1719,17985,1441,710,731
26440,20491,2503,9942,1719,17988,1441,710,731
26445,20492,2504,9943,1720,17988,1441,710,731
26450,20497,2505,9946,1721,17992,1441,710,731
26455,20499,2505,9947,1721,17994,1442,711,731
26460,20507,2505,9951,1721,18002,1442,711,731
26465,20510,2505,9952,1721,18005,1442,711,731
26470,20515,2505,9956,1721,18010,1442,711,731
26475,20519,2505,9958,1721,18014,1442,711,731
26480,20522,2505,9959,1721,18017,1442,711,731
26485,20523,2506,9960,1722,18017,1442,711,731
26490,20528,2507,9962,1723,18021,1442,711,731
26495,20530,2507,9963,1723,18023,1443,711,732
26500,20538,2507,9964,1723,18031,1443,711,732
26505,20541,2507,9966,1723,18034,1443,711,732
26510,20546,2508,9968,1723,18038,1443,711,732
26515,20550,2508,9970,1723,18041,1443,711,732
26520,20553,2510,9972,1725,18043,1443,711,732
26525,20554,2510,9972,1725,18044,1443,711,732
26530,20559,2510,9974,1725,18049,1443,711,732
26535,20561,2510,9974,1725,18051,1444,711,733
26540,20569,2513,9978,1728,18056,1445,711,734
26545,20572,2513,9979,1728,18059,1445,711,734
26550,20577,2514,9982,1728,18063,1445,711,734
26555,20581,2514,9984,1728,18066,1445,711,734
26560,20584,2515,9984,1729,18069,1445,711,734
26565,20585,2515,9985,1729,18070,1445,711,734
26570,20590,2515,9986,1729,18075,1445,711,734
26575,20592,2515,9988,1729,18077,1446,712,734
26580,20600,2517,9992,1730,18083,1447,713,734
26585,20603,2517,9994,1730,18086,1447,713,734
26590,20608,2517,9999,1730,18091,1447,713,734
26595,20612,2517,10003,1730,18095,1447,713,734
26600,20615,2517,10006,1730,18098,1447,713,734
26605,20616,2517,10006,1730,18099,1447,713,734
26610,20621,2517,10010,1730,18104,1447,713,734
26615,20623,2517,10011,1730,18106,1448,714,734
26620,20631,2517,10016,1730,18114,1448,714,734
26625,20634,2517,10017,1730,18117,1448,714,734
26630,20639,2517,10019,1730,18122,1448,714,734
26635,20643,2517,10021,1730,18126,1448,714,734
26640,20646,2517,10022,1730,18129,1448,714,734
26645,20647,2517,10022,1730,18130,1448,714,734
26650,20652,2518,10024,1731,18134,1448,714,734
26655,20654,2518,10025,1731,18136,1449,714,735
26660,20662,2518,10029,1731,18144,1451,715,736
26665,20665,2518,10030,1731,18147,1451,715,736
26670,20670,2518,10033,1731,18152,1451,715,736
26675,20674,2518,10036,1731,18155,1451,715,736
26680,20677,2519,10036,1732,18158,1451,715,736
26685,20678,2519,10037,1732,18159,1451,715,736
26690,20683,2520,10039,1732,18163,1451,715,736
26695,20685,2520,10040,1732,18165,1452,716,736
26700,20693,2520,10043,1732,18173,1454,717,737
26705,20696,2520,10044,1732,18176,1454,717,737
26710,20701,2521,10047,1733,18180,1454,717,737
26715,20705,2521,10049,1733,18184,1454,717,737
26720,20708,2521,10049,1733,18187,1454,717,737
26725,20709,2521,10049,1733,18188,1454,717,737
26730,20714,2522,10051,1733,18192,1454,717,737
26735,20716,2522,10051,1733,18194,1455,717,738
26740,20724,2522,10054,1733,18202,1456,717,739
26745,20727,2522,10055,1733,18205,1456,717,739
26750,20732,2523,10058,1734,18209,1456,717,739
26755,20736,2523,10061,1734,18212,1456,717,739
26760,20739,2525,10063,1736,18214,1456,717,739
26765,20740,2526,10064,1737,18214,1456,717,739
26770,20745,2527,10068,1738,18218,1456,717,739
26775,20747,2527,10068,1738,18220,1457,717,740
26780,20755,2529,10070,1739,18226,1457,717,740
26785,20758,2529,10072,1739,18229,1457,717,740
26790,20763,2530,10076,1740,18233,1457,717,740
26795,20767,2530,10077,1740,18237,1457,717,740
26800,20770,2530,10078,1740,18240,1457,717,740
26805,20771,2530,10078,1740,18241,1457,717,740
26810,20776,2531,10079,1741,18245,1458,717,741
26815,20778,2531,10080,1741,18247,1459,717,742
26820,20786,2532,10083,1741,18254,1460,717,743
26825,20789,2532,10084,1741,18257,1460,717,743
26830,20794,2533,10087,1742,18261,1460,717,743
26835,20798,2533,10089,1742,18265,1460,717,743
26840,20801,2534,10092,1743,18267,1460,717,743
26845,20802,2534,10092,1743,18268,1460,717,743
26850,20807,2535,10095,1743,18272,1460,717,743
26855,20809,2535,10096,1743,18274,1461,717,744
26860,20817,2536,10101,1743,18281,1461,717,744
26865,20820,2536,10102,1743,18284,1461,717,744
26870,20825,2537,10105,1744,18288,1461,717,744
26875,20829,2537,10106,1744,18292,1461,717,744
26880,20832,2538,10109,1745,18294,1461,717,744
26885,20833,2538,10109,1745,18295,1461,717,744
26890,20838,2539,10113,1746,18299,1461,717,744
26895,20840,2539,10113,1746,18301,1462,717,745
26900,20848,2541,10119,1747,18306,1463,718,745
26905,20851,2542,10120,1748,18309,1463,718,745
26910,20856,2543,10124,1749,18313,1463,718,745
26915,20860,2543,10124,1749,18317,1463,718,745
26920,20863,2544,10127,1750,18319,1463,718,745
26925,20864,2544,10128,1750,18320,1463,718,745
26930,20869,2545,10130,1750,18324,1464,718,746
26935,20871,2545,10130,1750,18326,1465,718,747
26940,20879,2546,10133,1750,18332,1467,719,748
26945,20882,2547,10134,1751,18335,1467,719,748
26950,20887,2547,10136,1751,18340,1467,719,748
26955,20891,2547,10138,1751,18343,1467,719,748
26960,20894,2548,10138,1752,18346,1467,719,748
26965,20895,2549,10139,1753,18346,1467,719,748
26970,20900,2550,10142,1753,18350,1468,719,749
26975,20902,2550,10144,1753,18352,1469,720,749
26980,20910,2551,10149,1754,18359,1469,720,749
26985,20913,2551,10151,1754,18362,1469,720,749
26990,20918,2551,10152,1754,18367,1469,720,749
26995,20922,2551,10154,1754,18370,1469,720,749
27000,20925,2552,10155,1755,18373,1469,720,749
27005,20926,2553,10156,1756,18373,1469,720,749
27010,20931,2554,10158,1756,18377,1469,720,749
27015,20933,2554,10160,1756,18379,1470,721,749
27020,20941,2555,10163,1757,18386,1470,721,749
27025,20944,2555,10163,1757,18389,1470,721,749
27030,20949,2555,10164,1757,18394,1470,721,749
27035,20953,2555,10166,1757,18397,1470,721,749
27040,20956,2556,10168,1758,18400,1470,721,749
27045,20957,2556,10168,1758,18401,1470,721,749
27050,20962,2557,10169,1758,18405,1470,721,749
27055,20964,2557,10169,1758,18407,1471,721,750
27060,20972,2560,10175,1761,18412,1472,721,751
27065,20975,2560,10176,1761,18415,1472,721,751
27070,20980,2561,10178,1761,18419,1472,721,751
27075,20984,2561,10181,1761,18423,1472,721,751
27080,20987,2561,10181,1761,18426,1472,721,751
27085,20988,2561,10182,1761,18427,1472,721,751
27090,20993,2561,10185,1761,18432,1472,721,751
27095,20995,2561,10186,1761,18434,1473,721,752
27100,21003,2562,10189,1762,18441,1473,721,752
27105,21006,2562,10192,1762,18444,1473,721,752
27110,21011,2563,10193,1762,18448,1473,721,752
27115,21015,2563,10193,1762,18452,1473,721,752
27120,21018,2563,10193,1762,18455,1473,721,752
27125,21019,2563,10193,1762,18456,1473,721,752
27130,21024,2563,10196,1762,18461,1473,721,752
27135,21026,2563,10197,1762,18463,1474,721,753
27140,21034,2565,10200,1763,18469,1474,721,753
27145,21037,2565,10201,1763,18472,1474,721,753
27150,21042,2566,10203,1763,18476,1474,721,753
27155,21046,2566,10205,1763,18480,1474,721,753
27160,21049,2567,10208,1764,18482,1474,721,753
27165,21050,2567,10208,1764,18483,1474,721,753
27170,21055,2568,10212,1765,18487,1475,722,753
27175,21057,2568,10212,1765,18489,1476,722,754
27180,21065,2570,10216,1766,18495,1477,722,755
27185,21068,2570,10216,1766,18498,1477,722,755
27190,21073,2570,10218,1766,18503,1477,722,755
27195,21077,2570,10220,1766,18507,1477,722,755
27200,21080,2570,10221,1766,18510,1477,722,755
27205,21081,2570,10221,1766,18511,1477,722,755
27210,21086,2571,10226,1767,18515,1477,722,755
27215,21088,2571,10227,1767,18517,1478,723,755
27220,21096,2572,10230,1768,18524,1478,723,755
27225,21099,2572,10230,1768,18527,1478,723,755
27230,21104,2572,10234,1768,18532,1478,723,755
27235,21108,2572,10234,1768,18536,1478,723,755
27240,21111,2572,10236,1768,18539,1478,723,755
27245,21112,2573,10237,1769,18539,1478,723,755
27250,21117,2574,10239,1770,18543,1478,723,755
27255,21119,2574,10239,1770,18545,1479,723,756
27260,21127,2575,10244,1771,18552,1480,724,756
27265,21130,2576,10247,1772,18554,1480,724,756
27270,21135,2576,10250,1772,18559,1480,724,756
27275,21139,2576,10252,1772,18562,1480,724,756
27280,21142,2577,10252,1773,18565,1480,724,756
27285,21143,2577,10252,1773,18566,1480,724,756
27290,21148,2578,10254,1773,18570,1481,725,756
27295,21150,2578,10255,1773,18572,1482,725,757
27300,21158,2579,10259,1774,18579,1484,726,758
27305,21161,2579,10260,1774,18582,1484,726,758
27310,21166,2580,10262,1774,18586,1484,726,758
27315,21170,2580,10263,1774,18590,1484,726,758
27320,21173,2580,10263,1774,18593,1484,726,758
27325,21174,2580,10263,1774,18594,1484,726,758
27330,21179,2580,10267,1774,18599,1484,726,758
27335,21181,2580,10268,1774,18601,1485,727,758
27340,21189,2581,10272,1774,18608,1485,727,758
27345,21192,2581,10272,1774,18611,1485,727,758
27350,21197,2582,10273,1774,18615,1485,727,758
27355,21201,2582,10276,1774,18618,1485,727,758
27360,21204,2583,10277,1775,18621,1485,727,758
27365,21205,2583,10277,1775,18622,1485,727,758
27370,21210,2583,10279,1775,18627,1486,727,759
27375,21212,2583,10281,1775,18629,1487,728,759
27380,21220,2584,10286,1776,18636,1487,728,759
27385,21223,2584,10288,1776,18639,1487,728,759
27390,21228,2585,10292,1777,18643,1487,728,759
27395,21232,2585,10294,1777,18647,1487,728,759
27400,21235,2586,10297,1778,18649,1487,728,759
27405,21236,2586,10298,1778,18650,1487,728,759
27410,21241,2587,10300,1778,18654,1488,729,759
27415,21243,2587,10301,1778,18656,1489,730,759
27420,21251,2590,10306,1780,18660,1491,731,760
27425,21254,2591,10308,1781,18663,1491,731,760
27430,21259,2591,10312,1781,18668,1491,731,760
27435,21263,2591,10312,1781,18672,1491,731,760
27440,21266,2591,10314,1781,18675,1491,731,760
27445,21267,2591,10314,1781,18676,1491,731,760
27450,21272,2592,10316,1782,18680,1491,731,760
27455,21274,2592,10316,1782,18682,1492,731,761
27460,21282,2593,10317,1782,18689,1492,731,761
27465,21285,2593,10319,1782,18692,1492,731,761
27470,21290,2593,10323,1782,18697,1492,731,761
27475,21294,2593,10325,1782,18701,1492,731,761
27480,21297,2593,10327,1782,18704,1492,731,761
27485,21298,2593,10327,1782,18705,1492,731,761
27490,21303,2594,10328,1782,18709,1492,731,761
27495,21305,2594,10329,1782,18711,1493,732,761
27500,21313,2595,10333,1783,18718,1493,732,761
27505,21316,2595,10333,1783,18721,1493,732,761
27510,21321,2595,10333,1783,18726,1493,732,761
27515,21325,2595,10335,1783,18730,1493,732,761
27520,21328,2595,10336,1783,18733,1493,732,761
27525,21329,2595,10336,1783,18734,1493,732,761
27530,21334,2596,10339,1783,18738,1493,732,761
27535,21336,2596,10341,1783,18740,1494,733,761
27540,21344,2599,10346,1786,18744,1496,733,763
27545,21347,2600,10348,1787,18747,1496,733,763
27550,21352,2601,10350,1788,18751,1496,733,763
27555,21356,2601,10350,1788,18755,1496,733,763
27560,21359,2602,10352,1789,18757,1496,733,763
27565,21360,2602,10353,1789,18758,1496,733,763
27570,21365,2603,10355,1790,18762,1497,734,763
27575,21367,2603,10356,1790,18764,1498,735,763
27580,21375,2605,10360,1791,18770,1498,735,763
27585,21378,2605,10361,1791,18773,1498,735,763
27590,21383,2606,10365,1792,18777,1498,735,763
27595,21387,2606,10367,1792,18780,1498,735,763
27600,21390,2607,10368,1793,18783,1498,735,763
27605,21391,2607,10369,1793,18784,1498,735,763
27610,21396,2608,10371,1793,18788,1499,736,763
27615,21398,2608,10373,1793,18790,1500,737,763
27620,21406,2609,10377,1794,18797,1500,737,763
27625,21409,2609,10377,1794,18800,1500,737,763
27630,21414,2609,10380,1794,18805,1500,737,763
27635,21418,2609,10381,1794,18809,1500,737,763
27640,21421,2609,10382,1794,18812,1500,737,763
27645,21422,2609,10382,1794,18813,1500,737,763
27650,21427,2610,10383,1794,18817,1500,737,763
27655,21429,2610,10385,1794,18819,1501,738,763
27660,21437,2612,10391,1796,18824,1503,739,764
27665,21440,2613,10391,1797,18827,1503,739,764
27670,21445,2613,10393,1797,18832,1503,739,764
27675,21449,2613,10396,1797,18836,1503,739,764
27680,21452,2613,10399,1797,18839,1503,739,764
27685,21453,2613,10400,1797,18840,1503,739,764
27690,21458,2614,10401,1798,18844,1503,739,764
27695,21460,2614,10403,1798,18846,1504,740,764
27700,21468,2614,10409,1798,18854,1504,740,764
27705,21471,2614,10411,1798,18857,1504,740,764
27710,21476,2615,10416,1799,18861,1504,740,764
27715,21480,2615,10418,1799,18865,1504,740,764
27720,21483,2616,10420,1800,18867,1504,740,764
27725,21484,2616,10421,1800,18868,1504,740,764
27730,21489,2617,10421,1800,18872,1505,740,765
27735,21491,2617,10422,1800,18874,1506,741,765
27740,21499,2617,10424,1800,18882,1506,741,765
27745,21502,2617,10426,1800,18885,1506,741,765
27750,21507,2618,10427,1800,18889,1506,741,765
27755,21511,2618,10429,1800,18892,1506,741,765
27760,21514,2619,10429,1801,18895,1506,741,765
27765,21515,2619,10429,1801,18896,1506,741,765
27770,21520,2620,10432,1801,18900,1507,742,765
27775,21522,2620,10433,1801,18902,1508,742,766
27780,21530,2623,10438,1803,18907,1510,744,766
27785,21533,2623,10439,1803,18910,1510,744,766
27790,21538,2624,10440,1803,18914,1510,744,766
27795,21542,2624,10443,1803,18918,1510,744,766
27800,21545,2624,10444,1803,18921,1510,744,766
27805,21546,2624,10444,1803,18922,1510,744,766
27810,21551,2625,10447,1803,18926,1511,745,766
27815,21553,2625,10449,1803,18928,1512,746,766
27820,21561,2626,10452,1803,18935,1512,746,766
27825,21564,2626,10453,1803,18938,1512,746,766
27830,21569,2627,10458,1804,18942,1512,746,766
27835,21573,2627,10461,1804,18946,1512,746,766
27840,21576,2628,10463,1805,18948,1512,746,766
27845,21577,2628,10463,1805,18949,1512,746,766
27850,21582,2629,10466,1805,18953,1512,746,766
27855,21584,2629,10468,1805,18955,1513,747,766
27860,21592,2630,10472,1806,18962,1513,747,766
27865,21595,2630,10472,1806,18965,1513,747,766
27870,21600,2631,10475,1807,18969,1513,747,766
27875,21604,2631,10477,1807,18973,1513,747,766
27880,21607,2632,10480,1808,18975,1513,747,766
27885,21608,2632,10481,1808,18976,1513,747,766
27890,21613,2633,10485,1809,18980,1513,747,766
27895,21615,2633,10487,1809,18982,1514,748,766
27900,21623,2635,10490,1811,18988,1516,748,768
27905,21626,2635,10490,1811,18991,1516,748,768
27910,21631,2635,10494,1811,18996,1516,748,768
27915,21635,2635,10494,1811,19000,1516,748,768
27920,21638,2635,10495,1811,19003,1516,748,768
27925,21639,2635,10496,1811,19004,1516,748,768
27930,21644,2636,10500,1812,19008,1516,748,768
27935,21646,2636,10501,1812,19010,1517,749,768
27940,21654,2636,10506,1812,19018,1517,749,768
27945,21657,2636,10507,1812,19021,1517,749,768
27950,21662,2636,10511,1812,19026,1517,749,768
27955,21666,2636,10513,1812,19029,1517,749,768
27960,21669,2637,10515,1813,19032,1517,749,768
27965,21670,2638,10516,1814,19032,1517,749,768
27970,21675,2639,10516,1814,19036,1518,749,769
27975,21677,2639,10517,1814,19038,1519,749,770
27980,21685,2639,10521,1814,19046,1519,749,770
27985,21688,2639,10523,1814,19049,1519,749,770
27990,21693,2639,10526,1814,19054,1519,749,770
27995,21697,2639,10527,1814,19058,1519,749,770
28000,21700,2639,10529,1814,19061,1519,749,770
28005,21701,2640,10530,1815,19061,1519,749,770
28010,21706,2641,10534,1816,19065,1520,750,770
28015,21708,2641,10535,1816,19067,1521,751,770
28020,21716,2642,10537,1816,19074,1523,752,771
28025,21719,2642,10539,1816,19077,1523,752,771
28030,21724,2643,10541,1816,19081,1523,752,771
28035,21728,2643,10542,1816,19084,1523,752,771
28040,21731,2645,10543,1818,19086,1523,752,771
28045,21732,2645,10543,1818,19087,1523,752,771
28050,21737,2646,10545,1818,19091,1524,753,771
28055,21739,2646,10546,1818,19093,1525,754,771
28060,21747,2647,10550,1819,19100,1525,754,771
28065,21750,2647,10550,1819,19103,1525,754,771
28070,21755,2648,10553,1820,19107,1525,754,771
28075,21759,2648,10555,1820,19110,1525,754,771
28080,21762,2650,10557,1822,19112,1525,754,771
28085,21763,2650,10558,1822,19113,1525,754,771
28090,21768,2651,10560,1822,19117,1525,754,771
28095,21770,2651,10561,1822,19119,1526,755,771
28100,21778,2652,10565,1823,19126,1526,755,771
28105,21781,2652,10566,1823,19129,1526,755,771
28110,21786,2653,10568,1823,19133,1526,755,771
28115,21790,2653,10570,1823,19137,1526,755,771
28120,21793,2653,10571,1823,19140,1526,755,771
28125,21794,2653,10571,1823,19141,1526,755,771
28130,21799,2654,10572,1823,19145,1526,755,771
28135,21801,2654,10572,1823,19147,1527,755,772
28140,21809,2656,10575,1825,19153,1529,755,774
28145,21812,2656,10575,1825,19156,1529,755,774
28150,21817,2656,10578,1825,19161,1529,755,774
28155,21821,2656,10581,1825,19165,1529,755,774
28160,21824,2656,10582,1825,19168,1529,755,774
28165,21825,2656,10582,1825,19169,1529,755,774
28170,21830,2657,10586,1826,19173,1529,755,774
28175,21832,2657,10587,1826,19175,1530,755,775
28180,21840,2657,10593,1826,19183,1530,755,775
28185,21843,2657,10596,1826,19186,1530,755,775
28190,21848,2657,10600,1826,19191,1530,755,775
28195,21852,2657,10601,1826,19195,1530,755,775
28200,21855,2657,10603,1826,19198,1530,755,775
28205,21856,2657,10603,1826,19199,1530,755,775
28210,21861,2658,10606,1826,19203,1530,755,775
28215,21863,2658,10607,1826,19205,1531,755,776
28220,21871,2658,10612,1826,19213,1531,755,776
28225,21874,2658,10612,1826,19216,1531,755,776
28230,21879,2658,10615,1826,19221,1531,755,776
28235,21883,2658,10618,1826,19225,1531,755,776
28240,21886,2658,10619,1826,19228,1531,755,776
28245,21887,2658,10619,1826,19229,1531,755,776
28250,21892,2659,10624,1827,19233,1531,755,776
28255,21894,2659,10625,1827,19235,1532,756,776
28260,21902,2661,10629,1829,19241,1534,756,778
28265,21905,2661,10629,1829,19244,1534,756,778
28270,21910,2662,10630,1829,19248,1534,756,778
28275,21914,2662,10633,1829,19251,1534,756,778
28280,21917,2664,10636,1831,19253,1534,756,778
28285,21918,2664,10637,1831,19254,1534,756,778
28290,21923,2665,10640,1831,19258,1534,756,778
28295,21925,2665,10640,1831,19260,1535,756,779
28300,21933,2666,10645,1832,19267,1535,756,779
28305,21936,2666,10648,1832,19270,1535,756,779
28310,21941,2667,10650,1833,19274,1535,756,779
28315,21945,2667,10653,1833,19277,1535,756,779
28320,21948,2668,10654,1834,19280,1535,756,779
28325,21949,2668,10654,1834,19281,1535,756,779
28330,21954,2669,10657,1835,19285,1535,756,779
28335,21956,2669,10658,1835,19287,1536,756,780
28340,21964,2670,10661,1836,19294,1536,756,780
28345,21967,2670,10663,1836,19297,1536,756,780
28350,21972,2671,10665,1836,19301,1536,756,780
28355,21976,2671,10666,1836,19305,1536,756,780
28360,21979,2672,10668,1837,19307,1536,756,780
28365,21980,2673,10669,1838,19307,1536,756,780
28370,21985,2674,10672,1838,19311,1536,756,780
28375,21987,2674,10673,1838,19313,1537,756,781
28380,21995,2675,10675,1838,19320,1539,757,782
28385,21998,2675,10675,1838,19323,1539,757,782
28390,22003,2676,10678,1839,19327,1539,757,782
28395,22007,2676,10680,1839,19331,1539,757,782
28400,22010,2677,10681,1840,19333,1539,757,782
28405,22011,2677,10681,1840,19334,1539,757,782
28410,22016,2678,10685,1841,19338,1539,757,782
28415,22018,2678,10686,1841,19340,1540,758,782
28420,22026,2679,10689,1841,19347,1541,759,782
28425,22029,2680,10691,1842,19349,1541,759,782
28430,22034,2681,10693,1843,19353,1541,759,782
28435,22038,2681,10694,1843,19357,1541,759,782
28440,22041,2681,10695,1843,19360,1541,759,782
28445,22042,2681,10695,1843,19361,1541,759,782
28450,22047,2682,10697,1843,19365,1541,759,782
28455,22049,2682,10699,1843,19367,1542,760,782
28460,22057,2684,10703,1844,19373,1542,760,782
28465,22060,2684,10705,1844,19376,1542,760,782
28470,22065,2685,10707,1845,19380,1542,760,782
28475,22069,2685,10708,1845,19384,1542,760,782
28480,22072,2685,10709,1845,19387,1542,760,782
28485,22073,2685,10709,1845,19388,1542,760,782
28490,22078,2686,10710,1845,19392,1542,760,782
28495,22080,2686,10711,1845,19394,1543,761,782
28500,22088,2688,10715,1847,19400,1544,761,783
28505,22091,2688,10717,1847,19403,1544,761,783
28510,22096,2688,10720,1847,19408,1544,761,783
28515,22100,2688,10721,1847,19411,1544,761,783
28520,22103,2689,10722,1848,19414,1544,761,783
28525,22104,2689,10723,1848,19415,1544,761,783
28530,22109,2690,10724,1848,19419,1544,761,783
28535,22111,2690,10726,1848,19421,1545,762,783
28540,22119,2690,10731,1848,19429,1545,762,783
28545,22122,2690,10732,1848,19432,1545,762,783
28550,22127,2690,10733,1848,19437,1545,762,783
28555,22131,2690,10735,1848,19441,1545,762,783
28560,22134,2690,10736,1848,19444,1545,762,783
28565,22135,2691,10737,1849,19444,1545,762,783
28570,22140,2692,10738,1849,19448,1546,762,784
28575,22142,2692,10738,1849,19450,1547,762,785
28580,22150,2692,10741,1849,19458,1547,762,785
28585,22153,2692,10742,1849,19461,1547,762,785
28590,22158,2692,10745,1849,19466,1547,762,785
28595,22162,2692,10746,1849,19470,1547,762,785
28600,22165,2692,10747,1849,19473,1547,762,785
28605,22166,2692,10747,1849,19474,1547,762,785
28610,22171,2693,10749,1850,19478,1548,763,785
28615,22173,2693,10750,1850,19480,1549,763,786
28620,22181,2696,10754,1852,19484,1551,763,788
28625,22184,2697,10756,1853,19487,1551,763,788
28630,22189,2698,10757,1854,19491,1551,763,788
28635,22193,2698,10759,1854,19494,1551,763,788
28640,22196,2699,10759,1855,19497,1551,763,788
28645,22197,2699,10759,1855,19498,1551,763,788
28650,22202,2700,10761,1855,19502,1551,763,788
28655,22204,2700,10763,1855,19504,1552,764,788
28660,22212,2700,10768,1855,19512,1552,764,788
28665,22215,2700,10768,1855,19515,1552,764,788
28670,22220,2701,10770,1855,19519,1552,764,788
28675,22224,2701,10772,1855,19523,1552,764,788
28680,22227,2701,10773,1855,19526,1552,764,788
28685,22228,2701,10773,1855,19527,1552,764,788
28690,22233,2702,10776,1856,19531,1552,764,788
28695,22235,2702,10777,1856,19533,1553,764,789
28700,22243,2702,10779,1856,19541,1553,764,789
28705,22246,2702,10781,1856,19544,1553,764,789
28710,22251,2703,10782,1857,19548,1553,764,789
28715,22255,2703,10784,1857,19551,1553,764,789
28720,22258,2705,10785,1859,19553,1553,764,789
28725,22259,2705,10785,1859,19554,1553,764,789
28730,22264,2706,10788,1859,19558,1554,765,789
28735,22266,2706,10789,1859,19560,1555,766,789
28740,22274,2707,10793,1859,19566,1557,768,789
28745,22277,2708,10795,1860,19569,1557,768,789
28750,22282,2708,10798,1860,19574,1557,768,789
28755,22286,2708,10799,1860,19578,1557,768,789
28760,22289,2708,10801,1860,19581,1557,768,789
28765,22290,2708,10801,1860,19582,1557,768,789
28770,22295,2708,10802,1860,19587,1558,768,790
28775,22297,2708,10802,1860,19589,1559,768,791
28780,22305,2710,10805,1862,19595,1559,768,791
28785,22308,2710,10807,1862,19598,1559,768,791
28790,22313,2710,10808,1862,19603,1559,768,791
28795,22317,2710,10811,1862,19607,1559,768,791
28800,22320,2710,10813,1862,19610,1559,768,791
28805,22321,2710,10814,1862,19611,1559,768,791
28810,22326,2710,10816,1862,19616,1559,768,791
28815,22328,2710,10817,1862,19618,1560,768,792
28820,22336,2711,10821,1863,19625,1560,768,792
28825,22339,2711,10821,1863,19628,1560,768,792
28830,22344,2711,10824,1863,19633,1560,768,792
28835,22348,2711,10826,1863,19637,1560,768,792
28840,22351,2711,10827,1863,19640,1560,768,792
28845,22352,2711,10827,1863,19641,1560,768,792
28850,22357,2712,10829,1863,19645,1560,768,792
28855,22359,2712,10829,1863,19647,1561,768,793
28860,22367,2714,10832,1864,19653,1563,769,794
28865,22370,2714,10834,1864,19656,1563,769,794
28870,22375,2715,10837,1865,19660,1563,769,794
28875,22379,2715,10839,1865,19663,1563,769,794
28880,22382,2717,10841,1867,19665,1563,769,794
28885,22383,2717,10841,1867,19666,1563,769,794
28890,22388,2718,10845,1868,19670,1563,769,794
28895,22390,2718,10847,1868,19672,1564,770,794
28900,22398,2719,10852,1868,19679,1564,770,794
28905,22401,2719,10854,1868,19682,1564,770,794
28910,22406,2720,10855,1868,19686,1564,770,794
28915,22410,2720,10858,1868,19690,1564,770,794
28920,22413,2720,10859,1868,19693,1564,770,794
28925,22414,2721,10860,1869,19693,1564,770,794
28930,22419,2722,10862,1869,19697,1565,771,794
28935,22421,2722,10863,1869,19699,1566,772,794
28940,22429,2723,10867,1870,19706,1566,772,794
28945,22432,2723,10868,1870,19709,1566,772,794
28950,22437,2724,10871,1871,19713,1566,772,794
28955,22441,2724,10872,1871,19717,1566,772,794
28960,22444,2724,10874,1871,19720,1566,772,794
28965,22445,2724,10875,1871,19721,1566,772,794
28970,22450,2725,10877,1872,19725,1567,772,795
28975,22452,2725,10878,1872,19727,1568,773,795
28980,22460,2727,10882,1874,19732,1570,774,796
28985,22463,2728,10883,1875,19735,1570,774,796
28990,22468,2728,10886,1875,19740,1570,774,796
28995,22472,2728,10887,1875,19744,1570,774,796
29000,22475,2728,10888,1875,19747,1570,774,796
29005,22476,2728,10889,1875,19748,1570,774,796
29010,22481,2729,10890,1875,19752,1571,775,796
29015,22483,2729,10890,1875,19754,1572,775,797
29020,22491,2730,10894,1875,19761,1572,775,797
29025,22494,2730,10895,1875,19764,1572,775,797
29030,22499,2730,10897,1875,19769,1572,775,797
29035,22503,2730,10899,1875,19773,1572,775,797
29040,22506,2730,10899,1875,19776,1572,775,797
29045,22507,2731,10900,1876,19776,1572,775,797
29050,22512,2732,10903,1877,19780,1572,775,797
29055,22514,2732,10904,1877,19782,1573,775,798
29060,22522,2734,10908,1878,19788,1573,775,798
29065,22525,2734,10908,1878,19791,1573,775,798
29070,22530,2735,10909,1878,19795,1573,775,798
29075,22534,2735,10911,1878,19799,1573,775,798
29080,22537,2735,10913,1878,19802,1573,775,798
29085,22538,2736,10914,1879,19802,1573,775,798
29090,22543,2737,10918,1880,19806,1573,775,798
29095,22545,2737,10919,1880,19808,1574,775,799
29100,22553,2739,10923,1882,19814,1576,776,800
29105,22556,2739,10923,1882,19817,1576,776,800
29110,22561,2739,10926,1882,19822,1576,776,800
29115,22565,2739,10929,1882,19826,1576,776,800
29120,22568,2739,10930,1882,19829,1576,776,800
29125,22569,2739,10930,1882,19830,1576,776,800
29130,22574,2739,10935,1882,19835,1577,777,800
29135,22576,2739,10935,1882,19837,1578,777,801
29140,22584,2739,10940,1882,19845,1578,777,801
29145,22587,2739,10943,1882,19848,1578,777,801
29150,22592,2739,10945,1882,19853,1578,777,801
29155,22596,2739,10947,1882,19857,1578,777,801
29160,22599,2739,10948,1882,19860,1578,777,801
29165,22600,2739,10948,1882,19861,1578,777,801
29170,22605,2739,10950,1882,19866,1579,777,802
29175,22607,2739,10951,1882,19868,1580,777,803
29180,22615,2739,10953,1882,19876,1580,777,803
29185,22618,2739,10955,1882,19879,1580,777,803
29190,22623,2739,10958,1882,19884,1580,777,803
29195,22627,2739,10961,1882,19888,1580,777,803
29200,22630,2739,10963,1882,19891,1580,777,803
29205,22631,2739,10963,1882,19892,1580,777,803
29210,22636,2740,10966,1882,19896,1580,777,803
29215,22638,2740,10968,1882,19898,1581,778,803
29220,22646,2743,10972,1884,19902,1583,779,804
29225,22649,2744,10974,1885,19905,1583,779,804
29230,22654,2745,10975,1886,19909,1583,779,804
29235,22658,2745,10976,1886,19913,1583,779,804
29240,22661,2745,10977,1886,19916,1583,779,804
29245,22662,2745,10977,1886,19917,1583,779,804
29250,22667,2746,10982,1887,19921,1584,780,804
29255,22669,2746,10982,1887,19923,1585,780,805
29260,22677,2747,10987,1888,19930,1585,780,805
29265,22680,2747,10987,1888,19933,1585,780,805
29270,22685,2748,10992,1889,19937,1585,780,805
29275,22689,2748,10992,1889,19941,1585,780,805
29280,22692,2748,10993,1889,19944,1585,780,805
29285,22693,2748,10993,1889,19945,1585,780,805
29290,22698,2749,10996,1889,19949,1585,780,805
29295,22700,2749,10997,1889,19951,1586,780,806
29300,22708,2750,11001,1890,19958,1586,780,806
29305,22711,2750,11002,1890,19961,1586,780,806
29310,22716,2751,11005,1891,19965,1586,780,806
29315,22720,2751,11007,1891,19968,1586,780,806
29320,22723,2752,11008,1892,19971,1586,780,806
29325,22724,2752,11008,1892,19972,1586,780,806
29330,22729,2753,11009,1892,19976,1586,780,806
29335,22731,2753,11011,1892,19978,1587,781,806
29340,22739,2755,11015,1893,19984,1589,782,807
29345,22742,2755,11017,1893,19987,1589,782,807
29350,22747,2756,11019,1894,19991,1589,782,807
29355,22751,2756,11020,1894,19995,1589,782,807
29360,22754,2757,11023,1895,19997,1589,782,807
29365,22755,2757,11023,1895,19998,1589,782,807
29370,22760,2758,11026,1896,20002,1589,782,807
29375,22762,2758,11026,1896,20004,1590,782,808
29380,22770,2759,11032,1897,20011,1590,782,808
29385,22773,2759,11033,1897,20014,1590,782,808
29390,22778,2760,11036,1898,20018,1590,782,808
29395,22782,2760,11036,1898,20022,1590,782,808
29400,22785,2761,11038,1899,20024,1590,782,808
29405,22786,2761,11038,1899,20025,1590,782,808
29410,22791,2762,11041,1900,20029,1590,782,808
29415,22793,2762,11041,1900,20031,1591,782,809
29420,22801,2763,11046,1901,20038,1592,782,810
29425,22804,2763,11047,1901,20041,1592,782,810
29430,22809,2764,11049,1901,20045,1592,782,810
29435,22813,2764,11053,1901,20049,1592,782,810
29440,22816,2764,11053,1901,20052,1592,782,810
29445,22817,2764,11053,1901,20053,1592,782,810
29450,22822,2765,11056,1902,20057,1592,782,810
29455,22824,2765,11057,1902,20059,1593,782,811
29460,22832,2768,11062,1904,20064,1595,782,813
29465,22835,2768,11065,1904,20067,1595,782,813
29470,22840,2768,11066,1904,20072,1595,782,813
29475,22844,2768,11067,1904,20076,1595,782,813
29480,22847,2768,11067,1904,20079,1595,782,813
29485,22848,2769,11068,1905,20079,1595,782,813
29490,22853,2770,11072,1906,20083,1596,782,814
29495,22855,2770,11073,1906,20085,1597,782,815
29500,22863,2772,11078,1908,20091,1598,783,815
29505,22866,2772,11079,1908,20094,1598,783,815
29510,22871,2772,11083,1908,20099,1598,783,815
29515,22875,2772,11085,1908,20103,1598,783,815
29520,22878,2772,11087,1908,20106,1598,783,815
29525,22879,2772,11088,1908,20107,1598,783,815
29530,22884,2772,11092,1908,20112,1598,783,815
29535,22886,2772,11093,1908,20114,1599,783,816
29540,22894,2773,11096,1908,20121,1599,783,816
29545,22897,2773,11098,1908,20124,1599,783,816
29550,22902,2773,11101,1908,20129,1599,783,816
29555,22906,2773,11102,1908,20133,1599,783,816
29560,22909,2773,11104,1908,20136,1599,783,816
29565,22910,2773,11105,1908,20137,1599,783,816
29570,22915,2773,11107,1908,20142,1599,783,816
29575,22917,2773,11107,1908,20144,1600,783,817
29580,22925,2775,11112,1910,20150,1600,783,817
29585,22928,2775,11114,1910,20153,1600,783,817
29590,22933,2776,11115,1910,20157,1600,783,817
29595,22937,2776,11118,1910,20161,1600,783,817
29600,22940,2777,11121,1911,20163,1600,783,817
29605,22941,2777,11122,1911,20164,1600,783,817
29610,22946,2777,11124,1911,20169,1600,783,817
29615,22948,2777,11126,1911,20171,1601,784,817
29620,22956,2779,11131,1912,20177,1601,784,817
29625,22959,2779,11133,1912,20180,1601,784,817
29630,22964,2780,11133,1912,20184,1601,784,817
29635,22968,2780,11133,1912,20188,1601,784,817
29640,22971,2781,11136,1913,20190,1601,784,817
29645,22972,2781,11136,1913,20191,1601,784,817
29650,22977,2782,11139,1914,20195,1601,784,817
29655,22979,2782,11140,1914,20197,1602,785,817
29660,22987,2783,11145,1914,20204,1603,786,817
29665,22990,2784,11147,1915,20206,1603,786,817
29670,22995,2785,11151,1916,20210,1603,786,817
29675,22999,2785,11151,1916,20214,1603,786,817
29680,23002,2785,11152,1916,20217,1603,786,817
29685,23003,2785,11152,1916,20218,1603,786,817
29690,23008,2786,11154,1916,20222,1604,786,818
29695,23010,2786,11156,1916,20224,1605,787,818
29700,23018,2787,11161,1917,20231,1606,787,819
29705,23021,2787,11163,1917,20234,1606,787,819
29710,23026,2788,11167,1918,20238,1606,787,819
29715,23030,2788,11168,1918,20242,1606,787,819
29720,23033,2788,11169,1918,20245,1606,787,819
29725,23034,2788,11169,1918,20246,1606,787,819
29730,23039,2789,11172,1918,20250,1607,788,819
29735,23041,2789,11173,1918,20252,1608,789,819
29740,23049,2790,11175,1918,20259,1608,789,819
29745,23052,2790,11177,1918,20262,1608,789,819
29750,23057,2791,11180,1919,20266,1608,789,819
29755,23061,2791,11182,1919,20269,1608,789,819
29760,23064,2792,11182,1920,20272,1608,789,819
29765,23065,2792,11182,1920,20273,1608,789,819
29770,23070,2793,11185,1921,20277,1608,789,819
29775,23072,2793,11186,1921,20279,1609,790,819
29780,23080,2794,11190,1922,20286,1609,790,819
29785,23083,2794,11190,1922,20289,1609,790,819
29790,23088,2795,11192,1923,20293,1609,790,819
29795,23092,2795,11195,1923,20297,1609,790,819
29800,23095,2795,11196,1923,20300,1609,790,819
29805,23096,2795,11197,1923,20301,1609,790,819
29810,23101,2796,11199,1923,20305,1609,790,819
29815,23103,2796,11201,1923,20307,1610,791,819
29820,23111,2798,11207,1925,20313,1611,791,820
29825,23114,2798,11208,1925,20316,1611,791,820
29830,23119,2798,11209,1925,20321,1611,791,820
29835,23123,2798,11212,1925,20324,1611,791,820
29840,23126,2799,11213,1926,20327,1611,791,820
29845,23127,2799,11213,1926,20328,1611,791,820
29850,23132,2800,11215,1927,20332,1611,791,820
29855,23134,2800,11217,1927,20334,1612,792,820
29860,23142,2801,11219,1927,20341,1613,793,820
29865,23145,2801,11220,1927,20344,1613,793,820
29870,23150,2801,11223,1927,20349,1613,793,820
29875,23154,2801,11225,1927,20353,1613,793,820
29880,23157,2801,11226,1927,20356,1613,793,820
29885,23158,2802,11227,1928,20356,1613,793,820
29890,23163,2803,11231,1929,20360,1614,794,820
29895,23165,2803,11232,1929,20362,1615,795,820
29900,23173,2803,11234,1929,20370,1615,795,820
29905,23176,2803,11235,1929,20373,1615,795,820
29910,23181,2803,11238,1929,20378,1615,795,820
29915,23185,2803,11238,1929,20382,1615,795,820
29920,23188,2803,11239,1929,20385,1615,795,820
29925,23189,2803,11239,1929,20386,1615,795,820
29930,23194,2804,11241,1929,20390,1616,795,821
29935,23196,2804,11241,1929,20392,1617,795,822
29940,23204,2804,11243,1929,20400,1617,795,822
29945,23207,2804,11245,1929,20403,1617,795,822
29950,23212,2805,11248,1930,20407,1617,795,822
29955,23216,2805,11251,1930,20410,1617,795,822
29960,23219,2807,11252,1932,20412,1617,795,822
29965,23220,2807,11253,1932,20413,1617,795,822
29970,23225,2808,11257,1933,20417,1617,795,822
29975,23227,2808,11257,1933,20419,1618,795,823
29980,23235,2809,11259,1934,20426,1618,795,823
29985,23238,2809,11259,1934,20429,1618,795,823
29990,23243,2810,11259,1934,20433,1618,795,823
29995,23247,2810,11261,1934,20436,1618,795,823
30000,23250,2811,11262,1935,20439,1618,795,823
30005,23251,2811,11263,1935,20440,1618,795,823
30010,23256,2812,11265,1936,20444,1618,795,823
30015,23258,2812,11266,1936,20446,1619,796,823
30020,23266,2814,11273,1938,20452,1619,796,823
30025,23269,2814,11275,1938,20455,1619,796,823
30030,23274,2814,11278,1938,20460,1619,796,823
30035,23278,2814,11280,1938,20464,1619,796,823
30040,23281,2814,11282,1938,20467,1619,796,823
30045,23282,2814,11283,1938,20468,1619,796,823
30050,23287,2815,11287,1939,20472,1620,797,823
30055,23289,2815,11287,1939,20474,1621,797,824
30060,23297,2816,11291,1940,20481,1622,797,825
30065,23300,2817,11294,1941,20483,1622,797,825
30070,23305,2817,11296,1941,20488,1622,797,825
30075,23309,2817,11296,1941,20492,1622,797,825
30080,23312,2817,11296,1941,20495,1622,797,825
30085,23313,2817,11296,1941,20496,1622,797,825
30090,23318,2818,11298,1941,20500,1623,798,825
30095,23320,2818,11299,1941,20502,1624,798,826
30100,23328,2819,11304,1942,20509,1625,798,827
30105,23331,2820,11306,1943,20511,1625,798,827
30110,23336,2821,11310,1944,20515,1625,798,827
30115,23340,2821,11311,1944,20518,1625,798,827
30120,23343,2822,11312,1945,20521,1625,798,827
30125,23344,2823,11313,1946,20521,1625,798,827
30130,23349,2824,11315,1947,20525,1625,798,827
30135,23351,2824,11315,1947,20527,1626,798,828
30140,23359,2824,11319,1947,20535,1626,798,828
30145,23362,2824,11320,1947,20538,1626,798,828
30150,23367,2825,11322,1947,20542,1626,798,828
30155,23371,2825,11323,1947,20546,1626,798,828
30160,23374,2825,11324,1947,20549,1626,798,828
30165,23375,2825,11324,1947,20550,1626,798,828
30170,23380,2826,11325,1947,20554,1626,798,828
30175,23382,2826,11326,1947,20556,1627,799,828
30180,23390,2827,11331,1948,20563,1627,799,828
30185,23393,2827,11332,1948,20566,1627,799,828
30190,23398,2828,11333,1948,20570,1627,799,828
30195,23402,2828,11334,1948,20573,1627,799,828
30200,23405,2830,11336,1950,20575,1627,799,828
30205,23406,2830,11337,1950,20576,1627,799,828
30210,23411,2831,11338,1951,20580,1627,799,828
30215,23413,2831,11339,1951,20582,1628,799,829
30220,23421,2831,11345,1951,20590,1628,799,829
30225,23424,2831,11346,1951,20593,1628,799,829
30230,23429,2832,11350,1952,20597,1628,799,829
30235,23433,2832,11351,1952,20601,1628,799,829
30240,23436,2833,11353,1953,20603,1628,799,829
30245,23437,2833,11354,1953,20604,1628,799,829
30250,23442,2833,11357,1953,20609,1629,800,829
30255,23444,2833,11358,1953,20611,1630,801,829
30260,23452,2834,11363,1954,20618,1630,801,829
30265,23455,2834,11364,1954,20621,1630,801,829
30270,23460,2835,11365,1954,20625,1630,801,829
30275,23464,2835,11366,1954,20629,1630,801,829
30280,23467,2835,11368,1954,20632,1630,801,829
30285,23468,2835,11368,1954,20633,1630,801,829
30290,23473,2835,11371,1954,20638,1631,801,830
30295,23475,2835,11371,1954,20640,1632,801,831
30300,23483,2837,11376,1955,20646,1633,802,831
30305,23486,2837,11377,1955,20649,1633,802,831
30310,23491,2838,11380,1956,20653,1633,802,831
30315,23495,2838,11383,1956,20657,1633,802,831
30320,23498,2838,11385,1956,20660,1633,802,831
30325,23499,2838,11385,1956,20661,1633,802,831
30330,23504,2838,11387,1956,20666,1633,802,831
30335,23506,2838,11387,1956,20668,1634,802,832
30340,23514,2839,11392,1957,20675,1635,802,833
30345,23517,2840,11395,1958,20677,1635,802,833
30350,23522,2841,11396,1959,20681,1635,802,833
30355,23526,2841,11400,1959,20684,1635,802,833
30360,23529,2842,11400,1960,20687,1635,802,833
30365,23530,2843,11401,1961,20687,1635,802,833
30370,23535,2844,11404,1962,20691,1635,802,833
30375,23537,2844,11404,1962,20693,1636,802,834
30380,23545,2846,11409,1963,20699,1636,802,834
30385,23548,2846,11411,1963,20702,1636,802,834
30390,23553,2846,11413,1963,20707,1636,802,834
30395,23557,2846,11416,1963,20710,1636,802,834
30400,23560,2847,11418,1964,20713,1636,802,834
30405,23561,2847,11418,1964,20714,1636,802,834
30410,23566,2848,11421,1964,20718,1637,803,834
30415,23568,2848,11421,1964,20720,1638,803,835
30420,23576,2850,11424,1965,20726,1638,803,835
30425,23579,2850,11425,1965,20729,1638,803,835
30430,23584,2850,11427,1965,20734,1638,803,835
30435,23588,2850,11428,1965,20738,1638,803,835
30440,23591,2850,11431,1965,20741,1638,803,835
30445,23592,2850,11432,1965,20742,1638,803,835
30450,23597,2851,11436,1966,20746,1638,803,835
30455,23599,2851,11436,1966,20748,1639,803,836
30460,23607,2853,11439,1967,20754,1639,803,836
30465,23610,2853,11440,1967,20757,1639,803,836
30470,23615,2854,11442,1967,20761,1639,803,836
30475,23619,2854,11445,1967,20764,1639,803,836
30480,23622,2855,11446,1968,20767,1639,803,836
30485,23623,2855,11447,1968,20768,1639,803,836
30490,23628,2855,11448,1968,20773,1640,803,837
30495,23630,2855,11450,1968,20775,1641,804,837
30500,23638,2856,11454,1968,20782,1641,804,837
30505,23641,2856,11457,1968,20785,1641,804,837
30510,23646,2857,11459,1968,20789,1641,804,837
30515,23650,2857,11461,1968,20793,1641,804,837
30520,23653,2857,11463,1968,20796,1641,804,837
30525,23654,2857,11463,1968,20797,1641,804,837
30530,23659,2857,11463,1968,20802,1641,804,837
30535,23661,2857,11464,1968,20804,1642,804,838
30540,23669,2859,11468,1969,20810,1642,804,838
30545,23672,2859,11470,1969,20813,1642,804,838
30550,23677,2860,11472,1970,20817,1642,804,838
30555,23681,2860,11473,1970,20821,1642,804,838
30560,23684,2860,11474,1970,20824,1642,804,838
30565,23685,2860,11475,1970,20825,1642,804,838
30570,23690,2860,11476,1970,20830,1642,804,838
30575,23692,2860,11477,1970,20832,1643,804,839
30580,23700,2862,11481,1971,20838,1643,804,839
30585,23703,2862,11482,1971,20841,1643,804,839
30590,23708,2863,11485,1972,20845,1643,804,839
30595,23712,2863,11487,1972,20848,1643,804,839
30600,23715,2864,11488,1973,20851,1643,804,839
30605,23716,2864,11489,1973,20852,1643,804,839
30610,23721,2865,11492,1974,20856,1643,804,839
30615,23723,2865,11493,1974,20858,1644,804,840
30620,23731,2867,11495,1975,20864,1645,804,841
30625,23734,2867,11495,1975,20867,1645,804,841
30630,23739,2867,11498,1975,20872,1645,804,841
30635,23743,2867,11500,1975,20876,1645,804,841
30640,23746,2867,11500,1975,20879,1645,804,841
30645,23747,2867,11500,1975,20880,1645,804,841
30650,23752,2868,11503,1976,20884,1645,804,841
30655,23754,2868,11503,1976,20886,1646,804,842
30660,23762,2870,11506,1977,20892,1647,804,843
30665,23765,2870,11507,1977,20895,1647,804,843
30670,23770,2870,11507,1977,20900,1647,804,843
30675,23774,2870,11508,1977,20904,1647,804,843
30680,23777,2870,11508,1977,20907,1647,804,843
30685,23778,2870,11508,1977,20908,1647,804,843
30690,23783,2871,11511,1978,20912,1648,804,844
30695,23785,2871,11511,1978,20914,1649,804,845
30700,23793,2872,11514,1979,20921,1649,804,845
30705,23796,2872,11516,1979,20924,1649,804,845
30710,23801,2873,11518,1979,20928,1649,804,845
30715,23805,2873,11521,1979,20931,1649,804,845
30720,23808,2874,11522,1980,20934,1649,804,845
30725,23809,2875,11523,1981,20934,1649,804,845
30730,23814,2876,11527,1981,20938,1649,804,845
30735,23816,2876,11529,1981,20940,1650,805,845
30740,23824,2877,11534,1981,20947,1650,805,845
30745,23827,2877,11535,1981,20950,1650,805,845
30750,23832,2878,11537,1982,20954,1650,805,845
30755,23836,2878,11541,1982,20958,1650,805,845
30760,23839,2879,11544,1983,20960,1650,805,845
30765,23840,2879,11544,1983,20961,1650,805,845
30770,23845,2880,11546,1983,20965,1650,805,845
30775,23847,2880,11546,1983,20967,1651,805,846
30780,23855,2881,11551,1984,20974,1652,806,846
30785,23858,2881,11552,1984,20977,1652,806,846
30790,23863,2882,11556,1985,20981,1652,806,846
30795,23867,2882,11558,1985,20985,1652,806,846
30800,23870,2883,11560,1986,20987,1652,806,846
30805,23871,2883,11560,1986,20988,1652,806,846
30810,23876,2884,11564,1987,20992,1652,806,846
30815,23878,2884,11566,1987,20994,1653,807,846
30820,23886,2885,11571,1987,21001,1653,807,846
30825,23889,2885,11571,1987,21004,1653,807,846
30830,23894,2886,11572,1987,21008,1653,807,846
30835,23898,2886,11574,1987,21012,1653,807,846
30840,23901,2886,11576,1987,21015,1653,807,846
30845,23902,2886,11577,1987,21016,1653,807,846
30850,23907,2887,11581,1988,21020,1653,807,846
30855,23909,2887,11583,1988,21022,1654,808,846
30860,23917,2887,11586,1988,21030,1654,808,846
30865,23920,2887,11588,1988,21033,1654,808,846
30870,23925,2887,11592,1988,21038,1654,808,846
30875,23929,2887,11593,1988,21042,1654,808,846
30880,23932,2887,11595,1988,21045,1654,808,846
30885,23933,2887,11595,1988,21046,1654,808,846
30890,23938,2888,11599,1989,21050,1654,808,846
30895,23940,2888,11600,1989,21052,1655,809,846
30900,23948,2888,11604,1989,21060,1655,809,846
30905,23951,2888,11605,1989,21063,1655,809,846
30910,23956,2888,11607,1989,21068,1655,809,846
30915,23960,2888,11609,1989,21072,1655,809,846
30920,23963,2888,11609,1989,21075,1655,809,846
30925,23964,2888,11610,1989,21076,1655,809,846
30930,23969,2889,11612,1989,21080,1655,809,846
30935,23971,2889,11612,1989,21082,1656,809,847
30940,23979,2889,11615,1989,21090,1656,809,847
30945,23982,2889,11617,1989,21093,1656,809,847
30950,23987,2890,11622,1990,21097,1656,809,847
30955,23991,2890,11625,1990,21100,1656,809,847
30960,23994,2891,11627,1991,21103,1656,809,847
30965,23995,2891,11627,1991,21104,1656,809,847
30970,24000,2892,11631,1992,21108,1656,809,847
30975,24002,2892,11631,1992,21110,1657,809,848
30980,24010,2893,11634,1993,21117,1658,809,849
30985,24013,2893,11634,1993,21120,1658,809,849
30990,24018,2894,11637,1993,21124,1658,809,849
30995,24022,2894,11640,1993,21128,1658,809,849
31000,24025,2895,11641,1994,21130,1658,809,849
31005,24026,2896,11642,1995,21130,1658,809,849
31010,24031,2897,11645,1996,21134,1658,809,849
31015,24033,2897,11647,1996,21136,1659,810,849
31020,24041,2899,11653,1998,21142,1660,810,850
31025,24044,2900,11656,1999,21144,1660,810,850
31030,24049,2901,11657,1999,21148,1660,810,850
31035,24053,2901,11659,1999,21152,1660,810,850
31040,24056,2901,11660,1999,21155,1660,810,850
31045,24057,2901,11660,1999,21156,1660,810,850
31050,24062,2902,11660,1999,21160,1661,810,851
31055,24064,2902,11661,1999,21162,1662,811,851
31060,24072,2903,11664,2000,21169,1663,812,851
31065,24075,2903,11665,2000,21172,1663,812,851
31070,24080,2904,11666,2001,21176,1663,812,851
31075,24084,2904,11669,2001,21179,1663,812,851
31080,24087,2905,11670,2002,21182,1663,812,851
31085,24088,2905,11670,2002,21183,1663,812,851
31090,24093,2906,11672,2002,21187,1663,812,851
31095,24095,2906,11674,2002,21189,1664,813,851
31100,24103,2906,11677,2002,21197,1664,813,851
31105,24106,2906,11678,2002,21200,1664,813,851
31110,24111,2906,11681,2002,21205,1664,813,851
31115,24115,2906,11682,2002,21209,1664,813,851
31120,24118,2906,11684,2002,21212,1664,813,851
31125,24119,2906,11684,2002,21213,1664,813,851
31130,24124,2907,11685,2002,21217,1664,813,851
31135,24126,2907,11686,2002,21219,1665,814,851
31140,24134,2907,11690,2002,21227,1665,814,851
31145,24137,2907,11690,2002,21230,1665,814,851
31150,24142,2907,11693,2002,21235,1665,814,851
31155,24146,2907,11694,2002,21239,1665,814,851
31160,24149,2907,11696,2002,21242,1665,814,851
31165,24150,2907,11696,2002,21243,1665,814,851
31170,24155,2908,11697,2002,21247,1666,814,852
31175,24157,2908,11698,2002,21249,1667,815,852
31180,24165,2908,11700,2002,21257,1667,815,852
31185,24168,2908,11700,2002,21260,1667,815,852
31190,24173,2909,11702,2003,21264,1667,815,852
31195,24177,2909,11705,2003,21267,1667,815,852
31200,24180,2911,11707,2005,21269,1667,815,852
31205,24181,2911,11707,2005,21270,1667,815,852
31210,24186,2912,11708,2005,21274,1667,815,852
31215,24188,2912,11710,2005,21276,1668,816,852
31220,24196,2914,11715,2006,21282,1668,816,852
31225,24199,2914,11716,2006,21285,1668,816,852
31230,24204,2915,11716,2006,21289,1668,816,852
31235,24208,2915,11718,2006,21293,1668,816,852
31240,24211,2916,11721,2007,21295,1668,816,852
31245,24212,2916,11721,2007,21296,1668,816,852
31250,24217,2917,11724,2007,21300,1668,816,852
31255,24219,2917,11725,2007,21302,1669,816,853
31260,24227,2918,11728,2007,21309,1669,816,853
31265,24230,2918,11729,2007,21312,1669,816,853
31270,24235,2919,11729,2007,21316,1669,816,853
31275,24239,2919,11732,2007,21320,1669,816,853
31280,24242,2919,11732,2007,21323,1669,816,853
31285,24243,2920,11733,2008,21323,1669,816,853
31290,24248,2921,11736,2009,21327,1669,816,853
31295,24250,2921,11737,2009,21329,1670,817,853
31300,24258,2922,11741,2010,21336,1670,817,853
31305,24261,2922,11742,2010,21339,1670,817,853
31310,24266,2923,11744,2011,21343,1670,817,853
31315,24270,2923,11748,2011,21346,1670,817,853
31320,24273,2924,11748,2012,21349,1670,817,853
31325,24274,2924,11748,2012,21350,1670,817,853
31330,24279,2925,11751,2013,21354,1670,817,853
31335,24281,2925,11751,2013,21356,1671,817,854
31340,24289,2926,11754,2013,21363,1671,817,854
31345,24292,2926,11754,2013,21366,1671,817,854
31350,24297,2926,11758,2013,21371,1671,817,854
31355,24301,2926,11761,2013,21375,1671,817,854
31360,24304,2926,11763,2013,21378,1671,817,854
31365,24305,2926,11764,2013,21379,1671,817,854
31370,24310,2927,11767,2014,21383,1671,817,854
31375,24312,2927,11767,2014,21385,1672,817,855
31380,24320,2928,11771,2014,21392,1673,818,855
31385,24323,2928,11773,2014,21395,1673,818,855
31390,24328,2929,11776,2014,21399,1673,818,855
31395,24332,2929,11779,2014,21403,1673,818,855
31400,24335,2930,11782,2015,21405,1673,818,855
31405,24336,2930,11782,2015,21406,1673,818,855
31410,24341,2931,11784,2015,21410,1674,818,856
31415,24343,2931,11785,2015,21412,1675,818,857
31420,24351,2933,11788,2016,21418,1675,818,857
31425,24354,2933,11788,2016,21421,1675,818,857
31430,24359,2934,11791,2016,21425,1675,818,857
31435,24363,2934,11793,2016,21429,1675,818,857
31440,24366,2935,11795,2017,21431,1675,818,857
31445,24367,2936,11796,2018,21431,1675,818,857
31450,24372,2937,11799,2019,21435,1675,818,857
31455,24374,2937,11800,2019,21437,1676,819,857
31460,24382,2938,11806,2020,21444,1676,819,857
31465,24385,2938,11808,2020,21447,1676,819,857
31470,24390,2939,11810,2021,21451,1676,819,857
31475,24394,2939,11812,2021,21455,1676,819,857
31480,24397,2940,11815,2022,21457,1676,819,857
31485,24398,2941,11816,2023,21457,1676,819,857
31490,24403,2942,11818,2023,21461,1676,819,857
31495,24405,2942,11818,2023,21463,1677,819,858
31500,24413,2943,11819,2023,21470,1678,819,859
31505,24416,2943,11821,2023,21473,1678,819,859
31510,24421,2944,11822,2023,21477,1678,819,859
31515,24425,2944,11824,2023,21481,1678,819,859
31520,24428,2944,11824,2023,21484,1678,819,859
31525,24429,2944,11824,2023,21485,1678,819,859
31530,24434,2945,11827,2024,21489,1678,819,859
31535,24436,2945,11827,2024,21491,1679,819,860
31540,24444,2946,11831,2025,21498,1679,819,860
31545,24447,2946,11832,2025,21501,1679,819,860
31550,24452,2947,11834,2025,21505,1679,819,860
31555,24456,2947,11836,2025,21508,1679,819,860
31560,24459,2948,11837,2026,21511,1679,819,860
31565,24460,2948,11838,2026,21512,1679,819,860
31570,24465,2949,11840,2026,21516,1679,819,860
31575,24467,2949,11841,2026,21518,1680,820,860
31580,24475,2950,11846,2027,21525,1680,820,860
31585,24478,2950,11846,2027,21528,1680,820,860
31590,24483,2950,11847,2027,21533,1680,820,860
31595,24487,2950,11848,2027,21537,1680,820,860
31600,24490,2950,11851,2027,21540,1680,820,860
31605,24491,2951,11852,2028,21540,1680,820,860
31610,24496,2952,11855,2029,21544,1680,820,860
31615,24498,2952,11856,2029,21546,1681,820,861
31620,24506,2954,11863,2031,21552,1682,820,862
31625,24509,2954,11864,2031,21555,1682,820,862
31630,24514,2954,11866,2031,21560,1682,820,862
31635,24518,2954,11869,2031,21564,1682,820,862
31640,24521,2954,11869,2031,21567,1682,820,862
31645,24522,2954,11869,2031,21568,1682,820,862
31650,24527,2955,11873,2032,21572,1682,820,862
31655,24529,2955,11874,2032,21574,1683,821,862
31660,24537,2957,11878,2033,21580,1683,821,862
31665,24540,2957,11880,2033,21583,1683,821,862
31670,24545,2958,11883,2034,21587,1683,821,862
31675,24549,2958,11886,2034,21590,1683,821,862
31680,24552,2959,11886,2035,21593,1683,821,862
31685,24553,2959,11886,2035,21594,1683,821,862
31690,24558,2959,11890,2035,21599,1683,821,862
31695,24560,2959,11891,2035,21601,1684,821,863
31700,24568,2959,11892,2035,21609,1684,821,863
31705,24571,2959,11894,2035,21612,1684,821,863
31710,24576,2960,11896,2036,21616,1684,821,863
31715,24580,2960,11898,2036,21619,1684,821,863
31720,24583,2962,11899,2038,21621,1684,821,863
31725,24584,2962,11900,2038,21622,1684,821,863
31730,24589,2962,11902,2038,21627,1684,821,863
31735,24591,2962,11903,2038,21629,1685,821,864
31740,24599,2962,11905,2038,21637,1686,821,865
31745,24602,2962,11907,2038,21640,1686,821,865
31750,24607,2962,11907,2038,21645,1686,821,865
31755,24611,2962,11910,2038,21649,1686,821,865
31760,24614,2962,11912,2038,21652,1686,821,865
31765,24615,2962,11912,2038,21653,1686,821,865
31770,24620,2962,11914,2038,21658,1687,822,865
31775,24622,2962,11915,2038,21660,1688,823,865
31780,24630,2962,11918,2038,21668,1688,823,865
31785,24633,2962,11918,2038,21671,1688,823,865
31790,24638,2962,11919,2038,21676,1688,823,865
31795,24642,2962,11921,2038,21680,1688,823,865
31800,24645,2962,11923,2038,21683,1688,823,865
31805,24646,2962,11923,2038,21684,1688,823,865
31810,24651,2963,11927,2039,21688,1688,823,865
31815,24653,2963,11928,2039,21690,1689,824,865
31820,24661,2964,11931,2040,21697,1689,824,865
31825,24664,2964,11931,2040,21700,1689,824,865
31830,24669,2964,11932,2040,21705,1689,824,865
31835,24673,2964,11935,2040,21709,1689,824,865
31840,24676,2964,11935,2040,21712,1689,824,865
31845,24677,2964,11935,2040,21713,1689,824,865
31850,24682,2965,11937,2040,21717,1689,824,865
31855,24684,2965,11938,2040,21719,1690,824,866
31860,24692,2967,11941,2041,21725,1691,825,866
31865,24695,2967,11943,2041,21728,1691,825,866
31870,24700,2968,11948,2042,21732,1691,825,866
31875,24704,2968,11951,2042,21736,1691,825,866
31880,24707,2968,11952,2042,21739,1691,825,866
31885,24708,2969,11953,2043,21739,1691,825,866
31890,24713,2970,11955,2043,21743,1691,825,866
31895,24715,2970,11956,2043,21745,1692,825,867
31900,24723,2970,11961,2043,21753,1693,826,867
31905,24726,2970,11962,2043,21756,1693,826,867
31910,24731,2971,11965,2044,21760,1693,826,867
31915,24735,2971,11967,2044,21764,1693,826,867
31920,24738,2972,11969,2045,21766,1693,826,867
31925,24739,2972,11969,2045,21767,1693,826,867
31930,24744,2973,11970,2046,21771,1693,826,867
31935,24746,2973,11971,2046,21773,1694,827,867
31940,24754,2975,11977,2048,21778,1696,829,867
31945,24757,2976,11979,2049,21781,1696,829,867
31950,24762,2977,11981,2049,21785,1696,829,867
31955,24766,2977,11982,2049,21789,1696,829,867
31960,24769,2977,11982,2049,21792,1696,829,867
31965,24770,2977,11982,2049,21793,1696,829,867
31970,24775,2978,11984,2049,21797,1697,829,868
31975,24777,2978,11986,2049,21799,1698,830,868
31980,24785,2979,11991,2050,21806,1700,832,868
31985,24788,2979,11994,2050,21809,1700,832,868
31990,24793,2980,11997,2050,21813,1700,832,868
31995,24797,2980,11999,2050,21816,1700,832,868
32000,24800,2981,12000,2051,21819,1700,832,868
32005,24801,2981,12001,2051,21820,1700,832,868
32010,24806,2982,12003,2051,21824,1701,832,869
32015,24808,2982,12004,2051,21826,1702,833,869
32020,24816,2983,12009,2052,21833,1702,833,869
32025,24819,2983,12011,2052,21836,1702,833,869
32030,24824,2984,12013,2052,21840,1702,833,869
32035,24828,2984,12015,2052,21844,1702,833,869
32040,24831,2985,12018,2053,21846,1702,833,869
32045,24832,2985,12018,2053,21847,1702,833,869
32050,24837,2986,12021,2053,21851,1702,833,869
32055,24839,2986,12022,2053,21853,1703,834,869
32060,24847,2987,12026,2053,21860,1703,834,869
32065,24850,2987,12029,2053,21863,1703,834,869
32070,24855,2987,12031,2053,21868,1703,834,869
32075,24859,2987,12031,2053,21872,1703,834,869
32080,24862,2987,12033,2053,21875,1703,834,869
32085,24863,2988,12034,2054,21875,1703,834,869
32090,24868,2989,12038,2054,21879,1703,834,869
32095,24870,2989,12039,2054,21881,1704,835,869
32100,24878,2991,12041,2055,21887,1706,836,870
32105,24881,2991,12041,2055,21890,1706,836,870
32110,24886,2991,12042,2055,21895,1706,836,870
32115,24890,2991,12045,2055,21898,1706,836,870
32120,24893,2992,12046,2056,21901,1706,836,870
32125,24894,2992,12046,2056,21902,1706,836,870
32130,24899,2993,12047,2056,21906,1706,836,870
32135,24901,2993,12048,2056,21908,1707,836,871
32140,24909,2995,12054,2058,21914,1708,836,872
32145,24912,2995,12055,2058,21917,1708,836,872
32150,24917,2996,12057,2058,21921,1708,836,872
32155,24921,2996,12059,2058,21925,1708,836,872
32160,24924,2996,12060,2058,21928,1708,836,872
32165,24925,2996,12060,2058,21929,1708,836,872
32170,24930,2997,12062,2058,21933,1708,836,872
32175,24932,2997,12062,2058,21935,1709,836,873
32180,24940,2998,12066,2059,21942,1709,836,873
32185,24943,2998,12067,2059,21945,1709,836,873
32190,24948,2999,12069,2059,21949,1709,836,873
32195,24952,2999,12071,2059,21953,1709,836,873
32200,24955,3000,12074,2060,21955,1709,836,873
32205,24956,3000,12074,2060,21956,1709,836,873
32210,24961,3001,12077,2061,21960,1709,836,873
32215,24963,3001,12077,2061,21962,1710,836,874
32220,24971,3003,12081,2062,21968,1711,837,874
32225,24974,3003,12082,2062,21971,1711,837,874
32230,24979,3004,12083,2063,21975,1711,837,874
32235,24983,3004,12084,2063,21979,1711,837,874
32240,24986,3004,12085,2063,21982,1711,837,874
32245,24987,3004,12086,2063,21983,1711,837,874
32250,24992,3005,12087,2063,21987,1712,838,874
32255,24994,3005,12087,2063,21989,1713,838,875
32260,25002,3006,12089,2063,21996,1713,838,875
32265,25005,3006,12090,2063,21999,1713,838,875
32270,25010,3007,12090,2063,22003,1713,838,875
32275,25014,3007,12091,2063,22007,1713,838,875
32280,25017,3007,12092,2063,22010,1713,838,875
32285,25018,3007,12092,2063,22011,1713,838,875
32290,25023,3008,12094,2064,22015,1713,838,875
32295,25025,3008,12095,2064,22017,1714,839,875
32300,25033,3009,12098,2064,22024,1714,839,875
32305,25036,3009,12099,2064,22027,1714,839,875
32310,25041,3010,12102,2064,22031,1714,839,875
32315,25045,3010,12104,2064,22035,1714,839,875
32320,25048,3011,12107,2065,22037,1714,839,875
32325,25049,3011,12107,2065,22038,1714,839,875
32330,25054,3012,12109,2065,22042,1714,839,875
32335,25056,3012,12111,2065,22044,1715,840,875
32340,25064,3013,12113,2065,22051,1717,840,877
32345,25067,3013,12114,2065,22054,1717,840,877
32350,25072,3013,12116,2065,22059,1717,840,877
32355,25076,3013,12117,2065,22063,1717,840,877
32360,25079,3013,12120,2065,22066,1717,840,877
32365,25080,3013,12120,2065,22067,1717,840,877
32370,25085,3014,12123,2066,22071,1717,840,877
32375,25087,3014,12123,2066,22073,1718,840,878
32380,25095,3016,12128,2068,22079,1718,840,878
32385,25098,3016,12129,2068,22082,1718,840,878
32390,25103,3016,12131,2068,22087,1718,840,878
32395,25107,3016,12133,2068,22091,1718,840,878
32400,25110,3016,12136,2068,22094,1718,840,878
32405,25111,3016,12137,2068,22095,1718,840,878
32410,25116,3017,12139,2068,22099,1719,841,878
32415,25118,3017,12141,2068,22101,1720,842,878
32420,25126,3019,12146,2070,22107,1720,842,878
32425,25129,3019,12147,2070,22110,1720,842,878
32430,25134,3019,12149,2070,22115,1720,842,878
32435,25138,3019,12150,2070,22119,1720,842,878
32440,25141,3019,12151,2070,22122,1720,842,878
32445,25142,3019,12151,2070,22123,1720,842,878
32450,25147,3020,12154,2071,22127,1721,843,878
32455,25149,3020,12155,2071,22129,1722,844,878
32460,25157,3023,12159,2073,22133,1724,845,879
32465,25160,3024,12161,2074,22136,1724,845,879
32470,25165,3025,12165,2075,22140,1724,845,879
32475,25169,3025,12167,2075,22144,1724,845,879
32480,25172,3026,12168,2076,22146,1724,845,879
32485,25173,3026,12169,2076,22147,1724,845,879
32490,25178,3027,12173,2077,22151,1724,845,879
32495,25180,3027,12173,2077,22153,1725,845,880
32500,25188,3028,12176,2078,22160,1725,845,880
32505,25191,3028,12177,2078,22163,1725,845,880
32510,25196,3029,12178,2078,22167,1725,845,880
32515,25200,3029,12180,2078,22171,1725,845,880
32520,25203,3030,12182,2079,22173,1725,845,880
32525,25204,3031,12183,2080,22173,1725,845,880
32530,25209,3032,12185,2080,22177,1725,845,880
32535,25211,3032,12185,2080,22179,1726,845,881
32540,25219,3032,12189,2080,22187,1726,845,881
32545,25222,3032,12191,2080,22190,1726,845,881
32550,25227,3033,12194,2080,22194,1726,845,881
32555,25231,3033,12196,2080,22198,1726,845,881
32560,25234,3034,12197,2081,22200,1726,845,881
32565,25235,3034,12197,2081,22201,1726,845,881
32570,25240,3035,12199,2081,22205,1726,845,881
32575,25242,3035,12200,2081,22207,1727,845,882
32580,25250,3036,12205,2082,22213,1729,846,883
32585,25253,3037,12206,2083,22216,1729,846,883
32590,25258,3038,12208,2083,22220,1729,846,883
32595,25262,3038,12209,2083,22224,1729,846,883
32600,25265,3039,12211,2084,22226,1729,846,883
32605,25266,3039,12211,2084,22227,1729,846,883
32610,25271,3040,12213,2085,22231,1730,846,884
32615,25273,3040,12214,2085,22233,1731,847,884
32620,25281,3041,12219,2086,22240,1731,847,884
32625,25284,3041,12219,2086,22243,1731,847,884
32630,25289,3042,12219,2086,22247,1731,847,884
32635,25293,3042,12221,2086,22251,1731,847,884
32640,25296,3042,12222,2086,22254,1731,847,884
32645,25297,3042,12223,2086,22255,1731,847,884
32650,25302,3043,12224,2086,22259,1732,847,885
32655,25304,3043,12225,2086,22261,1733,848,885
32660,25312,3044,12227,2086,22268,1733,848,885
32665,25315,3044,12230,2086,22271,1733,848,885
32670,25320,3045,12232,2086,22275,1733,848,885
32675,25324,3045,12233,2086,22278,1733,848,885
32680,25327,3046,12235,2087,22281,1733,848,885
32685,25328,3046,12235,2087,22282,1733,848,885
32690,25333,3047,12236,2087,22286,1734,849,885
32695,25335,3047,12237,2087,22288,1735,849,886
32700,25343,3049,12243,2089,22293,1737,850,887
32705,25346,3050,12243,2090,22296,1737,850,887
32710,25351,3050,12245,2090,22301,1737,850,887
32715,25355,3050,12247,2090,22305,1737,850,887
32720,25358,3050,12249,2090,22308,1737,850,887
32725,25359,3051,12250,2091,22308,1737,850,887
32730,25364,3052,12251,2092,22312,1737,850,887
32735,25366,3052,12252,2092,22314,1738,851,887
32740,25374,3053,12256,2093,22321,1738,851,887
32745,25377,3053,12256,2093,22324,1738,851,887
32750,25382,3053,12259,2093,22329,1738,851,887
32755,25386,3053,12260,2093,22333,1738,851,887
32760,25389,3053,12262,2093,22336,1738,851,887
32765,25390,3053,12262,2093,22337,1738,851,887
32770,25395,3054,12263,2093,22341,1738,851,887
32775,25397,3054,12263,2093,22343,1739,851,888
32780,25405,3056,12268,2094,22349,1739,851,888
32785,25408,3056,12270,2094,22352,1739,851,888
32790,25413,3056,12273,2094,22357,1739,851,888
32795,25417,3056,12274,2094,22361,1739,851,888
32800,25420,3056,12274,2094,22364,1739,851,888
32805,25421,3056,12274,2094,22365,1739,851,888
32810,25426,3057,12275,2095,22369,1739,851,888
32815,25428,3057,12277,2095,22371,1740,852,888
32820,25436,3058,12280,2096,22377,1742,853,889
32825,25439,3059,12280,2097,22380,1742,853,889
32830,25444,3060,12282,2097,22384,1742,853,889
32835,25448,3060,12283,2097,22387,1742,853,889
32840,25451,3061,12285,2098,22390,1742,853,889
32845,25452,3061,12285,2098,22391,1742,853,889
32850,25457,3062,12287,2099,22395,1743,853,890
32855,25459,3062,12288,2099,22397,1744,854,890
32860,25467,3063,12290,2099,22404,1744,854,890
32865,25470,3063,12293,2099,22407,1744,854,890
32870,25475,3064,12296,2099,22411,1744,854,890
32875,25479,3064,12300,2099,22414,1744,854,890
32880,25482,3065,12300,2100,22417,1744,854,890
32885,25483,3065,12300,2100,22418,1744,854,890
32890,25488,3066,12301,2100,22422,1745,854,891
32895,25490,3066,12301,2100,22424,1746,854,892
32900,25498,3068,12305,2102,22430,1746,854,892
32905,25501,3068,12306,2102,22433,1746,854,892
32910,25506,3068,12308,2102,22438,1746,854,892
32915,25510,3068,12311,2102,22442,1746,854,892
32920,25513,3068,12312,2102,22445,1746,854,892
32925,25514,3068,12313,2102,22446,1746,854,892
32930,25519,3069,12314,2102,22450,1746,854,892
32935,25521,3069,12315,2102,22452,1747,854,893
32940,25529,3072,12319,2104,22457,1749,855,894
32945,25532,3072,12321,2104,22460,1749,855,894
32950,25537,3072,12323,2104,22465,1749,855,894
32955,25541,3072,12326,2104,22468,1749,855,894
32960,25544,3073,12326,2105,22471,1749,855,894
32965,25545,3074,12327,2106,22471,1749,855,894
32970,25550,3075,12328,2107,22475,1749,855,894
32975,25552,3075,12329,2107,22477,1750,855,895
32980,25560,3077,12333,2109,22483,1750,855,895
32985,25563,3077,12334,2109,22486,1750,855,895
32990,25568,3078,12336,2110,22490,1750,855,895
32995,25572,3078,12337,2110,22493,1750,855,895
33000,25575,3080,12338,2112,22495,1750,855,895
33005,25576,3080,12339,2112,22496,1750,855,895
33010,25581,3081,12340,2112,22500,1750,855,895
33015,25583,3081,12342,2112,22502,1751,856,895
33020,25591,3082,12347,2113,22509,1751,856,895
33025,25594,3082,12349,2113,22512,1751,856,895
33030,25599,3083,12351,2113,22516,1751,856,895
33035,25603,3083,12352,2113,22520,1751,856,895
33040,25606,3083,12354,2113,22523,1751,856,895
33045,25607,3083,12355,2113,22524,1751,856,895
33050,25612,3084,12358,2114,22528,1752,856,896
33055,25614,3084,12359,2114,22530,1753,857,896
33060,25622,3085,12362,2115,22537,1755,859,896
33065,25625,3085,12363,2115,22540,1755,859,896
33070,25630,3086,12368,2116,22544,1755,859,896
33075,25634,3086,12370,2116,22548,1755,859,896
33080,25637,3087,12372,2117,22550,1755,859,896
33085,25638,3087,12373,2117,22551,1755,859,896
33090,25643,3087,12375,2117,22556,1756,860,896
33095,25645,3087,12376,2117,22558,1757,861,896
33100,25653,3087,12381,2117,22566,1758,862,896
33105,25656,3087,12383,2117,22569,1758,862,896
33110,25661,3088,12386,2118,22573,1758,862,896
33115,25665,3088,12388,2118,22577,1758,862,896
33120,25668,3088,12390,2118,22580,1758,862,896
33125,25669,3088,12391,2118,22581,1758,862,896
33130,25674,3088,12393,2118,22586,1758,862,896
33135,25676,3088,12394,2118,22588,1759,863,896
33140,25684,3088,12400,2118,22596,1760,864,896
33145,25687,3088,12402,2118,22599,1760,864,896
33150,25692,3089,12404,2119,22603,1760,864,896
33155,25696,3089,12407,2119,22607,1760,864,896
33160,25699,3089,12408,2119,22610,1760,864,896
33165,25700,3090,12409,2120,22610,1760,864,896
33170,25705,3091,12412,2120,22614,1760,864,896
33175,25707,3091,12413,2120,22616,1761,865,896
33180,25715,3093,12418,2122,22622,1763,867,896
33185,25718,3093,12418,2122,22625,1763,867,896
33190,25723,3094,12420,2122,22629,1763,867,896
33195,25727,3094,12423,2122,22632,1763,867,896
33200,25730,3095,12425,2123,22635,1763,867,896
33205,25731,3095,12425,2123,22636,1763,867,896
33210,25736,3096,12427,2123,22640,1763,867,896
33215,25738,3096,12427,2123,22642,1764,867,897
33220,25746,3097,12428,2123,22649,1764,867,897
33225,25749,3097,12429,2123,22652,1764,867,897
33230,25754,3098,12431,2124,22656,1764,867,897
33235,25758,3098,12433,2124,22660,1764,867,897
33240,25761,3098,12434,2124,22663,1764,867,897
33245,25762,3098,12435,2124,22664,1764,867,897
33250,25767,3099,12437,2125,22668,1765,867,898
33255,25769,3099,12438,2125,22670,1766,868,898
33260,25777,3101,12441,2127,22676,1766,868,898
33265,25780,3101,12443,2127,22679,1766,868,898
33270,25785,3101,12447,2127,22684,1766,868,898
33275,25789,3101,12449,2127,22687,1766,868,898
33280,25792,3102,12451,2128,22690,1766,868,898
33285,25793,3102,12451,2128,22691,1766,868,898
33290,25798,3103,12455,2128,22695,1767,869,898
33295,25800,3103,12455,2128,22697,1768,869,899
33300,25808,3106,12462,2131,22701,1770,871,899
33305,25811,3107,12464,2132,22704,1770,871,899
33310,25816,3107,12466,2132,22709,1770,871,899
33315,25820,3107,12467,2132,22713,1770,871,899
33320,25823,3107,12468,2132,22716,1770,871,899
33325,25824,3107,12468,2132,22717,1770,871,899
33330,25829,3108,12470,2132,22721,1771,871,900
33335,25831,3108,12472,2132,22723,1772,872,900
33340,25839,3108,12477,2132,22731,1772,872,900
33345,25842,3108,12477,2132,22734,1772,872,900
33350,25847,3109,12480,2133,22738,1772,872,900
33355,25851,3109,12482,2133,22742,1772,872,900
33360,25854,3109,12483,2133,22745,1772,872,900
33365,25855,3110,12484,2134,22745,1772,872,900
33370,25860,3111,12487,2134,22749,1772,872,900
33375,25862,3111,12487,2134,22751,1773,872,901
33380,25870,3112,12490,2135,22758,1773,872,901
33385,25873,3112,12491,2135,22761,1773,872,901
33390,25878,3113,12494,2136,22765,1773,872,901
33395,25882,3113,12494,2136,22769,1773,872,901
33400,25885,3113,12494,2136,22772,1773,872,901
33405,25886,3114,12495,2137,22772,1773,872,901
33410,25891,3115,12497,2137,22776,1773,872,901
33415,25893,3115,12498,2137,22778,1774,873,901
33420,25901,3117,12502,2138,22784,1776,875,901
33425,25904,3117,12503,2138,22787,1776,875,901
33430,25909,3118,12505,2139,22791,1776,875,901
33435,25913,3118,12507,2139,22795,1776,875,901
33440,25916,3118,12508,2139,22798,1776,875,901
33445,25917,3118,12509,2139,22799,1776,875,901
33450,25922,3118,12512,2139,22804,1777,876,901
33455,25924,3118,12514,2139,22806,1778,877,901
33460,25932,3118,12518,2139,22814,1778,877,901
33465,25935,3118,12519,2139,22817,1778,877,901
33470,25940,3119,12520,2139,22821,1778,877,901
33475,25944,3119,12523,2139,22825,1778,877,901
33480,25947,3119,12524,2139,22828,1778,877,901
33485,25948,3119,12525,2139,22829,1778,877,901
33490,25953,3119,12527,2139,22834,1779,877,902
33495,25955,3119,12529,2139,22836,1780,878,902
33500,25963,3119,12532,2139,22844,1780,878,902
33505,25966,3119,12533,2139,22847,1780,878,902
33510,25971,3120,12536,2139,22851,1780,878,902
33515,25975,3120,12537,2139,22855,1780,878,902
33520,25978,3121,12539,2140,22857,1780,878,902
33525,25979,3121,12540,2140,22858,1780,878,902
33530,25984,3122,12542,2140,22862,1781,879,902
33535,25986,3122,12542,2140,22864,1782,879,903
33540,25994,3124,12546,2142,22869,1784,879,905
33545,25997,3125,12549,2143,22872,1784,879,905
33550,26002,3126,12551,2143,22876,1784,879,905
33555,26006,3126,12552,2143,22880,1784,879,905
33560,26009,3127,12554,2144,22882,1784,879,905
33565,26010,3127,12555,2144,22883,1784,879,905
33570,26015,3128,12558,2145,22887,1784,879,905
33575,26017,3128,12560,2145,22889,1785,880,905
33580,26025,3129,12564,2146,22896,1785,880,905
33585,26028,3129,12565,2146,22899,1785,880,905
33590,26033,3130,12569,2147,22903,1785,880,905
33595,26037,3130,12570,2147,22907,1785,880,905
33600,26040,3130,12572,2147,22910,1785,880,905
33605,26041,3130,12573,2147,22911,1785,880,905
33610,26046,3131,12576,2147,22915,1785,880,905
33615,26048,3131,12578,2147,22917,1786,881,905
33620,26056,3132,12582,2147,22924,1786,881,905
33625,26059,3132,12582,2147,22927,1786,881,905
33630,26064,3133,12584,2147,22931,1786,881,905
33635,26068,3133,12586,2147,22935,1786,881,905
33640,26071,3133,12588,2147,22938,1786,881,905
33645,26072,3133,12589,2147,22939,1786,881,905
33650,26077,3134,12590,2148,22943,1786,881,905
33655,26079,3134,12591,2148,22945,1787,882,905
33660,26087,3135,12594,2149,22951,1789,883,906
33665,26090,3136,12596,2150,22954,1789,883,906
33670,26095,3136,12599,2150,22959,1789,883,906
33675,26099,3136,12601,2150,22963,1789,883,906
33680,26102,3136,12602,2150,22966,1789,883,906
33685,26103,3136,12602,2150,22967,1789,883,906
33690,26108,3137,12605,2150,22971,1789,883,906
33695,26110,3137,12606,2150,22973,1790,884,906
33700,26118,3138,12608,2150,22980,1790,884,906
33705,26121,3138,12609,2150,22983,1790,884,906
33710,26126,3138,12611,2150,22988,1790,884,906
33715,26130,3138,12613,2150,22992,1790,884,906
33720,26133,3138,12613,2150,22995,1790,884,906
33725,26134,3138,12613,2150,22996,1790,884,906
33730,26139,3139,12614,2150,23000,1791,884,907
33735,26141,3139,12615,2150,23002,1792,884,908
33740,26149,3141,12619,2152,23008,1792,884,908
33745,26152,3141,12620,2152,23011,1792,884,908
33750,26157,3141,12624,2152,23016,1792,884,908
33755,26161,3141,12624,2152,23020,1792,884,908
33760,26164,3141,12625,2152,23023,1792,884,908
33765,26165,3141,12625,2152,23024,1792,884,908
33770,26170,3142,12627,2152,23028,1793,885,908
33775,26172,3142,12627,2152,23030,1794,885,909
33780,26180,3145,12633,2154,23034,1796,886,910
33785,26183,3146,12634,2155,23037,1796,886,910
33790,26188,3147,12638,2156,23041,1796,886,910
33795,26192,3147,12640,2156,23044,1796,886,910
33800,26195,3148,12642,2157,23047,1796,886,910
33805,26196,3148,12643,2157,23048,1796,886,910
33810,26201,3149,12647,2157,23052,1796,886,910
33815,26203,3149,12648,2157,23054,1797,886,911
33820,26211,3150,12652,2158,23061,1797,886,911
33825,26214,3150,12655,2158,23064,1797,886,911
33830,26219,3151,12658,2159,23068,1797,886,911
33835,26223,3151,12660,2159,23072,1797,886,911
33840,26226,3151,12661,2159,23075,1797,886,911
33845,26227,3152,12662,2160,23075,1797,886,911
33850,26232,3153,12664,2160,23079,1797,886,911
33855,26234,3153,12666,2160,23081,1798,887,911
33860,26242,3153,12671,2160,23089,1798,887,911
33865,26245,3153,12672,2160,23092,1798,887,911
33870,26250,3153,12674,2160,23097,1798,887,911
33875,26254,3153,12676,2160,23100,1798,887,911
33880,26257,3154,12678,2161,23103,1798,887,911
33885,26258,3154,12678,2161,23104,1798,887,911
33890,26263,3155,12681,2161,23108,1798,887,911
33895,26265,3155,12683,2161,23110,1799,888,911
33900,26273,3157,12687,2163,23115,1801,889,912
33905,26276,3158,12688,2164,23118,1801,889,912
33910,26281,3158,12691,2164,23123,1801,889,912
33915,26285,3158,12693,2164,23126,1801,889,912
33920,26288,3159,12693,2165,23129,1801,889,912
33925,26289,3159,12694,2165,23130,1801,889,912
33930,26294,3160,12697,2165,23134,1802,890,912
33935,26296,3160,12699,2165,23136,1803,891,912
33940,26304,3162,12703,2167,23142,1803,891,912
33945,26307,3162,12704,2167,23145,1803,891,912
33950,26312,3163,12707,2168,23149,1803,891,912
33955,26316,3163,12709,2168,23153,1803,891,912
33960,26319,3163,12710,2168,23156,1803,891,912
33965,26320,3164,12711,2169,23156,1803,891,912
33970,26325,3165,12712,2169,23160,1804,891,913
33975,26327,3165,12713,2169,23162,1805,892,913
33980,26335,3166,12718,2170,23169,1805,892,913
33985,26338,3166,12720,2170,23172,1805,892,913
33990,26343,3167,12723,2171,23176,1805,892,913
33995,26347,3167,12724,2171,23180,1805,892,913
34000,26350,3167,12726,2171,23183,1805,892,913
34005,26351,3168,12727,2172,23183,1805,892,913
34010,26356,3169,12729,2173,23187,1805,892,913
34015,26358,3169,12730,2173,23189,1806,893,913
34020,26366,3171,12733,2175,23195,1808,893,915
34025,26369,3172,12735,2176,23197,1808,893,915
34030,26374,3173,12736,2176,23201,1808,893,915
34035,26378,3173,12738,2176,23205,1808,893,915
34040,26381,3173,12740,2176,23208,1808,893,915
34045,26382,3173,12740,2176,23209,1808,893,915
34050,26387,3173,12742,2176,23214,1809,893,916
34055,26389,3173,12742,2176,23216,1810,893,917
34060,26397,3174,12746,2176,23223,1810,893,917
34065,26400,3175,12749,2177,23225,1810,893,917
34070,26405,3176,12752,2177,23229,1810,893,917
34075,26409,3176,12755,2177,23233,1810,893,917
34080,26412,3176,12755,2177,23236,1810,893,917
34085,26413,3176,12756,2177,23237,1810,893,917
34090,26418,3176,12758,2177,23242,1810,893,917
34095,26420,3176,12760,2177,23244,1811,894,917
34100,26428,3177,12765,2178,23251,1811,894,917
34105,26431,3177,12767,2178,23254,1811,894,917
34110,26436,3178,12770,2178,23258,1811,894,917
34115,26440,3178,12771,2178,23262,1811,894,917
34120,26443,3178,12771,2178,23265,1811,894,917
34125,26444,3178,12772,2178,23266,1811,894,917
34130,26449,3179,12774,2178,23270,1811,894,917
34135,26451,3179,12775,2178,23272,1812,895,917
34140,26459,3181,12781,2180,23277,1813,895,918
34145,26462,3182,12781,2181,23280,1813,895,918
34150,26467,3183,12782,2182,23284,1813,895,918
34155,26471,3183,12784,2182,23287,1813,895,918
34160,26474,3185,12785,2184,23289,1813,895,918
34165,26475,3186,12786,2185,23289,1813,895,918
34170,26480,3187,12790,2186,23293,1813,895,918
34175,26482,3187,12791,2186,23295,1814,895,919
34180,26490,3188,12795,2186,23302,1814,895,919
34185,26493,3188,12797,2186,23305,1814,895,919
34190,26498,3189,12801,2187,23309,1814,895,919
34195,26502,3189,12802,2187,23313,1814,895,919
34200,26505,3189,12803,2187,23316,1814,895,919
34205,26506,3189,12804,2187,23317,1814,895,919
34210,26511,3190,12806,2188,23321,1815,895,920
34215,26513,3190,12807,2188,23323,1816,896,920
34220,26521,3192,12809,2190,23329,1816,896,920
34225,26524,3192,12811,2190,23332,1816,896,920
34230,26529,3192,12815,2190,23337,1816,896,920
34235,26533,3192,12818,2190,23340,1816,896,920
34240,26536,3193,12819,2191,23343,1816,896,920
34245,26537,3193,12819,2191,23344,1816,896,920
34250,26542,3194,12821,2192,23348,1817,896,921
34255,26544,3194,12823,2192,23350,1818,897,921
34260,26552,3197,12828,2195,23355,1820,898,922
34265,26555,3197,12828,2195,23358,1820,898,922
34270,26560,3197,12830,2195,23363,1820,898,922
34275,26564,3197,12831,2195,23366,1820,898,922
34280,26567,3198,12833,2196,23369,1820,898,922
34285,26568,3198,12834,2196,23370,1820,898,922
34290,26573,3199,12836,2196,23374,1821,899,922
34295,26575,3199,12836,2196,23376,1822,899,923
34300,26583,3199,12839,2196,23384,1822,899,923
34305,26586,3199,12841,2196,23387,1822,899,923
34310,26591,3200,12845,2197,23391,1822,899,923
34315,26595,3200,12846,2197,23395,1822,899,923
34320,26598,3200,12847,2197,23398,1822,899,923
34325,26599,3200,12847,2197,23399,1822,899,923
34330,26604,3201,12850,2198,23403,1822,899,923
34335,26606,3201,12851,2198,23405,1823,900,923
34340,26614,3201,12854,2198,23413,1823,900,923
34345,26617,3201,12856,2198,23416,1823,900,923
34350,26622,3202,12859,2199,23420,1823,900,923
34355,26626,3202,12862,2199,23424,1823,900,923
34360,26629,3202,12864,2199,23427,1823,900,923
34365,26630,3202,12864,2199,23428,1823,900,923
34370,26635,3203,12865,2199,23432,1823,900,923
34375,26637,3203,12866,2199,23434,1824,901,923
34380,26645,3205,12870,2201,23440,1826,901,925
34385,26648,3205,12871,2201,23443,1826,901,925
34390,26653,3206,12875,2202,23447,1826,901,925
34395,26657,3206,12875,2202,23451,1826,901,925
34400,26660,3207,12876,2203,23453,1826,901,925
34405,26661,3207,12877,2203,23454,1826,901,925
34410,26666,3207,12879,2203,23459,1826,901,925
34415,26668,3207,12880,2203,23461,1827,901,926
34420,26676,3207,12885,2203,23469,1827,901,926
34425,26679,3207,12887,2203,23472,1827,901,926
34430,26684,3208,12890,2203,23476,1827,901,926
34435,26688,3208,12891,2203,23480,1827,901,926
34440,26691,3208,12892,2203,23483,1827,901,926
34445,26692,3208,12893,2203,23484,1827,901,926
34450,26697,3208,12895,2203,23489,1828,901,927
34455,26699,3208,12897,2203,23491,1829,902,927
34460,26707,3208,12900,2203,23499,1829,902,927
34465,26710,3208,12901,2203,23502,1829,902,927
34470,26715,3209,12904,2203,23506,1829,902,927
34475,26719,3209,12905,2203,23510,1829,902,927
34480,26722,3210,12907,2204,23512,1829,902,927
34485,26723,3210,12907,2204,23513,1829,902,927
34490,26728,3211,12910,2204,23517,1830,903,927
34495,26730,3211,12911,2204,23519,1831,903,928
34500,26738,3214,12915,2207,23524,1833,904,929
34505,26741,3215,12917,2208,23526,1833,904,929
34510,26746,3216,12919,2208,23530,1833,904,929
34515,26750,3216,12922,2208,23533,1833,904,929
34520,26753,3217,12923,2209,23536,1833,904,929
34525,26754,3217,12923,2209,23537,1833,904,929
34530,26759,3218,12926,2210,23541,1834,904,930
34535,26761,3218,12928,2210,23543,1835,905,930
34540,26769,3220,12934,2212,23549,1836,906,930
34545,26772,3221,12936,2213,23551,1836,906,930
34550,26777,3222,12938,2213,23555,1836,906,930
34555,26781,3222,12941,2213,23558,1836,906,930
34560,26784,3223,12943,2214,23561,1836,906,930
34565,26785,3223,12943,2214,23562,1836,906,930
34570,26790,3224,12944,2214,23566,1836,906,930
34575,26792,3224,12945,2214,23568,1837,907,930
34580,26800,3226,12952,2216,23574,1838,908,930
34585,26803,3227,12954,2217,23576,1838,908,930
34590,26808,3227,12957,2217,23581,1838,908,930
34595,26812,3227,12958,2217,23585,1838,908,930
34600,26815,3227,12960,2217,23588,1838,908,930
34605,26816,3227,12960,2217,23589,1838,908,930
34610,26821,3228,12961,2217,23593,1838,908,930
34615,26823,3228,12962,2217,23595,1839,909,930
34620,26831,3231,12967,2219,23599,1841,911,930
34625,26834,3232,12969,2220,23602,1841,911,930
34630,26839,3232,12973,2220,23607,1841,911,930
34635,26843,3232,12977,2220,23610,1841,911,930
34640,26846,3233,12980,2221,23613,1841,911,930
34645,26847,3233,12981,2221,23614,1841,911,930
34650,26852,3234,12985,2222,23618,1841,911,930
34655,26854,3234,12987,2222,23620,1842,912,930
34660,26862,3234,12991,2222,23628,1842,912,930
34665,26865,3234,12992,2222,23631,1842,912,930
34670,26870,3235,12995,2223,23635,1842,912,930
34675,26874,3235,12996,2223,23639,1842,912,930
34680,26877,3236,12997,2224,23641,1842,912,930
34685,26878,3236,12997,2224,23642,1842,912,930
34690,26883,3237,12999,2224,23646,1843,913,930
34695,26885,3237,12999,2224,23648,1844,913,931
34700,26893,3238,13002,2225,23655,1844,913,931
34705,26896,3238,13002,2225,23658,1844,913,931
34710,26901,3239,13006,2226,23662,1844,913,931
34715,26905,3239,13008,2226,23666,1844,913,931
34720,26908,3239,13010,2226,23669,1844,913,931
34725,26909,3239,13010,2226,23670,1844,913,931
34730,26914,3240,13012,2226,23674,1844,913,931
34735,26916,3240,13012,2226,23676,1845,913,932
34740,26924,3242,13017,2228,23682,1847,914,933
34745,26927,3242,13018,2228,23685,1847,914,933
34750,26932,3243,13021,2229,23689,1847,914,933
34755,26936,3243,13023,2229,23693,1847,914,933
34760,26939,3244,13025,2230,23695,1847,914,933
34765,26940,3244,13025,2230,23696,1847,914,933
34770,26945,3245,13026,2230,23700,1847,914,933
34775,26947,3245,13028,2230,23702,1848,915,933
34780,26955,3246,13034,2231,23709,1849,915,934
34785,26958,3247,13036,2232,23711,1849,915,934
34790,26963,3248,13037,2232,23715,1849,915,934
34795,26967,3248,13039,2232,23719,1849,915,934
34800,26970,3249,13041,2233,23721,1849,915,934
34805,26971,3249,13041,2233,23722,1849,915,934
34810,26976,3250,13044,2234,23726,1850,915,935
34815,26978,3250,13045,2234,23728,1851,915,936
34820,26986,3252,13049,2236,23734,1851,915,936
34825,26989,3252,13051,2236,23737,1851,915,936
34830,26994,3252,13052,2236,23742,1851,915,936
34835,26998,3252,13054,2236,23746,1851,915,936
34840,27001,3252,13057,2236,23749,1851,915,936
34845,27002,3252,13058,2236,23750,1851,915,936
34850,27007,3253,13060,2236,23754,1851,915,936
34855,27009,3253,13061,2236,23756,1852,915,937
34860,27017,3255,13065,2238,23762,1853,916,937
34865,27020,3255,13067,2238,23765,1853,916,937
34870,27025,3255,13069,2238,23770,1853,916,937
34875,27029,3255,13070,2238,23774,1853,916,937
34880,27032,3255,13072,2238,23777,1853,916,937
34885,27033,3256,13073,2239,23777,1853,916,937
34890,27038,3257,13077,2240,23781,1853,916,937
34895,27040,3257,13078,2240,23783,1854,916,938
34900,27048,3257,13084,2240,23791,1854,916,938
34905,27051,3257,13085,2240,23794,1854,916,938
34910,27056,3257,13089,2240,23799,1854,916,938
34915,27060,3257,13092,2240,23803,1854,916,938
34920,27063,3257,13093,2240,23806,1854,916,938
34925,27064,3257,13094,2240,23807,1854,916,938
34930,27069,3258,13096,2241,23811,1855,917,938
34935,27071,3258,13098,2241,23813,1856,918,938
34940,27079,3260,13103,2243,23819,1856,918,938
34945,27082,3260,13104,2243,23822,1856,918,938
34950,27087,3260,13106,2243,23827,1856,918,938
34955,27091,3260,13108,2243,23830,1856,918,938
34960,27094,3261,13109,2244,23833,1856,918,938
34965,27095,3261,13110,2244,23834,1856,918,938
34970,27100,3262,13113,2245,23838,1857,918,939
34975,27102,3262,13115,2245,23840,1858,919,939
34980,27110,3264,13120,2246,23846,1859,920,939
34985,27113,3264,13123,2246,23849,1859,920,939
34990,27118,3265,13124,2246,23853,1859,920,939
34995,27122,3265,13127,2246,23856,1859,920,939
35000,27125,3266,13129,2247,23859,1859,920,939
35005,27126,3266,13129,2247,23860,1859,920,939
35010,27131,3267,13132,2248,23864,1860,921,939
35015,27133,3267,13133,2248,23866,1861,922,939
35020,27141,3267,13138,2248,23874,1861,922,939
35025,27144,3267,13138,2248,23877,1861,922,939
35030,27149,3268,13140,2249,23881,1861,922,939
35035,27153,3268,13143,2249,23884,1861,922,939
35040,27156,3270,13144,2251,23886,1861,922,939
35045,27157,3271,13145,2252,23886,1861,922,939
35050,27162,3272,13147,2252,23890,1861,922,939
35055,27164,3272,13149,2252,23892,1862,923,939
35060,27172,3274,13154,2254,23898,1863,923,940
35065,27175,3275,13157,2255,23900,1863,923,940
35070,27180,3275,13158,2255,23905,1863,923,940
35075,27184,3275,13158,2255,23909,1863,923,940
35080,27187,3275,13159,2255,23912,1863,923,940
35085,27188,3275,13159,2255,23913,1863,923,940
35090,27193,3276,13161,2255,23917,1863,923,940
35095,27195,3276,13162,2255,23919,1864,923,941
35100,27203,3277,13163,2255,23926,1866,924,942
35105,27206,3277,13166,2255,23929,1866,924,942
35110,27211,3277,13169,2255,23934,1866,924,942
35115,27215,3277,13171,2255,23938,1866,924,942
35120,27218,3277,13172,2255,23941,1866,924,942
35125,27219,3277,13172,2255,23942,1866,924,942
35130,27224,3277,13174,2255,23947,1866,924,942
35135,27226,3277,13175,2255,23949,1867,925,942
35140,27234,3277,13182,2255,23957,1868,926,942
35145,27237,3277,13183,2255,23960,1868,926,942
35150,27242,3278,13186,2256,23964,1868,926,942
35155,27246,3278,13188,2256,23968,1868,926,942
35160,27249,3278,13189,2256,23971,1868,926,942
35165,27250,3278,13189,2256,23972,1868,926,942
35170,27255,3278,13193,2256,23977,1869,927,942
35175,27257,3278,13194,2256,23979,1870,928,942
35180,27265,3278,13199,2256,23987,1870,928,942
35185,27268,3278,13201,2256,23990,1870,928,942
35190,27273,3279,13202,2256,23994,1870,928,942
35195,27277,3279,13206,2256,23997,1870,928,942
35200,27280,3280,13208,2257,24000,1870,928,942
35205,27281,3280,13209,2257,24001,1870,928,942
35210,27286,3281,13213,2258,24005,1871,929,942
35215,27288,3281,13213,2258,24007,1872,929,943
35220,27296,3282,13215,2258,24014,1873,930,943
35225,27299,3283,13217,2259,24016,1873,930,943
35230,27304,3285,13220,2261,24019,1873,930,943
35235,27308,3285,13221,2261,24023,1873,930,943
35240,27311,3286,13223,2262,24025,1873,930,943
35245,27312,3287,13224,2263,24025,1873,930,943
35250,27317,3288,13226,2263,24029,1874,930,944
35255,27319,3288,13228,2263,24031,1875,931,944
35260,27327,3289,13229,2264,24038,1876,931,945
35265,27330,3290,13230,2265,24040,1876,931,945
35270,27335,3291,13231,2265,24044,1876,931,945
35275,27339,3291,13234,2265,24048,1876,931,945
35280,27342,3292,13236,2266,24050,1876,931,945
35285,27343,3292,13236,2266,24051,1876,931,945
35290,27348,3293,13237,2266,24055,1877,931,946
35295,27350,3293,13238,2266,24057,1878,932,946
35300,27358,3294,13242,2267,24064,1878,932,946
35305,27361,3294,13244,2267,24067,1878,932,946
35310,27366,3295,13247,2267,24071,1878,932,946
35315,27370,3295,13249,2267,24075,1878,932,946
35320,27373,3295,13250,2267,24078,1878,932,946
35325,27374,3295,13250,2267,24079,1878,932,946
35330,27379,3296,13255,2268,24083,1878,932,946
35335,27381,3296,13256,2268,24085,1879,932,947
35340,27389,3297,13258,2269,24092,1880,932,948
35345,27392,3297,13259,2269,24095,1880,932,948
35350,27397,3297,13262,2269,24100,1880,932,948
35355,27401,3297,13263,2269,24104,1880,932,948
35360,27404,3297,13265,2269,24107,1880,932,948
35365,27405,3297,13265,2269,24108,1880,932,948
35370,27410,3298,13268,2269,24112,1880,932,948
35375,27412,3298,13268,2269,24114,1881,932,949
35380,27420,3299,13269,2270,24121,1881,932,949
35385,27423,3299,13270,2270,24124,1881,932,949
35390,27428,3299,13272,2270,24129,1881,932,949
35395,27432,3299,13275,2270,24133,1881,932,949
35400,27435,3299,13275,2270,24136,1881,932,949
35405,27436,3299,13276,2270,24137,1881,932,949
35410,27441,3300,13279,2271,24141,1882,932,950
35415,27443,3300,13280,2271,24143,1883,932,951
35420,27451,3301,13283,2271,24150,1884,932,952
35425,27454,3301,13284,2271,24153,1884,932,952
35430,27459,3301,13286,2271,24158,1884,932,952
35435,27463,3301,13286,2271,24162,1884,932,952
35440,27466,3301,13287,2271,24165,1884,932,952
35445,27467,3302,13288,2272,24165,1884,932,952
35450,27472,3303,13290,2272,24169,1885,933,952
35455,27474,3303,13291,2272,24171,1886,933,953
35460,27482,3305,13294,2273,24177,1888,934,954
35465,27485,3305,13295,2273,24180,1888,934,954
35470,27490,3306,13298,2273,24184,1888,934,954
35475,27494,3306,13300,2273,24188,1888,934,954
35480,27497,3306,13301,2273,24191,1888,934,954
35485,27498,3307,13302,2274,24191,1888,934,954
35490,27503,3308,13304,2275,24195,1888,934,954
35495,27505,3308,13305,2275,24197,1889,935,954
35500,27513,3308,13310,2275,24205,1889,935,954
35505,27516,3308,13312,2275,24208,1889,935,954
35510,27521,3309,13314,2275,24212,1889,935,954
35515,27525,3309,13316,2275,24216,1889,935,954
35520,27528,3309,13316,2275,24219,1889,935,954
35525,27529,3310,13317,2276,24219,1889,935,954
35530,27534,3311,13318,2276,24223,1889,935,954
35535,27536,3311,13318,2276,24225,1890,935,955
35540,27544,3311,13322,2276,24233,1890,935,955
35545,27547,3311,13323,2276,24236,1890,935,955
35550,27552,3312,13326,2277,24240,1890,935,955
35555,27556,3312,13328,2277,24244,1890,935,955
35560,27559,3312,13329,2277,24247,1890,935,955
35565,27560,3312,13329,2277,24248,1890,935,955
35570,27565,3313,13333,2278,24252,1891,936,955
35575,27567,3313,13333,2278,24254,1892,936,956
35580,27575,3314,13334,2278,24261,1894,936,958
35585,27578,3314,13334,2278,24264,1894,936,958
35590,27583,3315,13336,2278,24268,1894,936,958
35595,27587,3315,13340,2278,24271,1894,936,958
35600,27590,3316,13340,2279,24274,1894,936,958
35605,27591,3316,13341,2279,24275,1894,936,958
35610,27596,3317,13343,2279,24279,1894,936,958
35615,27598,3317,13344,2279,24281,1895,937,958
35620,27606,3318,13347,2280,24288,1896,938,958
35625,27609,3318,13347,2280,24291,1896,938,958
35630,27614,3319,13348,2280,24295,1896,938,958
35635,27618,3319,13350,2280,24299,1896,938,958
35640,27621,3320,13352,2281,24301,1896,938,958
35645,27622,3320,13353,2281,24302,1896,938,958
35650,27627,3321,13354,2281,24306,1896,938,958
35655,27629,3321,13354,2281,24308,1897,938,959
35660,27637,3322,13355,2282,24315,1898,938,960
35665,27640,3322,13356,2282,24318,1898,938,960
35670,27645,3323,13358,2282,24322,1898,938,960
35675,27649,3323,13361,2282,24326,1898,938,960
35680,27652,3324,13363,2283,24328,1898,938,960
35685,27653,3324,13363,2283,24329,1898,938,960
35690,27658,3325,13365,2283,24333,1899,939,960
35695,27660,3325,13366,2283,24335,1900,940,960
35700,27668,3328,13370,2286,24340,1902,940,962
35705,27671,3328,13373,2286,24343,1902,940,962
35710,27676,3328,13375,2286,24348,1902,940,962
35715,27680,3328,13376,2286,24352,1902,940,962
35720,27683,3328,13379,2286,24355,1902,940,962
35725,27684,3329,13380,2287,24355,1902,940,962
35730,27689,3330,13384,2288,24359,1902,940,962
35735,27691,3330,13384,2288,24361,1903,940,963
35740,27699,3330,13387,2288,24369,1903,940,963
35745,27702,3330,13388,2288,24372,1903,940,963
35750,27707,3330,13390,2288,24377,1903,940,963
35755,27711,3330,13391,2288,24381,1903,940,963
35760,27714,3330,13392,2288,24384,1903,940,963
35765,27715,3331,13393,2289,24384,1903,940,963
35770,27720,3332,13394,2290,24388,1903,940,963
35775,27722,3332,13395,2290,24390,1904,940,964
35780,27730,3332,13396,2290,24398,1904,940,964
35785,27733,3332,13398,2290,24401,1904,940,964
35790,27738,3332,13399,2290,24406,1904,940,964
35795,27742,3332,13401,2290,24410,1904,940,964
35800,27745,3332,13402,2290,24413,1904,940,964
35805,27746,3333,13403,2291,24413,1904,940,964
35810,27751,3334,13406,2291,24417,1904,940,964
35815,27753,3334,13406,2291,24419,1905,940,965
35820,27761,3335,13408,2291,24426,1907,941,966
35825,27764,3335,13410,2291,24429,1907,941,966
35830,27769,3336,13415,2292,24433,1907,941,966
35835,27773,3336,13419,2292,24436,1907,941,966
35840,27776,3337,13421,2293,24439,1907,941,966
35845,27777,3337,13422,2293,24440,1907,941,966
35850,27782,3338,13425,2294,24444,1907,941,966
35855,27784,3338,13426,2294,24446,1908,942,966
35860,27792,3339,13427,2295,24453,1909,942,967
35865,27795,3339,13429,2295,24456,1909,942,967
35870,27800,3340,13430,2295,24460,1909,942,967
35875,27804,3340,13430,2295,24464,1909,942,967
35880,27807,3340,13432,2295,24467,1909,942,967
35885,27808,3340,13432,2295,24468,1909,942,967
35890,27813,3341,13434,2295,24472,1910,942,968
35895,27815,3341,13436,2295,24474,1911,943,968
35900,27823,3343,13439,2296,24480,1912,943,969
35905,27826,3343,13440,2296,24483,1912,943,969
35910,27831,3344,13442,2296,24487,1912,943,969
35915,27835,3344,13445,2296,24490,1912,943,969
35920,27838,3346,13447,2298,24492,1912,943,969
35925,27839,3346,13448,2298,24493,1912,943,969
35930,27844,3347,13450,2299,24497,1913,943,970
35935,27846,3347,13450,2299,24499,1914,943,971
35940,27854,3349,13454,2301,24504,1916,944,972
35945,27857,3350,13455,2302,24507,1916,944,972
35950,27862,3350,13457,2302,24512,1916,944,972
35955,27866,3350,13459,2302,24516,1916,944,972
35960,27869,3350,13461,2302,24519,1916,944,972
35965,27870,3350,13461,2302,24520,1916,944,972
35970,27875,3350,13462,2302,24525,1916,944,972
35975,27877,3350,13464,2302,24527,1917,945,972
35980,27885,3350,13469,2302,24535,1917,945,972
35985,27888,3350,13471,2302,24538,1917,945,972
35990,27893,3350,13474,2302,24543,1917,945,972
35995,27897,3350,13478,2302,24547,1917,945,972
36000,27900,3350,13479,2302,24550,1917,945,972
36005,27901,3351,13480,2303,24550,1917,945,972
36010,27906,3352,13481,2303,24554,1917,945,972
36015,27908,3352,13483,2303,24556,1918,946,972
36020,27916,3352,13488,2303,24564,1918,946,972
36025,27919,3352,13489,2303,24567,1918,946,972
36030,27924,3352,13490,2303,24572,1918,946,972
36035,27928,3352,13494,2303,24575,1918,946,972
36040,27931,3353,13494,2304,24578,1918,946,972
36045,27932,3354,13495,2305,24578,1918,946,972
36050,27937,3355,13499,2306,24582,1918,946,972
36055,27939,3355,13500,2306,24584,1919,946,973
36060,27947,3358,13503,2308,24588,1921,946,975
36065,27950,3359,13505,2309,24591,1921,946,975
36070,27955,3360,13508,2310,24595,1921,946,975
36075,27959,3360,13509,2310,24599,1921,946,975
36080,27962,3361,13511,2311,24601,1921,946,975
36085,27963,3361,13512,2311,24602,1921,946,975
36090,27968,3361,13514,2311,24607,1922,946,976
36095,27970,3361,13515,2311,24609,1923,946,977
36100,27978,3361,13520,2311,24617,1924,947,977
36105,27981,3361,13521,2311,24620,1924,947,977
36110,27986,3362,13522,2311,24624,1924,947,977
36115,27990,3362,13524,2311,24628,1924,947,977
36120,27993,3362,13525,2311,24631,1924,947,977
36125,27994,3362,13525,2311,24632,1924,947,977
36130,27999,3362,13526,2311,24637,1924,947,977
36135,28001,3362,13527,2311,24639,1925,948,977
36140,28009,3363,13531,2312,24646,1925,948,977
36145,28012,3363,13532,2312,24649,1925,948,977
36150,28017,3364,13536,2313,24653,1925,948,977
36155,28021,3364,13537,2313,24657,1925,948,977
36160,28024,3364,13538,2313,24660,1925,948,977
36165,28025,3364,13539,2313,24661,1925,948,977
36170,28030,3365,13541,2313,24665,1925,948,977
36175,28032,3365,13542,2313,24667,1926,949,977
36180,28040,3367,13545,2314,24672,1927,949,978
36185,28043,3369,13548,2316,24674,1927,949,978
36190,28048,3371,13551,2318,24677,1927,949,978
36195,28052,3371,13554,2318,24680,1927,949,978
36200,28055,3373,13556,2320,24682,1927,949,978
36205,28056,3373,13556,2320,24683,1927,949,978
36210,28061,3374,13558,2321,24687,1927,949,978
36215,28063,3374,13559,2321,24689,1928,950,978
36220,28071,3375,13561,2321,24696,1929,950,979
36225,28074,3375,13562,2321,24699,1929,950,979
36230,28079,3376,13564,2321,24703,1929,950,979
36235,28083,3376,13564,2321,24707,1929,950,979
36240,28086,3377,13565,2322,24709,1929,950,979
36245,28087,3377,13566,2322,24710,1929,950,979
36250,28092,3378,13569,2323,24714,1930,950,980
36255,28094,3378,13570,2323,24716,1931,951,980
36260,28102,3379,13574,2323,24723,1931,951,980
36265,28105,3379,13576,2323,24726,1931,951,980
36270,28110,3379,13577,2323,24731,1931,951,980
36275,28114,3379,13578,2323,24735,1931,951,980
36280,28117,3379,13578,2323,24738,1931,951,980
36285,28118,3379,13579,2323,24739,1931,951,980
36290,28123,3380,13580,2323,24743,1932,951,981
36295,28125,3380,13580,2323,24745,1933,951,982
36300,28133,3382,13584,2324,24751,1934,952,982
36305,28136,3382,13586,2324,24754,1934,952,982
36310,28141,3382,13588,2324,24759,1934,952,982
36315,28145,3382,13589,2324,24763,1934,952,982
36320,28148,3382,13591,2324,24766,1934,952,982
36325,28149,3382,13592,2324,24767,1934,952,982
36330,28154,3383,13594,2324,24771,1935,953,982
36335,28156,3383,13595,2324,24773,1936,954,982
36340,28164,3385,13599,2325,24779,1936,954,982
36345,28167,3385,13599,2325,24782,1936,954,982
36350,28172,3385,13602,2325,24787,1936,954,982
36355,28176,3385,13603,2325,24791,1936,954,982
36360,28179,3385,13604,2325,24794,1936,954,982
36365,28180,3385,13604,2325,24795,1936,954,982
36370,28185,3386,13607,2325,24799,1936,954,982
36375,28187,3386,13609,2325,24801,1937,955,982
36380,28195,3388,13617,2327,24807,1937,955,982
36385,28198,3388,13619,2327,24810,1937,955,982
36390,28203,3388,13621,2327,24815,1937,955,982
36395,28207,3388,13623,2327,24819,1937,955,982
36400,28210,3388,13624,2327,24822,1937,955,982
36405,28211,3388,13624,2327,24823,1937,955,982
36410,28216,3389,13626,2327,24827,1937,955,982
36415,28218,3389,13626,2327,24829,1938,955,983
36420,28226,3390,13628,2327,24835,1939,955,984
36425,28229,3391,13629,2328,24838,1939,955,984
36430,28234,3392,13633,2329,24842,1939,955,984
36435,28238,3392,13635,2329,24845,1939,955,984
36440,28241,3394,13637,2331,24847,1939,955,984
36445,28242,3394,13638,2331,24848,1939,955,984
36450,28247,3395,13642,2331,24852,1940,956,984
36455,28249,3395,13643,2331,24854,1941,956,985
36460,28257,3397,13645,2332,24860,1941,956,985
36465,28260,3397,13645,2332,24863,1941,956,985
36470,28265,3398,13647,2333,24867,1941,956,985
36475,28269,3398,13648,2333,24870,1941,956,985
36480,28272,3399,13649,2334,24873,1941,956,985
36485,28273,3399,13650,2334,24874,1941,956,985
36490,28278,3400,13654,2335,24878,1942,957,985
36495,28280,3400,13654,2335,24880,1943,957,986
36500,28288,3402,13660,2337,24886,1943,957,986
36505,28291,3402,13661,2337,24889,1943,957,986
36510,28296,3402,13665,2337,24894,1943,957,986
36515,28300,3402,13667,2337,24898,1943,957,986
36520,28303,3402,13669,2337,24901,1943,957,986
36525,28304,3402,13669,2337,24902,1943,957,986
36530,28309,3403,13671,2338,24906,1944,957,987
36535,28311,3403,13672,2338,24908,1945,958,987
36540,28319,3405,13674,2340,24914,1946,958,988
36545,28322,3405,13676,2340,24917,1946,958,988
36550,28327,3405,13677,2340,24922,1946,958,988
36555,28331,3405,13677,2340,24926,1946,958,988
36560,28334,3405,13679,2340,24929,1946,958,988
36565,28335,3405,13679,2340,24930,1946,958,988
36570,28340,3405,13679,2340,24935,1946,958,988
36575,28342,3405,13679,2340,24937,1947,958,989
36580,28350,3407,13683,2342,24943,1947,958,989
36585,28353,3407,13684,2342,24946,1947,958,989
36590,28358,3408,13687,2342,24950,1947,958,989
36595,28362,3408,13688,2342,24954,1947,958,989
36600,28365,3408,13688,2342,24957,1947,958,989
36605,28366,3408,13688,2342,24958,1947,958,989
36610,28371,3408,13690,2342,24963,1947,958,989
36615,28373,3408,13692,2342,24965,1948,959,989
36620,28381,3410,13696,2344,24971,1948,959,989
36625,28384,3410,13697,2344,24974,1948,959,989
36630,28389,3411,13700,2344,24978,1948,959,989
36635,28393,3411,13700,2344,24982,1948,959,989
36640,28396,3411,13700,2344,24985,1948,959,989
36645,28397,3411,13700,2344,24986,1948,959,989
36650,28402,3412,13703,2345,24990,1948,959,989
36655,28404,3412,13705,2345,24992,1949,960,989
36660,28412,3414,13708,2346,24998,1950,960,990
36665,28415,3414,13710,2346,25001,1950,960,990
36670,28420,3415,13711,2346,25005,1950,960,990
36675,28424,3415,13712,2346,25009,1950,960,990
36680,28427,3416,13715,2347,25011,1950,960,990
36685,28428,3416,13715,2347,25012,1950,960,990
36690,28433,3417,13717,2348,25016,1951,961,990
36695,28435,3417,13719,2348,25018,1952,962,990
36700,28443,3418,13723,2348,25025,1952,962,990
36705,28446,3418,13725,2348,25028,1952,962,990
36710,28451,3419,13726,2348,25032,1952,962,990
36715,28455,3419,13729,2348,25036,1952,962,990
36720,28458,3420,13731,2349,25038,1952,962,990
36725,28459,3421,13732,2350,25038,1952,962,990
36730,28464,3422,13734,2351,25042,1952,962,990
36735,28466,3422,13735,2351,25044,1953,963,990
36740,28474,3423,13740,2352,25051,1953,963,990
36745,28477,3423,13741,2352,25054,1953,963,990
36750,28482,3424,13743,2352,25058,1953,963,990
36755,28486,3424,13744,2352,25062,1953,963,990
36760,28489,3425,13745,2353,25064,1953,963,990
36765,28490,3426,13746,2354,25064,1953,963,990
36770,28495,3427,13749,2355,25068,1953,963,990
36775,28497,3427,13751,2355,25070,1954,964,990
36780,28505,3429,13754,2356,25076,1955,964,991
36785,28508,3429,13756,2356,25079,1955,964,991
36790,28513,3429,13759,2356,25084,1955,964,991
36795,28517,3429,13762,2356,25087,1955,964,991
36800,28520,3430,13764,2357,25090,1955,964,991
36805,28521,3430,13765,2357,25091,1955,964,991
36810,28526,3431,13767,2357,25095,1955,964,991
36815,28528,3431,13769,2357,25097,1956,965,991
36820,28536,3433,13773,2359,25103,1956,965,991
36825,28539,3433,13775,2359,25106,1956,965,991
36830,28544,3433,13778,2359,25111,1956,965,991
36835,28548,3433,13779,2359,25115,1956,965,991
36840,28551,3433,13780,2359,25118,1956,965,991
36845,28552,3433,13780,2359,25119,1956,965,991
36850,28557,3434,13783,2359,25123,1956,965,991
36855,28559,3434,13784,2359,25125,1957,965,992
36860,28567,3436,13787,2360,25131,1957,965,992
36865,28570,3436,13787,2360,25134,1957,965,992
36870,28575,3436,13789,2360,25139,1957,965,992
36875,28579,3436,13790,2360,25143,1957,965,992
36880,28582,3436,13792,2360,25146,1957,965,992
36885,28583,3436,13792,2360,25147,1957,965,992
36890,28588,3437,13794,2360,25151,1957,965,992
36895,28590,3437,13795,2360,25153,1958,965,993
36900,28598,3438,13798,2361,25160,1959,965,994
36905,28601,3438,13800,2361,25163,1959,965,994
36910,28606,3439,13804,2362,25167,1959,965,994
36915,28610,3439,13806,2362,25171,1959,965,994
36920,28613,3439,13808,2362,25174,1959,965,994
36925,28614,3439,13809,2362,25175,1959,965,994
36930,28619,3439,13812,2362,25180,1959,965,994
36935,28621,3439,13814,2362,25182,1960,966,994
36940,28629,3439,13816,2362,25190,1960,966,994
36945,28632,3439,13817,2362,25193,1960,966,994
36950,28637,3440,13819,2363,25197,1960,966,994
36955,28641,3440,13820,2363,25201,1960,966,994
36960,28644,3440,13820,2363,25204,1960,966,994
36965,28645,3440,13820,2363,25205,1960,966,994
36970,28650,3440,13823,2363,25210,1960,966,994
36975,28652,3440,13823,2363,25212,1961,966,995
36980,28660,3441,13825,2364,25219,1962,966,996
36985,28663,3442,13827,2365,25221,1962,966,996
36990,28668,3442,13829,2365,25226,1962,966,996
36995,28672,3442,13831,2365,25230,1962,966,996
37000,28675,3442,13831,2365,25233,1962,966,996
37005,28676,3442,13831,2365,25234,1962,966,996
37010,28681,3443,13836,2366,25238,1962,966,996
37015,28683,3443,13836,2366,25240,1963,966,997
37020,28691,3445,13840,2368,25246,1965,967,998
37025,28694,3445,13841,2368,25249,1965,967,998
37030,28699,3445,13845,2368,25254,1965,967,998
37035,28703,3445,13846,2368,25258,1965,967,998
37040,28706,3445,13847,2368,25261,1965,967,998
37045,28707,3445,13848,2368,25262,1965,967,998
37050,28712,3446,13852,2369,25266,1965,967,998
37055,28714,3446,13853,2369,25268,1966,968,998
37060,28722,3446,13857,2369,25276,1966,968,998
37065,28725,3446,13860,2369,25279,1966,968,998
37070,28730,3447,13863,2369,25283,1966,968,998
37075,28734,3447,13865,2369,25287,1966,968,998
37080,28737,3448,13868,2370,25289,1966,968,998
37085,28738,3448,13868,2370,25290,1966,968,998
37090,28743,3449,13870,2371,25294,1966,968,998
37095,28745,3449,13871,2371,25296,1967,969,998
37100,28753,3451,13874,2373,25302,1968,969,999
37105,28756,3451,13877,2373,25305,1968,969,999
37110,28761,3452,13879,2374,25309,1968,969,999
37115,28765,3452,13881,2374,25313,1968,969,999
37120,28768,3452,13883,2374,25316,1968,969,999
37125,28769,3452,13883,2374,25317,1968,969,999
37130,28774,3453,13885,2375,25321,1968,969,999
37135,28776,3453,13887,2375,25323,1969,970,999
37140,28784,3454,13890,2375,25330,1970,971,999
37145,28787,3454,13892,2375,25333,1970,971,999
37150,28792,3455,13896,2376,25337,1970,971,999
37155,28796,3455,13898,2376,25341,1970,971,999
37160,28799,3456,13900,2377,25343,1970,971,999
37165,28800,3457,13901,2378,25343,1970,971,999
37170,28805,3458,13902,2378,25347,1970,971,999
37175,28807,3458,13902,2378,25349,1971,971,1000
37180,28815,3459,13906,2378,25356,1971,971,1000
37185,28818,3459,13907,2378,25359,1971,971,1000
37190,28823,3460,13909,2379,25363,1971,971,1000
37195,28827,3460,13912,2379,25367,1971,971,1000
37200,28830,3460,13913,2379,25370,1971,971,1000
37205,28831,3460,13914,2379,25371,1971,971,1000
37210,28836,3461,13915,2380,25375,1972,971,1001
37215,28838,3461,13915,2380,25377,1973,971,1002
37220,28846,3462,13918,2380,25384,1974,972,1002
37225,28849,3462,13920,2380,25387,1974,972,1002
37230,28854,3463,13922,2380,25391,1974,972,1002
37235,28858,3463,13922,2380,25395,1974,972,1002
37240,28861,3464,13924,2381,25397,1974,972,1002
37245,28862,3464,13925,2381,25398,1974,972,1002
37250,28867,3465,13928,2382,25402,1974,972,1002
37255,28869,3465,13929,2382,25404,1975,973,1002
37260,28877,3467,13935,2384,25410,1976,974,1002
37265,28880,3467,13935,2384,25413,1976,974,1002
37270,28885,3467,13937,2384,25418,1976,974,1002
37275,28889,3467,13938,2384,25421,1976,974,1002
37280,28892,3468,13939,2385,25424,1976,974,1002
37285,28893,3468,13939,2385,25425,1976,974,1002
37290,28898,3469,13940,2385,25429,1976,974,1002
37295,28900,3469,13941,2385,25431,1977,975,1002
37300,28908,3470,13945,2385,25438,1977,975,1002
37305,28911,3470,13947,2385,25441,1977,975,1002
37310,28916,3470,13948,2385,25446,1977,975,1002
37315,28920,3470,13950,2385,25450,1977,975,1002
37320,28923,3470,13951,2385,25453,1977,975,1002
37325,28924,3471,13952,2386,25453,1977,975,1002
37330,28929,3472,13954,2386,25457,1977,975,1002
37335,28931,3472,13955,2386,25459,1978,976,1002
37340,28939,3474,13960,2388,25465,1978,976,1002
37345,28942,3474,13961,2388,25468,1978,976,1002
37350,28947,3474,13963,2388,25473,1978,976,1002
37355,28951,3474,13966,2388,25477,1978,976,1002
37360,28954,3474,13969,2388,25480,1978,976,1002
37365,28955,3474,13969,2388,25481,1978,976,1002
37370,28960,3475,13972,2388,25485,1978,976,1002
37375,28962,3475,13972,2388,25487,1979,976,1003
37380,28970,3477,13976,2390,25493,1980,977,1003
37385,28973,3477,13977,2390,25496,1980,977,1003
37390,28978,3478,13977,2390,25500,1980,977,1003
37395,28982,3478,13979,2390,25504,1980,977,1003
37400,28985,3478,13979,2390,25507,1980,977,1003
37405,28986,3479,13980,2391,25507,1980,977,1003
37410,28991,3480,13984,2391,25511,1980,977,1003
37415,28993,3480,13985,2391,25513,1981,977,1004
37420,29001,3481,13986,2391,25520,1981,977,1004
37425,29004,3481,13986,2391,25523,1981,977,1004
37430,29009,3482,13989,2391,25527,1981,977,1004
37435,29013,3482,13990,2391,25530,1981,977,1004
37440,29016,3483,13990,2392,25533,1981,977,1004
37445,29017,3483,13990,2392,25534,1981,977,1004
37450,29022,3484,13992,2392,25538,1981,977,1004
37455,29024,3484,13993,2392,25540,1982,978,1004
37460,29032,3484,13995,2392,25548,1982,978,1004
37465,29035,3484,13995,2392,25551,1982,978,1004
37470,29040,3485,13996,2392,25555,1982,978,1004
37475,29044,3485,13997,2392,25559,1982,978,1004
37480,29047,3485,13998,2392,25562,1982,978,1004
37485,29048,3485,13999,2392,25563,1982,978,1004
37490,29053,3486,14004,2393,25567,1982,978,1004
37495,29055,3486,14005,2393,25569,1983,978,1005
37500,29063,3487,14010,2394,25576,1984,979,1005
37505,29066,3487,14012,2394,25579,1984,979,1005
37510,29071,3488,14014,2394,25583,1984,979,1005
37515,29075,3488,14016,2394,25586,1984,979,1005
37520,29078,3489,14017,2395,25589,1984,979,1005
37525,29079,3489,14017,2395,25590,1984,979,1005
37530,29084,3490,14020,2396,25594,1984,979,1005
37535,29086,3490,14022,2396,25596,1985,980,1005
37540,29094,3491,14024,2396,25603,1985,980,1005
37545,29097,3491,14024,2396,25606,1985,980,1005
37550,29102,3492,14027,2396,25610,1985,980,1005
37555,29106,3492,14029,2396,25614,1985,980,1005
37560,29109,3492,14031,2396,25617,1985,980,1005
37565,29110,3493,14032,2397,25617,1985,980,1005
37570,29115,3494,14036,2397,25621,1985,980,1005
37575,29117,3494,14037,2397,25623,1986,981,1005
37580,29125,3495,14041,2398,25630,1986,981,1005
37585,29128,3495,14043,2398,25633,1986,981,1005
37590,29133,3495,14047,2398,25638,1986,981,1005
37595,29137,3495,14048,2398,25642,1986,981,1005
37600,29140,3495,14049,2398,25645,1986,981,1005
37605,29141,3495,14049,2398,25646,1986,981,1005
37610,29146,3496,14051,2398,25650,1986,981,1005
37615,29148,3496,14052,2398,25652,1987,982,1005
37620,29156,3497,14054,2399,25659,1988,982,1006
37625,29159,3498,14057,2400,25661,1988,982,1006
37630,29164,3498,14060,2400,25666,1988,982,1006
37635,29168,3498,14062,2400,25670,1988,982,1006
37640,29171,3498,14063,2400,25673,1988,982,1006
37645,29172,3499,14064,2401,25673,1988,982,1006
37650,29177,3500,14067,2402,25677,1988,982,1006
37655,29179,3500,14069,2402,25679,1989,983,1006
37660,29187,3501,14072,2402,25686,1989,983,1006
37665,29190,3501,14072,2402,25689,1989,983,1006
37670,29195,3502,14075,2403,25693,1989,983,1006
37675,29199,3502,14078,2403,25696,1989,983,1006
37680,29202,3504,14080,2405,25698,1989,983,1006
37685,29203,3504,14080,2405,25699,1989,983,1006
37690,29208,3505,14082,2405,25703,1989,983,1006
37695,29210,3505,14084,2405,25705,1990,984,1006
37700,29218,3506,14091,2406,25712,1990,984,1006
37705,29221,3506,14092,2406,25715,1990,984,1006
37710,29226,3507,14096,2406,25719,1990,984,1006
37715,29230,3507,14099,2406,25723,1990,984,1006
37720,29233,3507,14100,2406,25726,1990,984,1006
37725,29234,3507,14101,2406,25727,1990,984,1006
37730,29239,3508,14103,2407,25731,1990,984,1006
37735,29241,3508,14105,2407,25733,1991,985,1006
37740,29249,3509,14108,2408,25740,1992,985,1007
37745,29252,3509,14111,2408,25743,1992,985,1007
37750,29257,3510,14113,2408,25747,1992,985,1007
37755,29261,3510,14115,2408,25751,1992,985,1007
37760,29264,3510,14116,2408,25754,1992,985,1007
37765,29265,3510,14117,2408,25755,1992,985,1007
37770,29270,3511,14119,2408,25759,1992,985,1007
37775,29272,3511,14121,2408,25761,1993,986,1007
37780,29280,3512,14125,2409,25768,1993,986,1007
37785,29283,3512,14127,2409,25771,1993,986,1007
37790,29288,3513,14130,2410,25775,1993,986,1007
37795,29292,3513,14131,2410,25779,1993,986,1007
37800,29295,3513,14132,2410,25782,1993,986,1007
37805,29296,3514,14133,2411,25782,1993,986,1007
37810,29301,3515,14136,2411,25786,1994,987,1007
37815,29303,3515,14136,2411,25788,1995,987,1008
37820,29311,3516,14139,2411,25795,1995,987,1008
37825,29314,3516,14140,2411,25798,1995,987,1008
37830,29319,3517,14141,2411,25802,1995,987,1008
37835,29323,3517,14143,2411,25806,1995,987,1008
37840,29326,3518,14146,2412,25808,1995,987,1008
37845,29327,3518,14146,2412,25809,1995,987,1008
37850,29332,3519,14148,2413,25813,1996,987,1009
37855,29334,3519,14148,2413,25815,1997,987,1010
37860,29342,3521,14152,2414,25821,1998,987,1011
37865,29345,3521,14153,2414,25824,1998,987,1011
37870,29350,3521,14155,2414,25829,1998,987,1011
37875,29354,3521,14156,2414,25832,1998,987,1011
37880,29357,3522,14157,2415,25835,1998,987,1011
37885,29358,3522,14158,2415,25836,1998,987,1011
37890,29363,3523,14160,2415,25840,1998,987,1011
37895,29365,3523,14161,2415,25842,1999,987,1012
37900,29373,3525,14167,2416,25848,1999,987,1012
37905,29376,3525,14167,2416,25851,1999,987,1012
37910,29381,3525,14168,2416,25856,1999,987,1012
37915,29385,3525,14170,2416,25860,1999,987,1012
37920,29388,3525,14171,2416,25863,1999,987,1012
37925,29389,3525,14172,2416,25864,1999,987,1012
37930,29394,3526,14174,2416,25868,2000,988,1012
37935,29396,3526,14174,2416,25870,2001,988,1013
37940,29404,3527,14179,2417,25877,2001,988,1013
37945,29407,3527,14179,2417,25880,2001,988,1013
37950,29412,3527,14181,2417,25885,2001,988,1013
37955,29416,3527,14182,2417,25889,2001,988,1013
37960,29419,3527,14184,2417,25892,2001,988,1013
37965,29420,3527,14185,2417,25893,2001,988,1013
37970,29425,3528,14187,2417,25897,2002,989,1013
37975,29427,3528,14188,2417,25899,2003,990,1013
37980,29435,3530,14194,2419,25905,2004,991,1013
37985,29438,3530,14196,2419,25908,2004,991,1013
37990,29443,3531,14199,2419,25912,2004,991,1013
37995,29447,3531,14200,2419,25916,2004,991,1013
38000,29450,3532,14203,2420,25918,2004,991,1013
38005,29451,3532,14203,2420,25919,2004,991,1013
38010,29456,3533,14206,2421,25923,2004,991,1013
38015,29458,3533,14208,2421,25925,2005,992,1013
38020,29466,3535,14213,2423,25931,2005,992,1013
38025,29469,3535,14214,2423,25934,2005,992,1013
38030,29474,3536,14216,2424,25938,2005,992,1013
38035,29478,3536,14218,2424,25942,2005,992,1013
38040,29481,3536,14220,2424,25945,2005,992,1013
38045,29482,3536,14220,2424,25946,2005,992,1013
38050,29487,3537,14222,2424,25950,2005,992,1013
38055,29489,3537,14223,2424,25952,2006,993,1013
38060,29497,3537,14227,2424,25960,2006,993,1013
38065,29500,3537,14229,2424,25963,2006,993,1013
38070,29505,3537,14232,2424,25968,2006,993,1013
38075,29509,3537,14235,2424,25972,2006,993,1013
38080,29512,3537,14236,2424,25975,2006,993,1013
38085,29513,3537,14236,2424,25976,2006,993,1013
38090,29518,3538,14239,2424,25980,2006,993,1013
38095,29520,3538,14241,2424,25982,2007,994,1013
38100,29528,3538,14248,2424,25990,2008,995,1013
38105,29531,3539,14250,2425,25992,2008,995,1013
38110,29536,3539,14254,2425,25997,2008,995,1013
38115,29540,3539,14256,2425,26001,2008,995,1013
38120,29543,3539,14257,2425,26004,2008,995,1013
38125,29544,3539,14257,2425,26005,2008,995,1013
38130,29549,3540,14258,2425,26009,2008,995,1013
38135,29551,3540,14260,2425,26011,2009,996,1013
38140,29559,3541,14265,2425,26018,2010,997,1013
38145,29562,3541,14266,2425,26021,2010,997,1013
38150,29567,3542,14268,2426,26025,2010,997,1013
38155,29571,3542,14268,2426,26029,2010,997,1013
38160,29574,3543,14270,2427,26031,2010,997,1013
38165,29575,3544,14271,2428,26031,2010,997,1013
38170,29580,3545,14274,2429,26035,2010,997,1013
38175,29582,3545,14275,2429,26037,2011,998,1013
38180,29590,3546,14277,2430,26044,2012,998,1014
38185,29593,3546,14278,2430,26047,2012,998,1014
38190,29598,3547,14281,2430,26051,2012,998,1014
38195,29602,3547,14283,2430,26054,2012,998,1014
38200,29605,3548,14284,2431,26057,2012,998,1014
38205,29606,3549,14285,2432,26057,2012,998,1014
38210,29611,3550,14288,2433,26061,2012,998,1014
38215,29613,3550,14288,2433,26063,2013,998,1015
38220,29621,3551,14292,2434,26070,2014,998,1016
38225,29624,3551,14293,2434,26073,2014,998,1016
38230,29629,3551,14296,2434,26078,2014,998,1016
38235,29633,3551,14299,2434,26081,2014,998,1016
38240,29636,3552,14300,2435,26084,2014,998,1016
38245,29637,3553,14301,2436,26084,2014,998,1016
38250,29642,3554,14303,2436,26088,2014,998,1016
38255,29644,3554,14305,2436,26090,2015,999,1016
38260,29652,3554,14309,2436,26098,2015,999,1016
38265,29655,3554,14312,2436,26101,2015,999,1016
38270,29660,3554,14315,2436,26106,2015,999,1016
38275,29664,3554,14318,2436,26109,2015,999,1016
38280,29667,3555,14321,2437,26112,2015,999,1016
38285,29668,3555,14322,2437,26113,2015,999,1016
38290,29673,3555,14324,2437,26118,2015,999,1016
38295,29675,3555,14326,2437,26120,2016,1000,1016
38300,29683,3556,14330,2437,26127,2017,1001,1016
38305,29686,3556,14330,2437,26130,2017,1001,1016
38310,29691,3556,14331,2437,26135,2017,1001,1016
38315,29695,3556,14334,2437,26139,2017,1001,1016
38320,29698,3556,14337,2437,26142,2017,1001,1016
38325,29699,3556,14337,2437,26143,2017,1001,1016
38330,29704,3556,14339,2437,26148,2018,1001,1017
38335,29706,3556,14340,2437,26150,2019,1002,1017
38340,29714,3557,14343,2438,26157,2020,1002,1018
38345,29717,3557,14345,2438,26160,2020,1002,1018
38350,29722,3558,14346,2438,26164,2020,1002,1018
38355,29726,3558,14349,2438,26168,2020,1002,1018
38360,29729,3559,14350,2439,26170,2020,1002,1018
38365,29730,3559,14350,2439,26171,2020,1002,1018
38370,29735,3559,14353,2439,26176,2020,1002,1018
38375,29737,3559,14354,2439,26178,2021,1003,1018
38380,29745,3561,14359,2441,26184,2021,1003,1018
38385,29748,3561,14359,2441,26187,2021,1003,1018
38390,29753,3562,14362,2442,26191,2021,1003,1018
38395,29757,3562,14365,2442,26194,2021,1003,1018
38400,29760,3564,14367,2444,26196,2021,1003,1018
38405,29761,3565,14368,2445,26196,2021,1003,1018
38410,29766,3566,14370,2445,26200,2021,1003,1018
38415,29768,3566,14371,2445,26202,2022,1003,1019
38420,29776,3567,14376,2445,26209,2022,1003,1019
38425,29779,3567,14379,2445,26212,2022,1003,1019
38430,29784,3567,14382,2445,26217,2022,1003,1019
38435,29788,3567,14385,2445,26221,2022,1003,1019
38440,29791,3567,14387,2445,26224,2022,1003,1019
38445,29792,3567,14387,2445,26225,2022,1003,1019
38450,29797,3568,14390,2445,26229,2023,1003,1020
38455,29799,3568,14391,2445,26231,2024,1004,1020
38460,29807,3569,14396,2446,26238,2024,1004,1020
38465,29810,3569,14396,2446,26241,2024,1004,1020
38470,29815,3569,14398,2446,26246,2024,1004,1020
38475,29819,3569,14400,2446,26250,2024,1004,1020
38480,29822,3569,14401,2446,26253,2024,1004,1020
38485,29823,3569,14401,2446,26254,2024,1004,1020
38490,29828,3570,14405,2447,26258,2024,1004,1020
38495,29830,3570,14406,2447,26260,2025,1005,1020
38500,29838,3571,14411,2448,26267,2025,1005,1020
38505,29841,3571,14414,2448,26270,2025,1005,1020
38510,29846,3572,14417,2448,26274,2025,1005,1020
38515,29850,3572,14419,2448,26278,2025,1005,1020
38520,29853,3572,14419,2448,26281,2025,1005,1020
38525,29854,3572,14420,2448,26282,2025,1005,1020
38530,29859,3573,14421,2449,26286,2025,1005,1020
38535,29861,3573,14423,2449,26288,2026,1006,1020
38540,29869,3575,14426,2450,26293,2027,1006,1021
38545,29872,3576,14428,2451,26296,2027,1006,1021
38550,29877,3577,14429,2451,26300,2027,1006,1021
38555,29881,3577,14430,2451,26304,2027,1006,1021
38560,29884,3577,14430,2451,26307,2027,1006,1021
38565,29885,3577,14430,2451,26308,2027,1006,1021
38570,29890,3578,14434,2452,26312,2028,1007,1021
38575,29892,3578,14435,2452,26314,2029,1008,1021
38580,29900,3581,14440,2455,26319,2030,1009,1021
38585,29903,3581,14441,2455,26322,2030,1009,1021
38590,29908,3582,14444,2456,26326,2030,1009,1021
38595,29912,3582,14446,2456,26330,2030,1009,1021
38600,29915,3583,14448,2457,26332,2030,1009,1021
38605,29916,3583,14448,2457,26333,2030,1009,1021
38610,29921,3584,14451,2458,26337,2030,1009,1021
38615,29923,3584,14453,2458,26339,2031,1010,1021
38620,29931,3586,14456,2459,26345,2031,1010,1021
38625,29934,3586,14457,2459,26348,2031,1010,1021
38630,29939,3588,14459,2460,26351,2031,1010,1021
38635,29943,3588,14460,2460,26355,2031,1010,1021
38640,29946,3589,14461,2461,26357,2031,1010,1021
38645,29947,3590,14462,2462,26357,2031,1010,1021
38650,29952,3591,14465,2462,26361,2031,1010,1021
38655,29954,3591,14466,2462,26363,2032,1011,1021
38660,29962,3592,14472,2463,26370,2032,1011,1021
38665,29965,3592,14474,2463,26373,2032,1011,1021
38670,29970,3593,14475,2463,26377,2032,1011,1021
38675,29974,3593,14476,2463,26381,2032,1011,1021
38680,29977,3594,14479,2464,26383,2032,1011,1021
38685,29978,3595,14480,2465,26383,2032,1011,1021
38690,29983,3596,14483,2466,26387,2032,1011,1021
38695,29985,3596,14484,2466,26389,2033,1011,1022
38700,29993,3597,14487,2467,26396,2034,1012,1022
38705,29996,3597,14490,2467,26399,2034,1012,1022
38710,30001,3597,14492,2467,26404,2034,1012,1022
38715,30005,3597,14495,2467,26407,2034,1012,1022
38720,30008,3598,14496,2468,26410,2034,1012,1022
38725,30009,3598,14497,2468,26411,2034,1012,1022
38730,30014,3599,14500,2469,26415,2034,1012,1022
38735,30016,3599,14500,2469,26417,2035,1012,1023
38740,30024,3601,14506,2470,26423,2036,1013,1023
38745,30027,3601,14508,2470,26426,2036,1013,1023
38750,30032,3601,14512,2470,26431,2036,1013,1023
38755,30036,3601,14515,2470,26434,2036,1013,1023
38760,30039,3602,14515,2471,26437,2036,1013,1023
38765,30040,3602,14516,2471,26438,2036,1013,1023
38770,30045,3603,14516,2471,26442,2036,1013,1023
38775,30047,3603,14517,2471,26444,2037,1014,1023
38780,30055,3603,14518,2471,26452,2038,1014,1024
38785,30058,3603,14520,2471,26455,2038,1014,1024
38790,30063,3603,14524,2471,26460,2038,1014,1024
38795,30067,3603,14526,2471,26464,2038,1014,1024
38800,30070,3603,14528,2471,26467,2038,1014,1024
38805,30071,3603,14528,2471,26468,2038,1014,1024
38810,30076,3604,14529,2471,26472,2038,1014,1024
38815,30078,3604,14529,2471,26474,2039,1014,1025
38820,30086,3604,14533,2471,26480,2040,1014,1026
38825,30089,3605,14533,2472,26484,2040,1014,1026
38830,30094,3606,14537,2473,26488,2040,1014,1026
38835,30098,3606,14539,2473,26492,2040,1014,1026
38840,30101,3607,14542,2474,26494,2040,1014,1026
38845,30102,3607,14543,2474,26495,2040,1014,1026
38850,30107,3607,14545,2474,26500,2040,1014,1026
38855,30109,3607,14547,2474,26502,2041,1015,1026
38860,30117,3607,14552,2474,26510,2043,1015,1028
38865,30120,3607,14552,2474,26513,2043,1015,1028
38870,30125,3608,14552,2474,26517,2043,1015,1028
38875,30129,3608,14555,2474,26521,2043,1015,1028
38880,30132,3608,14556,2474,26524,2043,1015,1028
38885,30133,3609,14557,2475,26524,2043,1015,1028
38890,30138,3609,14558,2475,26529,2043,1015,1028
38895,30140,3609,14559,2475,26531,2044,1015,1029
38900,30148,3610,14563,2476,26538,2044,1015,1029
38905,30151,3610,14564,2476,26541,2044,1015,1029
38910,30156,3611,14565,2476,26545,2044,1015,1029
38915,30160,3611,14567,2476,26549,2044,1015,1029
38920,30163,3611,14567,2476,26552,2044,1015,1029
38925,30164,3611,14567,2476,26553,2044,1015,1029
38930,30169,3611,14569,2476,26558,2045,1016,1029
38935,30171,3611,14570,2476,26560,2046,1017,1029
38940,30179,3612,14574,2477,26567,2046,1017,1029
38945,30182,3612,14577,2477,26570,2046,1017,1029
38950,30187,3613,14579,2477,26574,2046,1017,1029
38955,30191,3613,14582,2477,26578,2046,1017,1029
38960,30194,3613,14583,2477,26581,2046,1017,1029
38965,30195,3613,14583,2477,26582,2046,1017,1029
38970,30200,3613,14586,2477,26587,2046,1017,1029
38975,30202,3613,14587,2477,26589,2047,1017,1030
38980,30210,3614,14591,2478,26596,2047,1017,1030
38985,30213,3614,14592,2478,26599,2047,1017,1030
38990,30218,3615,14593,2479,26603,2047,1017,1030
38995,30222,3615,14594,2479,26607,2047,1017,1030
39000,30225,3615,14595,2479,26610,2047,1017,1030
39005,30226,3615,14595,2479,26611,2047,1017,1030
39010,30231,3616,14598,2479,26615,2047,1017,1030
39015,30233,3616,14599,2479,26617,2048,1018,1030
39020,30241,3618,14604,2480,26623,2049,1019,1030
39025,30244,3618,14605,2480,26626,2049,1019,1030
39030,30249,3619,14606,2480,26630,2049,1019,1030
39035,30253,3619,14609,2480,26633,2049,1019,1030
39040,30256,3621,14611,2482,26635,2049,1019,1030
39045,30257,3622,14612,2483,26635,2049,1019,1030
39050,30262,3623,14615,2484,26639,2050,1019,1031
39055,30264,3623,14616,2484,26641,2051,1020,1031
39060,30272,3624,14617,2484,26648,2052,1020,1032
39065,30275,3624,14620,2484,26651,2052,1020,1032
39070,30280,3624,14620,2484,26656,2052,1020,1032
39075,30284,3624,14622,2484,26660,2052,1020,1032
39080,30287,3624,14624,2484,26663,2052,1020,1032
39085,30288,3624,14625,2484,26664,2052,1020,1032
39090,30293,3625,14628,2484,26668,2052,1020,1032
39095,30295,3625,14629,2484,26670,2053,1020,1033
39100,30303,3627,14631,2485,26676,2053,1020,1033
39105,30306,3627,14632,2485,26679,2053,1020,1033
39110,30311,3627,14634,2485,26684,2053,1020,1033
39115,30315,3627,14636,2485,26687,2053,1020,1033
39120,30318,3628,14637,2486,26690,2053,1020,1033
39125,30319,3628,14638,2486,26691,2053,1020,1033
39130,30324,3629,14641,2487,26695,2053,1020,1033
39135,30326,3629,14642,2487,26697,2054,1020,1034
39140,30334,3631,14647,2489,26703,2054,1020,1034
39145,30337,3631,14649,2489,26706,2054,1020,1034
39150,30342,3631,14650,2489,26711,2054,1020,1034
39155,30346,3631,14652,2489,26715,2054,1020,1034
39160,30349,3631,14652,2489,26718,2054,1020,1034
39165,30350,3632,14653,2490,26718,2054,1020,1034
39170,30355,3633,14656,2490,26722,2054,1020,1034
39175,30357,3633,14657,2490,26724,2055,1021,1034
39180,30365,3635,14662,2491,26730,2056,1022,1034
39185,30368,3635,14662,2491,26733,2056,1022,1034
39190,30373,3636,14664,2491,26737,2056,1022,1034
39195,30377,3636,14666,2491,26741,2056,1022,1034
39200,30380,3637,14667,2492,26743,2056,1022,1034
39205,30381,3637,14667,2492,26744,2056,1022,1034
39210,30386,3638,14670,2493,26748,2056,1022,1034
39215,30388,3638,14671,2493,26750,2057,1023,1034
39220,30396,3640,14676,2494,26756,2057,1023,1034
39225,30399,3640,14676,2494,26759,2057,1023,1034
39230,30404,3641,14679,2494,26763,2057,1023,1034
39235,30408,3641,14682,2494,26766,2057,1023,1034
39240,30411,3642,14684,2495,26769,2057,1023,1034
39245,30412,3642,14684,2495,26770,2057,1023,1034
39250,30417,3643,14687,2495,26774,2057,1023,1034
39255,30419,3643,14688,2495,26776,2058,1023,1035
39260,30427,3644,14693,2495,26783,2058,1023,1035
39265,30430,3644,14695,2495,26786,2058,1023,1035
39270,30435,3645,14698,2496,26790,2058,1023,1035
39275,30439,3645,14699,2496,26794,2058,1023,1035
39280,30442,3646,14700,2497,26796,2058,1023,1035
39285,30443,3646,14700,2497,26797,2058,1023,1035
39290,30448,3647,14702,2497,26801,2059,1023,1036
39295,30450,3647,14703,2497,26803,2060,1024,1036
39300,30458,3649,14707,2498,26809,2061,1025,1036
39305,30461,3649,14707,2498,26812,2061,1025,1036
39310,30466,3650,14707,2498,26816,2061,1025,1036
39315,30470,3650,14709,2498,26820,2061,1025,1036
39320,30473,3651,14711,2499,26822,2061,1025,1036
39325,30474,3651,14711,2499,26823,2061,1025,1036
39330,30479,3652,14715,2500,26827,2061,1025,1036
39335,30481,3652,14715,2500,26829,2062,1025,1037
39340,30489,3653,14720,2501,26836,2062,1025,1037
39345,30492,3653,14722,2501,26839,2062,1025,1037
39350,30497,3654,14724,2502,26843,2062,1025,1037
39355,30501,3654,14727,2502,26846,2062,1025,1037
39360,30504,3655,14728,2503,26849,2062,1025,1037
39365,30505,3655,14728,2503,26850,2062,1025,1037
39370,30510,3656,14730,2503,26854,2062,1025,1037
39375,30512,3656,14730,2503,26856,2063,1025,1038
39380,30520,3657,14733,2503,26863,2063,1025,1038
39385,30523,3657,14735,2503,26866,2063,1025,1038
39390,30528,3658,14740,2504,26870,2063,1025,1038
39395,30532,3658,14741,2504,26874,2063,1025,1038
39400,30535,3659,14743,2505,26876,2063,1025,1038
39405,30536,3660,14744,2506,26876,2063,1025,1038
39410,30541,3661,14744,2506,26880,2063,1025,1038
39415,30543,3661,14746,2506,26882,2064,1026,1038
39420,30551,3662,14748,2507,26889,2065,1026,1039
39425,30554,3662,14749,2507,26892,2065,1026,1039
39430,30559,3662,14752,2507,26897,2065,1026,1039
39435,30563,3662,14754,2507,26901,2065,1026,1039
39440,30566,3662,14756,2507,26904,2065,1026,1039
39445,30567,3662,14756,2507,26905,2065,1026,1039
39450,30572,3663,14761,2508,26909,2066,1027,1039
39455,30574,3663,14763,2508,26911,2067,1028,1039
39460,30582,3665,14768,2509,26917,2067,1028,1039
39465,30585,3665,14771,2509,26920,2067,1028,1039
39470,30590,3665,14774,2509,26925,2067,1028,1039
39475,30594,3665,14777,2509,26928,2067,1028,1039
39480,30597,3666,14779,2510,26931,2067,1028,1039
39485,30598,3666,14780,2510,26932,2067,1028,1039
39490,30603,3667,14784,2511,26936,2068,1029,1039
39495,30605,3667,14785,2511,26938,2069,1029,1040
39500,30613,3669,14789,2513,26944,2069,1029,1040
39505,30616,3669,14790,2513,26947,2069,1029,1040
39510,30621,3669,14792,2513,26952,2069,1029,1040
39515,30625,3669,14795,2513,26955,2069,1029,1040
39520,30628,3670,14796,2514,26958,2069,1029,1040
39525,30629,3670,14796,2514,26959,2069,1029,1040
39530,30634,3671,14800,2515,26963,2069,1029,1040
39535,30636,3671,14801,2515,26965,2070,1030,1040
39540,30644,3673,14805,2516,26971,2071,1031,1040
39545,30647,3673,14806,2516,26974,2071,1031,1040
39550,30652,3673,14808,2516,26979,2071,1031,1040
39555,30656,3673,14812,2516,26983,2071,1031,1040
39560,30659,3673,14812,2516,26986,2071,1031,1040
39565,30660,3673,14813,2516,26987,2071,1031,1040
39570,30665,3673,14817,2516,26992,2071,1031,1040
39575,30667,3673,14818,2516,26994,2072,1032,1040
39580,30675,3674,14823,2517,27001,2072,1032,1040
39585,30678,3674,14825,2517,27004,2072,1032,1040
39590,30683,3674,14828,2517,27009,2072,1032,1040
39595,30687,3674,14831,2517,27013,2072,1032,1040
39600,30690,3674,14832,2517,27016,2072,1032,1040
39605,30691,3674,14832,2517,27017,2072,1032,1040
39610,30696,3674,14835,2517,27022,2072,1032,1040
39615,30698,3674,14836,2517,27024,2073,1033,1040
39620,30706,3675,14840,2517,27031,2073,1033,1040
39625,30709,3675,14842,2517,27034,2073,1033,1040
39630,30714,3675,14843,2517,27039,2073,1033,1040
39635,30718,3675,14843,2517,27043,2073,1033,1040
39640,30721,3675,14844,2517,27046,2073,1033,1040
39645,30722,3675,14844,2517,27047,2073,1033,1040
39650,30727,3676,14846,2518,27051,2073,1033,1040
39655,30729,3676,14847,2518,27053,2074,1034,1040
39660,30737,3678,14850,2519,27058,2076,1034,1042
39665,30740,3679,14850,2520,27061,2076,1034,1042
39670,30745,3680,14851,2520,27065,2076,1034,1042
39675,30749,3680,14852,2520,27069,2076,1034,1042
39680,30752,3681,14854,2521,27071,2076,1034,1042
39685,30753,3681,14854,2521,27072,2076,1034,1042
39690,30758,3682,14857,2521,27076,2076,1034,1042
39695,30760,3682,14859,2521,27078,2077,1035,1042
39700,30768,3684,14866,2522,27084,2077,1035,1042
39705,30771,3684,14868,2522,27087,2077,1035,1042
39710,30776,3685,14869,2522,27091,2077,1035,1042
39715,30780,3685,14870,2522,27095,2077,1035,1042
39720,30783,3686,14872,2523,27097,2077,1035,1042
39725,30784,3687,14873,2524,27097,2077,1035,1042
39730,30789,3688,14876,2525,27101,2078,1036,1042
39735,30791,3688,14878,2525,27103,2079,1037,1042
39740,30799,3690,14882,2527,27109,2079,1037,1042
39745,30802,3690,14884,2527,27112,2079,1037,1042
39750,30807,3691,14887,2528,27116,2079,1037,1042
39755,30811,3691,14888,2528,27120,2079,1037,1042
39760,30814,3692,14889,2529,27122,2079,1037,1042
39765,30815,3693,14890,2530,27122,2079,1037,1042
39770,30820,3694,14893,2531,27126,2079,1037,1042
39775,30822,3694,14894,2531,27128,2080,1037,1043
39780,30830,3696,14898,2533,27134,2082,1038,1044
39785,30833,3696,14898,2533,27137,2082,1038,1044
39790,30838,3696,14902,2533,27142,2082,1038,1044
39795,30842,3696,14903,2533,27145,2082,1038,1044
39800,30845,3697,14905,2534,27148,2082,1038,1044
39805,30846,3697,14906,2534,27149,2082,1038,1044
39810,30851,3698,14907,2535,27153,2082,1038,1044
39815,30853,3698,14908,2535,27155,2083,1038,1045
39820,30861,3698,14911,2535,27163,2083,1038,1045
39825,30864,3698,14913,2535,27166,2083,1038,1045
39830,30869,3698,14916,2535,27171,2083,1038,1045
39835,30873,3698,14917,2535,27175,2083,1038,1045
39840,30876,3698,14918,2535,27178,2083,1038,1045
39845,30877,3698,14918,2535,27179,2083,1038,1045
39850,30882,3699,14921,2535,27183,2083,1038,1045
39855,30884,3699,14922,2535,27185,2084,1038,1046
39860,30892,3699,14924,2535,27193,2084,1038,1046
39865,30895,3699,14926,2535,27196,2084,1038,1046
39870,30900,3699,14928,2535,27201,2084,1038,1046
39875,30904,3699,14931,2535,27204,2084,1038,1046
39880,30907,3700,14933,2536,27207,2084,1038,1046
39885,30908,3700,14933,2536,27208,2084,1038,1046
39890,30913,3701,14935,2536,27212,2084,1038,1046
39895,30915,3701,14937,2536,27214,2085,1039,1046
39900,30923,3703,14942,2538,27220,2087,1041,1046
39905,30926,3703,14942,2538,27223,2087,1041,1046
39910,30931,3704,14946,2538,27227,2087,1041,1046
39915,30935,3704,14949,2538,27230,2087,1041,1046
39920,30938,3705,14951,2539,27233,2087,1041,1046
39925,30939,3705,14951,2539,27234,2087,1041,1046
39930,30944,3706,14954,2539,27238,2087,1041,1046
39935,30946,3706,14954,2539,27240,2088,1041,1047
39940,30954,3707,14956,2539,27247,2088,1041,1047
39945,30957,3707,14958,2539,27250,2088,1041,1047
39950,30962,3708,14961,2539,27254,2088,1041,1047
39955,30966,3708,14962,2539,27257,2088,1041,1047
39960,30969,3709,14962,2540,27260,2088,1041,1047
39965,30970,3710,14963,2541,27260,2088,1041,1047
39970,30975,3711,14966,2542,27264,2088,1041,1047
39975,30977,3711,14968,2542,27266,2089,1042,1047
39980,30985,3712,14971,2543,27273,2089,1042,1047
39985,30988,3712,14974,2543,27276,2089,1042,1047
39990,30993,3712,14978,2543,27281,2089,1042,1047
39995,30997,3712,14981,2543,27284,2089,1042,1047
40000,31000,3713,14983,2544,27287,2089,1042,1047
40005,31001,3714,14984,2545,27287,2089,1042,1047
40010,31006,3715,14986,2545,27291,2090,1042,1048
40015,31008,3715,14988,2545,27293,2091,1043,1048
40020,31016,3717,14993,2547,27298,2093,1044,1049
40025,31019,3718,14996,2548,27301,2093,1044,1049
40030,31024,3718,14997,2548,27306,2093,1044,1049
40035,31028,3718,15000,2548,27310,2093,1044,1049
40040,31031,3718,15001,2548,27313,2093,1044,1049
40045,31032,3718,15001,2548,27314,2093,1044,1049
40050,31037,3718,15003,2548,27319,2093,1044,1049
40055,31039,3718,15003,2548,27321,2094,1044,1050
40060,31047,3718,15007,2548,27329,2094,1044,1050
40065,31050,3718,15007,2548,27332,2094,1044,1050
40070,31055,3719,15010,2548,27336,2094,1044,1050
40075,31059,3719,15012,2548,27340,2094,1044,1050
40080,31062,3720,15013,2549,27342,2094,1044,1050
40085,31063,3720,15014,2549,27343,2094,1044,1050
40090,31068,3721,15018,2550,27347,2094,1044,1050
40095,31070,3721,15019,2550,27349,2095,1045,1050
40100,31078,3722,15020,2550,27356,2096,1045,1051
40105,31081,3723,15022,2551,27358,2096,1045,1051
40110,31086,3724,15024,2551,27362,2096,1045,1051
40115,31090,3724,15026,2551,27365,2096,1045,1051
40120,31093,3726,15028,2553,27367,2096,1045,1051
40125,31094,3726,15028,2553,27368,2096,1045,1051
40130,31099,3727,15029,2553,27372,2096,1045,1051
40135,31101,3727,15030,2553,27374,2097,1046,1051
40140,31109,3729,15034,2554,27380,2098,1047,1051
40145,31112,3730,15036,2555,27382,2098,1047,1051
40150,31117,3730,15038,2555,27387,2098,1047,1051
40155,31121,3730,15040,2555,27391,2098,1047,1051
40160,31124,3730,15041,2555,27394,2098,1047,1051
40165,31125,3730,15042,2555,27395,2098,1047,1051
40170,31130,3731,15045,2555,27399,2098,1047,1051
40175,31132,3731,15046,2555,27401,2099,1048,1051
40180,31140,3732,15048,2555,27408,2100,1049,1051
40185,31143,3732,15049,2555,27411,2100,1049,1051
40190,31148,3733,15051,2556,27415,2100,1049,1051
40195,31152,3733,15053,2556,27418,2100,1049,1051
40200,31155,3734,15055,2557,27421,2100,1049,1051
40205,31156,3734,15056,2557,27422,2100,1049,1051
40210,31161,3734,15058,2557,27427,2100,1049,1051
40215,31163,3734,15058,2557,27429,2101,1049,1052
40220,31171,3734,15060,2557,27437,2101,1049,1052
40225,31174,3734,15060,2557,27440,2101,1049,1052
40230,31179,3734,15062,2557,27445,2101,1049,1052
40235,31183,3734,15064,2557,27449,2101,1049,1052
40240,31186,3734,15064,2557,27452,2101,1049,1052
40245,31187,3734,15064,2557,27453,2101,1049,1052
40250,31192,3734,15066,2557,27458,2102,1049,1053
40255,31194,3734,15068,2557,27460,2103,1050,1053
40260,31202,3734,15071,2557,27468,2103,1050,1053
40265,31205,3734,15071,2557,27471,2103,1050,1053
40270,31210,3735,15073,2557,27475,2103,1050,1053
40275,31214,3735,15073,2557,27479,2103,1050,1053
40280,31217,3735,15073,2557,27482,2103,1050,1053
40285,31218,3735,15074,2557,27483,2103,1050,1053
40290,31223,3735,15074,2557,27488,2104,1050,1054
40295,31225,3735,15075,2557,27490,2105,1051,1054
40300,31233,3735,15079,2557,27498,2105,1051,1054
40305,31236,3735,15079,2557,27501,2105,1051,1054
40310,31241,3737,15083,2559,27504,2105,1051,1054
40315,31245,3737,15086,2559,27507,2105,1051,1054
40320,31248,3738,15088,2560,27510,2105,1051,1054
40325,31249,3738,15089,2560,27511,2105,1051,1054
40330,31254,3739,15092,2560,27515,2106,1052,1054
40335,31256,3739,15092,2560,27517,2107,1052,1055
40340,31264,3741,15098,2561,27523,2108,1053,1055
40345,31267,3741,15100,2561,27526,2108,1053,1055
40350,31272,3742,15101,2561,27530,2108,1053,1055
40355,31276,3742,15104,2561,27534,2108,1053,1055
40360,31279,3743,15106,2562,27536,2108,1053,1055
40365,31280,3743,15107,2562,27537,2108,1053,1055
40370,31285,3744,15110,2562,27541,2109,1053,1056
40375,31287,3744,15112,2562,27543,2110,1054,1056
40380,31295,3745,15117,2562,27550,2111,1055,1056
40385,31298,3745,15118,2562,27553,2111,1055,1056
40390,31303,3746,15120,2563,27557,2111,1055,1056
40395,31307,3746,15121,2563,27561,2111,1055,1056
40400,31310,3747,15124,2564,27563,2111,1055,1056
40405,31311,3747,15124,2564,27564,2111,1055,1056
40410,31316,3748,15126,2564,27568,2111,1055,1056
40415,31318,3748,15126,2564,27570,2112,1055,1057
40420,31326,3750,15131,2565,27576,2112,1055,1057
40425,31329,3750,15132,2565,27579,2112,1055,1057
40430,31334,3751,15135,2566,27583,2112,1055,1057
40435,31338,3751,15136,2566,27587,2112,1055,1057
40440,31341,3752,15138,2567,27589,2112,1055,1057
40445,31342,3753,15139,2568,27589,2112,1055,1057
40450,31347,3754,15139,2568,27593,2113,1055,1058
40455,31349,3754,15140,2568,27595,2114,1055,1059
40460,31357,3756,15145,2570,27601,2114,1055,1059
40465,31360,3756,15147,2570,27604,2114,1055,1059
40470,31365,3756,15149,2570,27609,2114,1055,1059
40475,31369,3756,15151,2570,27612,2114,1055,1059
40480,31372,3757,15152,2571,27615,2114,1055,1059
40485,31373,3757,15152,2571,27616,2114,1055,1059
40490,31378,3758,15155,2572,27620,2114,1055,1059
40495,31380,3758,15155,2572,27622,2115,1055,1060
40500,31388,3759,15157,2572,27629,2116,1056,1060
40505,31391,3759,15158,2572,27632,2116,1056,1060
40510,31396,3759,15163,2572,27637,2116,1056,1060
40515,31400,3759,15165,2572,27640,2116,1056,1060
40520,31403,3760,15167,2573,27643,2116,1056,1060
40525,31404,3760,15167,2573,27644,2116,1056,1060
40530,31409,3761,15170,2574,27648,2116,1056,1060
40535,31411,3761,15170,2574,27650,2117,1056,1061
40540,31419,3762,15173,2574,27657,2117,1056,1061
40545,31422,3762,15173,2574,27660,2117,1056,1061
40550,31427,3762,15175,2574,27665,2117,1056,1061
40555,31431,3762,15176,2574,27669,2117,1056,1061
40560,31434,3762,15178,2574,27672,2117,1056,1061
40565,31435,3762,15178,2574,27673,2117,1056,1061
40570,31440,3763,15181,2575,27677,2117,1056,1061
40575,31442,3763,15183,2575,27679,2118,1057,1061
40580,31450,3764,15186,2575,27686,2118,1057,1061
40585,31453,3764,15187,2575,27689,2118,1057,1061
40590,31458,3765,15188,2575,27693,2118,1057,1061
40595,31462,3765,15191,2575,27696,2118,1057,1061
40600,31465,3767,15194,2577,27698,2118,1057,1061
40605,31466,3767,15195,2577,27699,2118,1057,1061
40610,31471,3768,15200,2578,27703,2118,1057,1061
40615,31473,3768,15202,2578,27705,2119,1058,1061
40620,31481,3769,15206,2578,27712,2120,1058,1062
40625,31484,3769,15206,2578,27715,2120,1058,1062
40630,31489,3770,15207,2578,27719,2120,1058,1062
40635,31493,3770,15209,2578,27723,2120,1058,1062
40640,31496,3770,15210,2578,27726,2120,1058,1062
40645,31497,3770,15210,2578,27727,2120,1058,1062
40650,31502,3771,15215,2579,27731,2120,1058,1062
40655,31504,3771,15216,2579,27733,2121,1059,1062
40660,31512,3772,15218,2579,27740,2121,1059,1062
40665,31515,3772,15220,2579,27743,2121,1059,1062
40670,31520,3773,15221,2580,27747,2121,1059,1062
40675,31524,3773,15224,2580,27750,2121,1059,1062
40680,31527,3775,15225,2582,27752,2121,1059,1062
40685,31528,3776,15226,2583,27752,2121,1059,1062
40690,31533,3777,15228,2583,27756,2122,1059,1063
40695,31535,3777,15229,2583,27758,2123,1060,1063
40700,31543,3779,15232,2584,27764,2123,1060,1063
40705,31546,3779,15232,2584,27767,2123,1060,1063
40710,31551,3779,15235,2584,27772,2123,1060,1063
40715,31555,3779,15238,2584,27776,2123,1060,1063
40720,31558,3779,15238,2584,27779,2123,1060,1063
40725,31559,3779,15238,2584,27780,2123,1060,1063
40730,31564,3780,15240,2584,27784,2123,1060,1063
40735,31566,3780,15241,2584,27786,2124,1060,1064
40740,31574,3782,15244,2586,27792,2124,1060,1064
40745,31577,3782,15245,2586,27795,2124,1060,1064
40750,31582,3782,15248,2586,27800,2124,1060,1064
40755,31586,3782,15248,2586,27804,2124,1060,1064
40760,31589,3782,15250,2586,27807,2124,1060,1064
40765,31590,3782,15250,2586,27808,2124,1060,1064
40770,31595,3783,15254,2587,27812,2124,1060,1064
40775,31597,3783,15256,2587,27814,2125,1061,1064
40780,31605,3785,15262,2589,27820,2125,1061,1064
40785,31608,3785,15264,2589,27823,2125,1061,1064
40790,31613,3786,15266,2590,27827,2125,1061,1064
40795,31617,3786,15268,2590,27830,2125,1061,1064
40800,31620,3788,15269,2592,27832,2125,1061,1064
40805,31621,3788,15269,2592,27833,2125,1061,1064
40810,31626,3788,15271,2592,27838,2125,1061,1064
40815,31628,3788,15272,2592,27840,2126,1062,1064
40820,31636,3788,15274,2592,27848,2126,1062,1064
40825,31639,3788,15274,2592,27851,2126,1062,1064
40830,31644,3789,15277,2593,27855,2126,1062,1064
40835,31648,3789,15278,2593,27858,2126,1062,1064
40840,31651,3791,15279,2595,27860,2126,1062,1064
40845,31652,3791,15279,2595,27861,2126,1062,1064
40850,31657,3791,15281,2595,27866,2126,1062,1064
40855,31659,3791,15283,2595,27868,2127,1063,1064
40860,31667,3792,15287,2596,27875,2127,1063,1064
40865,31670,3792,15289,2596,27878,2127,1063,1064
40870,31675,3792,15292,2596,27883,2127,1063,1064
40875,31679,3792,15294,2596,27887,2127,1063,1064
40880,31682,3792,15296,2596,27890,2127,1063,1064
40885,31683,3792,15296,2596,27891,2127,1063,1064
40890,31688,3792,15296,2596,27896,2127,1063,1064
40895,31690,3792,15297,2596,27898,2128,1063,1065
40900,31698,3792,15300,2596,27906,2128,1063,1065
40905,31701,3792,15301,2596,27909,2128,1063,1065
40910,31706,3792,15303,2596,27914,2128,1063,1065
40915,31710,3792,15306,2596,27917,2128,1063,1065
40920,31713,3793,15309,2597,27920,2128,1063,1065
40925,31714,3793,15309,2597,27921,2128,1063,1065
40930,31719,3794,15313,2598,27925,2128,1063,1065
40935,31721,3794,15315,2598,27927,2129,1064,1065
40940,31729,3796,15320,2600,27933,2129,1064,1065
40945,31732,3796,15322,2600,27936,2129,1064,1065
40950,31737,3796,15324,2600,27941,2129,1064,1065
40955,31741,3796,15326,2600,27944,2129,1064,1065
40960,31744,3797,15329,2601,27947,2129,1064,1065
40965,31745,3797,15330,2601,27948,2129,1064,1065
40970,31750,3798,15333,2601,27952,2130,1065,1065
40975,31752,3798,15333,2601,27954,2131,1065,1066
40980,31760,3800,15336,2603,27960,2131,1065,1066
40985,31763,3800,15337,2603,27963,2131,1065,1066
40990,31768,3801,15341,2604,27967,2131,1065,1066
40995,31772,3801,15343,2604,27971,2131,1065,1066
41000,31775,3801,15345,2604,27974,2131,1065,1066
41005,31776,3802,15346,2605,27974,2131,1065,1066
41010,31781,3803,15349,2606,27978,2131,1065,1066
41015,31783,3803,15350,2606,27980,2132,1065,1067
41020,31791,3804,15351,2607,27987,2132,1065,1067
41025,31794,3804,15352,2607,27990,2132,1065,1067
41030,31799,3805,15353,2607,27994,2132,1065,1067
41035,31803,3805,15355,2607,27998,2132,1065,1067
41040,31806,3805,15356,2607,28001,2132,1065,1067
41045,31807,3805,15356,2607,28002,2132,1065,1067
41050,31812,3806,15358,2607,28006,2132,1065,1067
41055,31814,3806,15359,2607,28008,2133,1066,1067
41060,31822,3806,15363,2607,28016,2133,1066,1067
41065,31825,3806,15364,2607,28019,2133,1066,1067
41070,31830,3807,15368,2608,28023,2133,1066,1067
41075,31834,3807,15370,2608,28027,2133,1066,1067
41080,31837,3808,15372,2609,28029,2133,1066,1067
41085,31838,3808,15372,2609,28030,2133,1066,1067
41090,31843,3809,15374,2610,28034,2133,1066,1067
41095,31845,3809,15375,2610,28036,2134,1067,1067
41100,31853,3809,15380,2610,28044,2134,1067,1067
41105,31856,3809,15380,2610,28047,2134,1067,1067
41110,31861,3810,15381,2610,28051,2134,1067,1067
41115,31865,3810,15382,2610,28055,2134,1067,1067
41120,31868,3810,15383,2610,28058,2134,1067,1067
41125,31869,3810,15383,2610,28059,2134,1067,1067
41130,31874,3811,15387,2611,28063,2134,1067,1067
41135,31876,3811,15389,2611,28065,2135,1068,1067
41140,31884,3812,15391,2612,28072,2135,1068,1067
41145,31887,3812,15392,2612,28075,2135,1068,1067
41150,31892,3813,15395,2612,28079,2135,1068,1067
41155,31896,3813,15398,2612,28082,2135,1068,1067
41160,31899,3814,15399,2613,28085,2135,1068,1067
41165,31900,3815,15400,2614,28085,2135,1068,1067
41170,31905,3816,15403,2614,28089,2135,1068,1067
41175,31907,3816,15405,2614,28091,2136,1069,1067
41180,31915,3817,15409,2615,28098,2136,1069,1067
41185,31918,3817,15410,2615,28101,2136,1069,1067
41190,31923,3817,15412,2615,28106,2136,1069,1067
41195,31927,3817,15415,2615,28109,2136,1069,1067
41200,31930,3818,15416,2616,28112,2136,1069,1067
41205,31931,3818,15416,2616,28113,2136,1069,1067
41210,31936,3819,15418,2617,28117,2136,1069,1067
41215,31938,3819,15419,2617,28119,2137,1069,1068
41220,31946,3820,15424,2618,28126,2138,1070,1068
41225,31949,3820,15427,2618,28129,2138,1070,1068
41230,31954,3820,15429,2618,28134,2138,1070,1068
41235,31958,3820,15431,2618,28138,2138,1070,1068
41240,31961,3820,15433,2618,28141,2138,1070,1068
41245,31962,3820,15433,2618,28142,2138,1070,1068
41250,31967,3821,15434,2618,28146,2138,1070,1068
41255,31969,3821,15436,2618,28148,2139,1071,1068
41260,31977,3822,15442,2619,28155,2139,1071,1068
41265,31980,3822,15444,2619,28158,2139,1071,1068
41270,31985,3823,15445,2620,28162,2139,1071,1068
41275,31989,3823,15447,2620,28165,2139,1071,1068
41280,31992,3824,15448,2621,28168,2139,1071,1068
41285,31993,3824,15449,2621,28169,2139,1071,1068
41290,31998,3825,15452,2622,28173,2139,1071,1068
41295,32000,3825,15453,2622,28175,2140,1071,1069
41300,32008,3826,15457,2623,28182,2140,1071,1069
41305,32011,3826,15458,2623,28185,2140,1071,1069
41310,32016,3827,15458,2623,28189,2140,1071,1069
41315,32020,3827,15461,2623,28192,2140,1071,1069
41320,32023,3828,15462,2624,28195,2140,1071,1069
41325,32024,3828,15462,2624,28196,2140,1071,1069
41330,32029,3829,15465,2624,28200,2140,1071,1069
41335,32031,3829,15466,2624,28202,2141,1071,1070
41340,32039,3831,15471,2626,28208,2142,1071,1071
41345,32042,3831,15472,2626,28211,2142,1071,1071
41350,32047,3831,15475,2626,28216,2142,1071,1071
41355,32051,3831,15476,2626,28220,2142,1071,1071
41360,32054,3831,15478,2626,28223,2142,1071,1071
41365,32055,3832,15479,2627,28223,2142,1071,1071
41370,32060,3833,15481,2627,28227,2142,1071,1071
41375,32062,3833,15483,2627,28229,2143,1072,1071
41380,32070,3834,15489,2627,28236,2143,1072,1071
41385,32073,3834,15491,2627,28239,2143,1072,1071
41390,32078,3834,15494,2627,28244,2143,1072,1071
41395,32082,3834,15495,2627,28248,2143,1072,1071
41400,32085,3834,15496,2627,28251,2143,1072,1071
41405,32086,3834,15497,2627,28252,2143,1072,1071
41410,32091,3835,15500,2628,28256,2143,1072,1071
41415,32093,3835,15500,2628,28258,2144,1072,1072
41420,32101,3836,15504,2628,28265,2144,1072,1072
41425,32104,3836,15505,2628,28268,2144,1072,1072
41430,32109,3836,15508,2628,28273,2144,1072,1072
41435,32113,3836,15511,2628,28277,2144,1072,1072
41440,32116,3836,15511,2628,28280,2144,1072,1072
41445,32117,3836,15511,2628,28281,2144,1072,1072
41450,32122,3837,15512,2628,28285,2144,1072,1072
41455,32124,3837,15512,2628,28287,2145,1072,1073
41460,32132,3838,15515,2629,28294,2146,1072,1074
41465,32135,3838,15517,2629,28297,2146,1072,1074
41470,32140,3839,15519,2629,28301,2146,1072,1074
41475,32144,3839,15522,2629,28305,2146,1072,1074
41480,32147,3840,15525,2630,28307,2146,1072,1074
41485,32148,3840,15526,2630,28308,2146,1072,1074
41490,32153,3841,15529,2631,28312,2147,1072,1075
41495,32155,3841,15529,2631,28314,2148,1072,1076
41500,32163,3843,15533,2632,28320,2148,1072,1076
41505,32166,3843,15533,2632,28323,2148,1072,1076
41510,32171,3844,15535,2632,28327,2148,1072,1076
41515,32175,3844,15538,2632,28331,2148,1072,1076
41520,32178,3844,15538,2632,28334,2148,1072,1076
41525,32179,3845,15539,2633,28334,2148,1072,1076
41530,32184,3846,15541,2634,28338,2148,1072,1076
41535,32186,3846,15542,2634,28340,2149,1073,1076
41540,32194,3847,15545,2634,28347,2150,1073,1077
41545,32197,3847,15547,2634,28350,2150,1073,1077
41550,32202,3848,15549,2635,28354,2150,1073,1077
41555,32206,3848,15551,2635,28358,2150,1073,1077
41560,32209,3848,15553,2635,28361,2150,1073,1077
41565,32210,3848,15553,2635,28362,2150,1073,1077
41570,32215,3849,15556,2636,28366,2150,1073,1077
41575,32217,3849,15556,2636,28368,2151,1073,1078
41580,32225,3852,15561,2639,28373,2153,1074,1079
41585,32228,3852,15561,2639,28376,2153,1074,1079
41590,32233,3852,15563,2639,28381,2153,1074,1079
41595,32237,3852,15565,2639,28385,2153,1074,1079
41600,32240,3852,15566,2639,28388,2153,1074,1079
41605,32241,3852,15567,2639,28389,2153,1074,1079
41610,32246,3852,15570,2639,28394,2153,1074,1079
41615,32248,3852,15572,2639,28396,2154,1075,1079
41620,32256,3852,15576,2639,28404,2154,1075,1079
41625,32259,3852,15578,2639,28407,2154,1075,1079
41630,32264,3852,15582,2639,28412,2154,1075,1079
41635,32268,3852,15585,2639,28416,2154,1075,1079
41640,32271,3852,15586,2639,28419,2154,1075,1079
41645,32272,3852,15586,2639,28420,2154,1075,1079
41650,32277,3852,15589,2639,28425,2155,1076,1079
41655,32279,3852,15591,2639,28427,2156,1077,1079
41660,32287,3852,15596,2639,28435,2156,1077,1079
41665,32290,3852,15596,2639,28438,2156,1077,1079
41670,32295,3852,15599,2639,28443,2156,1077,1079
41675,32299,3852,15600,2639,28447,2156,1077,1079
41680,32302,3852,15603,2639,28450,2156,1077,1079
41685,32303,3852,15603,2639,28451,2156,1077,1079
41690,32308,3853,15605,2640,28455,2156,1077,1079
41695,32310,3853,15605,2640,28457,2157,1077,1080
41700,32318,3856,15609,2642,28462,2159,1077,1082
41705,32321,3856,15609,2642,28465,2159,1077,1082
41710,32326,3857,15611,2643,28469,2159,1077,1082
41715,32330,3857,15613,2643,28473,2159,1077,1082
41720,32333,3857,15614,2643,28476,2159,1077,1082
41725,32334,3857,15614,2643,28477,2159,1077,1082
41730,32339,3858,15616,2643,28481,2159,1077,1082
41735,32341,3858,15617,2643,28483,2160,1077,1083
41740,32349,3859,15620,2644,28490,2160,1077,1083
41745,32352,3859,15622,2644,28493,2160,1077,1083
41750,32357,3860,15623,2644,28497,2160,1077,1083
41755,32361,3860,15625,2644,28501,2160,1077,1083
41760,32364,3860,15626,2644,28504,2160,1077,1083
41765,32365,3860,15626,2644,28505,2160,1077,1083
41770,32370,3861,15629,2644,28509,2160,1077,1083
41775,32372,3861,15630,2644,28511,2161,1077,1084
41780,32380,3863,15633,2645,28517,2161,1077,1084
41785,32383,3863,15634,2645,28520,2161,1077,1084
41790,32388,3863,15636,2645,28525,2161,1077,1084
41795,32392,3863,15639,2645,28528,2161,1077,1084
41800,32395,3864,15641,2646,28531,2161,1077,1084
41805,32396,3864,15642,2646,28532,2161,1077,1084
41810,32401,3865,15645,2646,28536,2161,1077,1084
41815,32403,3865,15646,2646,28538,2162,1077,1085
41820,32411,3867,15652,2648,28544,2164,1079,1085
41825,32414,3867,15653,2648,28547,2164,1079,1085
41830,32419,3867,15657,2648,28552,2164,1079,1085
41835,32423,3867,15660,2648,28555,2164,1079,1085
41840,32426,3868,15661,2649,28558,2164,1079,1085
41845,32427,3868,15662,2649,28559,2164,1079,1085
41850,32432,3869,15664,2649,28563,2165,1080,1085
41855,32434,3869,15665,2649,28565,2166,1080,1086
41860,32442,3869,15668,2649,28573,2167,1080,1087
41865,32445,3869,15670,2649,28576,2167,1080,1087
41870,32450,3870,15673,2650,28580,2167,1080,1087
41875,32454,3870,15675,2650,28583,2167,1080,1087
41880,32457,3872,15677,2652,28585,2167,1080,1087
41885,32458,3872,15677,2652,28586,2167,1080,1087
41890,32463,3873,15680,2652,28590,2167,1080,1087
41895,32465,3873,15681,2652,28592,2168,1080,1088
41900,32473,3873,15687,2652,28600,2169,1081,1088
41905,32476,3873,15689,2652,28603,2169,1081,1088
41910,32481,3874,15692,2653,28607,2169,1081,1088
41915,32485,3874,15693,2653,28611,2169,1081,1088
41920,32488,3874,15695,2653,28614,2169,1081,1088
41925,32489,3874,15695,2653,28615,2169,1081,1088
41930,32494,3875,15699,2654,28619,2169,1081,1088
41935,32496,3875,15701,2654,28621,2170,1082,1088
41940,32504,3876,15705,2655,28628,2172,1084,1088
41945,32507,3876,15707,2655,28631,2172,1084,1088
41950,32512,3877,15711,2656,28635,2172,1084,1088
41955,32516,3877,15714,2656,28638,2172,1084,1088
41960,32519,3878,15716,2657,28641,2172,1084,1088
41965,32520,3878,15716,2657,28642,2172,1084,1088
41970,32525,3878,15719,2657,28647,2173,1085,1088
41975,32527,3878,15721,2657,28649,2174,1086,1088
41980,32535,3879,15727,2658,28656,2174,1086,1088
41985,32538,3879,15728,2658,28659,2174,1086,1088
41990,32543,3880,15731,2659,28663,2174,1086,1088
41995,32547,3880,15733,2659,28666,2174,1086,1088
42000,32550,3882,15736,2661,28668,2174,1086,1088
42005,32551,3882,15736,2661,28669,2174,1086,1088
42010,32556,3882,15740,2661,28674,2175,1087,1088
42015,32558,3882,15741,2661,28676,2176,1087,1089
42020,32566,3883,15744,2661,28683,2176,1087,1089
42025,32569,3883,15745,2661,28686,2176,1087,1089
42030,32574,3884,15746,2661,28690,2176,1087,1089
42035,32578,3884,15746,2661,28694,2176,1087,1089
42040,32581,3884,15746,2661,28697,2176,1087,1089
42045,32582,3884,15746,2661,28698,2176,1087,1089
42050,32587,3885,15747,2661,28702,2177,1088,1089
42055,32589,3885,15747,2661,28704,2178,1088,1090
42060,32597,3887,15751,2663,28709,2180,1089,1091
42065,32600,3888,15753,2664,28712,2180,1089,1091
42070,32605,3888,15755,2664,28717,2180,1089,1091
42075,32609,3888,15756,2664,28721,2180,1089,1091
42080,32612,3888,15757,2664,28724,2180,1089,1091
42085,32613,3888,15757,2664,28725,2180,1089,1091
42090,32618,3889,15760,2664,28729,2181,1090,1091
42095,32620,3889,15760,2664,28731,2182,1090,1092
42100,32628,3891,15764,2666,28737,2182,1090,1092
42105,32631,3891,15766,2666,28740,2182,1090,1092
42110,32636,3891,15767,2666,28745,2182,1090,1092
42115,32640,3891,15770,2666,28749,2182,1090,1092
42120,32643,3891,15771,2666,28752,2182,1090,1092
42125,32644,3892,15772,2667,28752,2182,1090,1092
42130,32649,3893,15774,2668,28756,2183,1090,1093
42135,32651,3893,15774,2668,28758,2184,1090,1094
42140,32659,3894,15777,2668,28765,2184,1090,1094
42145,32662,3894,15779,2668,28768,2184,1090,1094
42150,32667,3894,15781,2668,28773,2184,1090,1094
42155,32671,3894,15782,2668,28777,2184,1090,1094
42160,32674,3894,15784,2668,28780,2184,1090,1094
42165,32675,3895,15785,2669,28780,2184,1090,1094
42170,32680,3896,15787,2669,28784,2184,1090,1094
42175,32682,3896,15787,2669,28786,2185,1090,1095
42180,32690,3898,15791,2670,28792,2187,1092,1095
42185,32693,3899,15792,2671,28794,2187,1092,1095
42190,32698,3900,15794,2671,28798,2187,1092,1095
42195,32702,3900,15794,2671,28802,2187,1092,1095
42200,32705,3900,15795,2671,28805,2187,1092,1095
42205,32706,3900,15796,2671,28806,2187,1092,1095
42210,32711,3900,15797,2671,28811,2187,1092,1095
42215,32713,3900,15797,2671,28813,2188,1092,1096
42220,32721,3901,15802,2672,28820,2189,1093,1096
42225,32724,3902,15804,2673,28822,2189,1093,1096
42230,32729,3903,15809,2674,28826,2189,1093,1096
42235,32733,3903,15811,2674,28830,2189,1093,1096
42240,32736,3903,15811,2674,28833,2189,1093,1096
42245,32737,3903,15812,2674,28834,2189,1093,1096
42250,32742,3903,15812,2674,28839,2189,1093,1096
42255,32744,3903,15813,2674,28841,2190,1094,1096
42260,32752,3904,15816,2675,28848,2190,1094,1096
42265,32755,3904,15817,2675,28851,2190,1094,1096
42270,32760,3904,15820,2675,28856,2190,1094,1096
42275,32764,3904,15824,2675,28860,2190,1094,1096
42280,32767,3904,15824,2675,28863,2190,1094,1096
42285,32768,3905,15825,2676,28863,2190,1094,1096
42290,32773,3906,15827,2677,28867,2190,1094,1096
42295,32775,3906,15829,2677,28869,2191,1095,1096
42300,32783,3909,15832,2679,28874,2192,1095,1097
42305,32786,3909,15834,2679,28877,2192,1095,1097
42310,32791,3909,15836,2679,28882,2192,1095,1097
42315,32795,3909,15839,2679,28885,2192,1095,1097
42320,32798,3910,15840,2680,28888,2192,1095,1097
42325,32799,3911,15841,2681,28888,2192,1095,1097
42330,32804,3912,15845,2681,28892,2192,1095,1097
42335,32806,3912,15845,2681,28894,2193,1095,1098
42340,32814,3913,15850,2682,28901,2193,1095,1098
42345,32817,3913,15852,2682,28904,2193,1095,1098
42350,32822,3914,15853,2682,28908,2193,1095,1098
42355,32826,3914,15856,2682,28911,2193,1095,1098
42360,32829,3916,15858,2684,28913,2193,1095,1098
42365,32830,3917,15859,2685,28913,2193,1095,1098
42370,32835,3917,15863,2685,28918,2193,1095,1098
42375,32837,3917,15864,2685,28920,2194,1096,1098
42380,32845,3918,15867,2686,28927,2194,1096,1098
42385,32848,3918,15868,2686,28930,2194,1096,1098
42390,32853,3919,15871,2686,28934,2194,1096,1098
42395,32857,3919,15872,2686,28937,2194,1096,1098
42400,32860,3920,15873,2687,28940,2194,1096,1098
42405,32861,3920,15874,2687,28941,2194,1096,1098
42410,32866,3920,15876,2687,28946,2194,1096,1098
42415,32868,3920,15877,2687,28948,2195,1097,1098
42420,32876,3923,15882,2689,28953,2196,1098,1098
42425,32879,3923,15883,2689,28956,2196,1098,1098
42430,32884,3924,15886,2689,28960,2196,1098,1098
42435,32888,3924,15887,2689,28964,2196,1098,1098
42440,32891,3925,15890,2690,28966,2196,1098,1098
42445,32892,3925,15891,2690,28967,2196,1098,1098
42450,32897,3926,15892,2691,28971,2197,1098,1099
42455,32899,3926,15892,2691,28973,2198,1098,1100
42460,32907,3927,15896,2692,28980,2198,1098,1100
42465,32910,3927,15897,2692,28983,2198,1098,1100
42470,32915,3928,15897,2692,28987,2198,1098,1100
42475,32919,3928,15900,2692,28991,2198,1098,1100
42480,32922,3929,15901,2693,28993,2198,1098,1100
42485,32923,3929,15901,2693,28994,2198,1098,1100
42490,32928,3930,15902,2693,28998,2198,1098,1100
42495,32930,3930,15904,2693,29000,2199,1099,1100
42500,32938,3931,15909,2694,29007,2199,1099,1100
42505,32941,3931,15909,2694,29010,2199,1099,1100
42510,32946,3931,15913,2694,29015,2199,1099,1100
42515,32950,3931,15916,2694,29019,2199,1099,1100
42520,32953,3931,15918,2694,29022,2199,1099,1100
42525,32954,3931,15919,2694,29023,2199,1099,1100
42530,32959,3932,15922,2694,29027,2199,1099,1100
42535,32961,3932,15922,2694,29029,2200,1099,1101
42540,32969,3933,15925,2695,29036,2201,1099,1102
42545,32972,3933,15928,2695,29039,2201,1099,1102
42550,32977,3933,15932,2695,29044,2201,1099,1102
42555,32981,3933,15936,2695,29047,2201,1099,1102
42560,32984,3934,15938,2696,29050,2201,1099,1102
42565,32985,3934,15938,2696,29051,2201,1099,1102
42570,32990,3935,15940,2696,29055,2202,1100,1102
42575,32992,3935,15942,2696,29057,2203,1101,1102
42580,33000,3936,15945,2696,29064,2203,1101,1102
42585,33003,3936,15947,2696,29067,2203,1101,1102
42590,33008,3936,15949,2696,29072,2203,1101,1102
42595,33012,3936,15949,2696,29076,2203,1101,1102
42600,33015,3936,15949,2696,29079,2203,1101,1102
42605,33016,3936,15950,2696,29080,2203,1101,1102
42610,33021,3937,15951,2696,29084,2203,1101,1102
42615,33023,3937,15951,2696,29086,2204,1101,1103
42620,33031,3939,15955,2697,29092,2204,1101,1103
42625,33034,3939,15957,2697,29095,2204,1101,1103
42630,33039,3939,15959,2697,29100,2204,1101,1103
42635,33043,3939,15960,2697,29103,2204,1101,1103
42640,33046,3940,15963,2698,29106,2204,1101,1103
42645,33047,3940,15963,2698,29107,2204,1101,1103
42650,33052,3941,15966,2699,29111,2204,1101,1103
42655,33054,3941,15968,2699,29113,2205,1102,1103
42660,33062,3943,15973,2701,29119,2206,1103,1103
42665,33065,3943,15974,2701,29122,2206,1103,1103
42670,33070,3944,15977,2702,29126,2206,1103,1103
42675,33074,3944,15979,2702,29130,2206,1103,1103
42680,33077,3945,15980,2703,29132,2206,1103,1103
42685,33078,3945,15980,2703,29133,2206,1103,1103
42690,33083,3946,15983,2703,29137,2206,1103,1103
42695,33085,3946,15983,2703,29139,2207,1103,1104
42700,33093,3947,15987,2703,29146,2207,1103,1104
42705,33096,3947,15989,2703,29149,2207,1103,1104
42710,33101,3948,15991,2704,29153,2207,1103,1104
42715,33105,3948,15994,2704,29156,2207,1103,1104
42720,33108,3949,15995,2705,29159,2207,1103,1104
42725,33109,3949,15996,2705,29160,2207,1103,1104
42730,33114,3950,15999,2706,29164,2207,1103,1104
42735,33116,3950,16000,2706,29166,2208,1104,1104
42740,33124,3951,16003,2706,29173,2209,1105,1104
42745,33127,3951,16004,2706,29176,2209,1105,1104
42750,33132,3952,16007,2706,29180,2209,1105,1104
42755,33136,3952,16008,2706,29184,2209,1105,1104
42760,33139,3952,16010,2706,29187,2209,1105,1104
42765,33140,3952,16011,2706,29188,2209,1105,1104
42770,33145,3953,16015,2707,29192,2209,1105,1104
42775,33147,3953,16015,2707,29194,2210,1105,1105
42780,33155,3954,16017,2708,29201,2212,1106,1106
42785,33158,3954,16018,2708,29204,2212,1106,1106
42790,33163,3954,16020,2708,29209,2212,1106,1106
42795,33167,3954,16022,2708,29213,2212,1106,1106
42800,33170,3954,16024,2708,29216,2212,1106,1106
42805,33171,3954,16025,2708,29217,2212,1106,1106
42810,33176,3955,16026,2708,29221,2212,1106,1106
42815,33178,3955,16026,2708,29223,2213,1106,1107
42820,33186,3955,16028,2708,29231,2213,1106,1107
42825,33189,3955,16030,2708,29234,2213,1106,1107
42830,33194,3955,16033,2708,29239,2213,1106,1107
42835,33198,3955,16036,2708,29243,2213,1106,1107
42840,33201,3955,16038,2708,29246,2213,1106,1107
42845,33202,3956,16039,2709,29246,2213,1106,1107
42850,33207,3957,16041,2710,29250,2213,1106,1107
42855,33209,3957,16041,2710,29252,2214,1106,1108
42860,33217,3957,16045,2710,29260,2214,1106,1108
42865,33220,3957,16047,2710,29263,2214,1106,1108
42870,33225,3957,16049,2710,29268,2214,1106,1108
42875,33229,3957,16050,2710,29272,2214,1106,1108
42880,33232,3957,16052,2710,29275,2214,1106,1108
42885,33233,3958,16053,2711,29275,2214,1106,1108
42890,33238,3959,16056,2712,29279,2214,1106,1108
42895,33240,3959,16057,2712,29281,2215,1107,1108
42900,33248,3962,16061,2715,29286,2217,1107,1110
42905,33251,3962,16062,2715,29289,2217,1107,1110
42910,33256,3963,16063,2716,29293,2217,1107,1110
42915,33260,3963,16063,2716,29297,2217,1107,1110
42920,33263,3963,16064,2716,29300,2217,1107,1110
42925,33264,3963,16065,2716,29301,2217,1107,1110
42930,33269,3964,16066,2717,29305,2218,1107,1111
42935,33271,3964,16067,2717,29307,2219,1108,1111
42940,33279,3966,16073,2719,29313,2219,1108,1111
42945,33282,3966,16075,2719,29316,2219,1108,1111
42950,33287,3967,16078,2719,29320,2219,1108,1111
42955,33291,3967,16080,2719,29323,2219,1108,1111
42960,33294,3968,16081,2720,29326,2219,1108,1111
42965,33295,3968,16081,2720,29327,2219,1108,1111
42970,33300,3969,16085,2721,29331,2219,1108,1111
42975,33302,3969,16085,2721,29333,2220,1108,1112
42980,33310,3971,16090,2723,29339,2220,1108,1112
42985,33313,3971,16091,2723,29342,2220,1108,1112
42990,33318,3971,16094,2723,29347,2220,1108,1112
42995,33322,3971,16096,2723,29350,2220,1108,1112
43000,33325,3972,16097,2724,29353,2220,1108,1112
43005,33326,3972,16097,2724,29354,2220,1108,1112
43010,33331,3973,16100,2725,29358,2220,1108,1112
43015,33333,3973,16101,2725,29360,2221,1109,1112
43020,33341,3974,16103,2726,29367,2223,1110,1113
43025,33344,3974,16105,2726,29370,2223,1110,1113
43030,33349,3974,16110,2726,29375,2223,1110,1113
43035,33353,3974,16112,2726,29379,2223,1110,1113
43040,33356,3974,16114,2726,29382,2223,1110,1113
43045,33357,3974,16114,2726,29383,2223,1110,1113
43050,33362,3974,16115,2726,29388,2224,1110,1114
43055,33364,3974,16117,2726,29390,2225,1111,1114
43060,33372,3974,16119,2726,29398,2225,1111,1114
43065,33375,3974,16120,2726,29401,2225,1111,1114
43070,33380,3975,16123,2727,29405,2225,1111,1114
43075,33384,3975,16127,2727,29408,2225,1111,1114
43080,33387,3976,16128,2728,29411,2225,1111,1114
43085,33388,3976,16129,2728,29412,2225,1111,1114
43090,33393,3976,16131,2728,29417,2225,1111,1114
43095,33395,3976,16133,2728,29419,2226,1112,1114
43100,33403,3976,16136,2728,29427,2226,1112,1114
43105,33406,3976,16139,2728,29430,2226,1112,1114
43110,33411,3977,16143,2729,29434,2226,1112,1114
43115,33415,3977,16145,2729,29437,2226,1112,1114
43120,33418,3978,16147,2730,29440,2226,1112,1114
43125,33419,3978,16147,2730,29441,2226,1112,1114
43130,33424,3979,16149,2731,29445,2226,1112,1114
43135,33426,3979,16151,2731,29447,2227,1113,1114
43140,33434,3980,16155,2732,29454,2229,1114,1115
43145,33437,3980,16156,2732,29457,2229,1114,1115
43150,33442,3980,16158,2732,29462,2229,1114,1115
43155,33446,3980,16161,2732,29466,2229,1114,1115
43160,33449,3980,16163,2732,29469,2229,1114,1115
43165,33450,3980,16164,2732,29470,2229,1114,1115
43170,33455,3981,16167,2732,29474,2230,1115,1115
43175,33457,3981,16168,2732,29476,2231,1115,1116
43180,33465,3981,16175,2732,29484,2231,1115,1116
43185,33468,3981,16178,2732,29487,2231,1115,1116
43190,33473,3981,16182,2732,29492,2231,1115,1116
43195,33477,3981,16184,2732,29496,2231,1115,1116
43200,33480,3981,16186,2732,29499,2231,1115,1116
43205,33481,3981,16186,2732,29500,2231,1115,1116
43210,33486,3982,16190,2733,29504,2232,1116,1116
43215,33488,3982,16191,2733,29506,2233,1117,1116
43220,33496,3982,16195,2733,29514,2233,1117,1116
43225,33499,3982,16195,2733,29517,2233,1117,1116
43230,33504,3982,16198,2733,29522,2233,1117,1116
43235,33508,3982,16200,2733,29526,2233,1117,1116
43240,33511,3982,16201,2733,29529,2233,1117,1116
43245,33512,3982,16202,2733,29530,2233,1117,1116
43250,33517,3983,16205,2734,29534,2233,1117,1116
43255,33519,3983,16207,2734,29536,2234,1118,1116
43260,33527,3985,16212,2736,29541,2235,1119,1116
43265,33530,3986,16214,2737,29544,2235,1119,1116
43270,33535,3987,16218,2738,29548,2235,1119,1116
43275,33539,3987,16218,2738,29552,2235,1119,1116
43280,33542,3988,16221,2739,29554,2235,1119,1116
43285,33543,3988,16221,2739,29555,2235,1119,1116
43290,33548,3989,16223,2739,29559,2235,1119,1116
43295,33550,3989,16223,2739,29561,2236,1119,1117
43300,33558,3989,16224,2739,29569,2236,1119,1117
43305,33561,3989,16224,2739,29572,2236,1119,1117
43310,33566,3990,16228,2740,29576,2236,1119,1117
43315,33570,3990,16230,2740,29580,2236,1119,1117
43320,33573,3991,16233,2741,29582,2236,1119,1117
43325,33574,3991,16234,2741,29583,2236,1119,1117
43330,33579,3992,16235,2741,29587,2236,1119,1117
43335,33581,3992,16236,2741,29589,2237,1119,1118
43340,33589,3992,16240,2741,29597,2237,1119,1118
43345,33592,3992,16240,2741,29600,2237,1119,1118
43350,33597,3993,16245,2742,29604,2237,1119,1118
43355,33601,3993,16249,2742,29607,2237,1119,1118
43360,33604,3994,16250,2743,29610,2237,1119,1118
43365,33605,3994,16250,2743,29611,2237,1119,1118
43370,33610,3995,16253,2744,29615,2237,1119,1118
43375,33612,3995,16254,2744,29617,2238,1120,1118
43380,33620,3996,16257,2745,29624,2240,1121,1119
43385,33623,3996,16258,2745,29627,2240,1121,1119
43390,33628,3996,16261,2745,29632,2240,1121,1119
43395,33632,3996,16262,2745,29636,2240,1121,1119
43400,33635,3996,16264,2745,29639,2240,1121,1119
43405,33636,3996,16264,2745,29640,2240,1121,1119
43410,33641,3997,16266,2746,29644,2240,1121,1119
43415,33643,3997,16267,2746,29646,2241,1122,1119
43420,33651,3999,16271,2748,29652,2241,1122,1119
43425,33654,3999,16273,2748,29655,2241,1122,1119
43430,33659,3999,16277,2748,29660,2241,1122,1119
43435,33663,3999,16278,2748,29664,2241,1122,1119
43440,33666,3999,16280,2748,29667,2241,1122,1119
43445,33667,3999,16280,2748,29668,2241,1122,1119
43450,33672,4000,16282,2748,29672,2242,1122,1120
43455,33674,4000,16283,2748,29674,2243,1122,1121
43460,33682,4002,16287,2749,29680,2243,1122,1121
43465,33685,4002,16289,2749,29683,2243,1122,1121
43470,33690,4002,16293,2749,29688,2243,1122,1121
43475,33694,4002,16294,2749,29692,2243,1122,1121
43480,33697,4002,16297,2749,29695,2243,1122,1121
43485,33698,4002,16297,2749,29696,2243,1122,1121
43490,33703,4003,16299,2750,29700,2244,1123,1121
43495,33705,4003,16299,2750,29702,2245,1123,1122
43500,33713,4006,16304,2752,29706,2247,1124,1123
43505,33716,4007,16305,2753,29709,2247,1124,1123
43510,33721,4008,16308,2754,29713,2247,1124,1123
43515,33725,4008,16308,2754,29717,2247,1124,1123
43520,33728,4008,16309,2754,29720,2247,1124,1123
43525,33729,4008,16310,2754,29721,2247,1124,1123
43530,33734,4009,16313,2755,29725,2247,1124,1123
43535,33736,4009,16314,2755,29727,2248,1125,1123
43540,33744,4010,16319,2756,29734,2249,1126,1123
43545,33747,4010,16321,2756,29737,2249,1126,1123
43550,33752,4011,16322,2756,29741,2249,1126,1123
43555,33756,4011,16323,2756,29745,2249,1126,1123
43560,33759,4012,16326,2757,29747,2249,1126,1123
43565,33760,4012,16326,2757,29748,2249,1126,1123
43570,33765,4013,16328,2757,29752,2249,1126,1123
43575,33767,4013,16329,2757,29754,2250,1127,1123
43580,33775,4015,16335,2759,29759,2251,1128,1123
43585,33778,4016,16336,2760,29762,2251,1128,1123
43590,33783,4017,16336,2760,29766,2251,1128,1123
43595,33787,4017,16338,2760,29770,2251,1128,1123
43600,33790,4017,16339,2760,29773,2251,1128,1123
43605,33791,4017,16339,2760,29774,2251,1128,1123
43610,33796,4018,16341,2760,29778,2252,1128,1124
43615,33798,4018,16342,2760,29780,2253,1128,1125
43620,33806,4020,16348,2762,29785,2254,1128,1126
43625,33809,4021,16350,2763,29788,2254,1128,1126
43630,33814,4021,16352,2763,29793,2254,1128,1126
43635,33818,4021,16355,2763,29797,2254,1128,1126
43640,33821,4021,16358,2763,29800,2254,1128,1126
43645,33822,4021,16358,2763,29801,2254,1128,1126
43650,33827,4022,16358,2763,29805,2254,1128,1126
43655,33829,4022,16358,2763,29807,2255,1128,1127
43660,33837,4024,16364,2765,29813,2255,1128,1127
43665,33840,4024,16366,2765,29816,2255,1128,1127
43670,33845,4024,16370,2765,29821,2255,1128,1127
43675,33849,4024,16371,2765,29825,2255,1128,1127
43680,33852,4024,16374,2765,29828,2255,1128,1127
43685,33853,4024,16374,2765,29829,2255,1128,1127
43690,33858,4025,16376,2766,29833,2255,1128,1127
43695,33860,4025,16378,2766,29835,2256,1129,1127
43700,33868,4027,16383,2768,29841,2256,1129,1127
43705,33871,4027,16384,2768,29844,2256,1129,1127
43710,33876,4027,16387,2768,29849,2256,1129,1127
43715,33880,4027,16388,2768,29852,2256,1129,1127
43720,33883,4028,16389,2769,29855,2256,1129,1127
43725,33884,4028,16390,2769,29856,2256,1129,1127
43730,33889,4029,16391,2769,29860,2256,1129,1127
43735,33891,4029,16391,2769,29862,2257,1129,1128
43740,33899,4031,16396,2771,29868,2258,1130,1128
43745,33902,4032,16397,2772,29870,2258,1130,1128
43750,33907,4033,16398,2772,29874,2258,1130,1128
43755,33911,4033,16401,2772,29877,2258,1130,1128
43760,33914,4035,16402,2774,29879,2258,1130,1128
43765,33915,4036,16403,2775,29879,2258,1130,1128
43770,33920,4037,16406,2776,29883,2259,1131,1128
43775,33922,4037,16407,2776,29885,2260,1132,1128
43780,33930,4039,16411,2777,29891,2261,1132,1129
43785,33933,4040,16413,2778,29893,2261,1132,1129
43790,33938,4041,16416,2778,29897,2261,1132,1129
43795,33942,4041,16417,2778,29901,2261,1132,1129
43800,33945,4042,16419,2779,29903,2261,1132,1129
43805,33946,4042,16419,2779,29904,2261,1132,1129
43810,33951,4043,16422,2780,29908,2262,1133,1129
43815,33953,4043,16423,2780,29910,2263,1133,1130
43820,33961,4043,16429,2780,29918,2264,1134,1130
43825,33964,4043,16430,2780,29921,2264,1134,1130
43830,33969,4043,16433,2780,29926,2264,1134,1130
43835,33973,4043,16434,2780,29930,2264,1134,1130
43840,33976,4043,16434,2780,29933,2264,1134,1130
43845,33977,4044,16435,2781,29933,2264,1134,1130
43850,33982,4045,16437,2781,29937,2264,1134,1130
43855,33984,4045,16438,2781,29939,2265,1135,1130
43860,33992,4045,16442,2781,29947,2266,1136,1130
43865,33995,4045,16444,2781,29950,2266,1136,1130
43870,34000,4045,16447,2781,29955,2266,1136,1130
43875,34004,4045,16448,2781,29959,2266,1136,1130
43880,34007,4045,16450,2781,29962,2266,1136,1130
43885,34008,4045,16450,2781,29963,2266,1136,1130
43890,34013,4046,16454,2781,29967,2266,1136,1130
43895,34015,4046,16455,2781,29969,2267,1136,1131
43900,34023,4046,16457,2781,29977,2267,1136,1131
43905,34026,4046,16457,2781,29980,2267,1136,1131
43910,34031,4047,16459,2781,29984,2267,1136,1131
43915,34035,4047,16460,2781,29988,2267,1136,1131
43920,34038,4047,16461,2781,29991,2267,1136,1131
43925,34039,4047,16462,2781,29992,2267,1136,1131
43930,34044,4048,16464,2782,29996,2268,1137,1131
43935,34046,4048,16464,2782,29998,2269,1137,1132
43940,34054,4050,16468,2783,30004,2271,1138,1133
43945,34057,4051,16470,2784,30006,2271,1138,1133
43950,34062,4052,16472,2784,30010,2271,1138,1133
43955,34066,4052,16475,2784,30013,2271,1138,1133
43960,34069,4053,16477,2785,30016,2271,1138,1133
43965,34070,4054,16478,2786,30016,2271,1138,1133
43970,34075,4055,16479,2787,30020,2272,1138,1134
43975,34077,4055,16479,2787,30022,2273,1138,1135
43980,34085,4057,16482,2788,30028,2275,1139,1136
43985,34088,4057,16484,2788,30031,2275,1139,1136
43990,34093,4057,16484,2788,30036,2275,1139,1136
43995,34097,4057,16487,2788,30040,2275,1139,1136
44000,34100,4057,16490,2788,30043,2275,1139,1136
44005,34101,4057,16491,2788,30044,2275,1139,1136
44010,34106,4057,16494,2788,30049,2275,1139,1136
44015,34108,4057,16496,2788,30051,2276,1140,1136
44020,34116,4058,16499,2789,30058,2276,1140,1136
44025,34119,4058,16501,2789,30061,2276,1140,1136
44030,34124,4058,16502,2789,30066,2276,1140,1136
44035,34128,4058,16503,2789,30070,2276,1140,1136
44040,34131,4058,16506,2789,30073,2276,1140,1136
44045,34132,4058,16507,2789,30074,2276,1140,1136
44050,34137,4058,16511,2789,30079,2276,1140,1136
44055,34139,4058,16513,2789,30081,2277,1141,1136
44060,34147,4060,16518,2790,30087,2277,1141,1136
44065,34150,4060,16520,2790,30090,2277,1141,1136
44070,34155,4060,16524,2790,30095,2277,1141,1136
44075,34159,4060,16525,2790,30099,2277,1141,1136
44080,34162,4060,16527,2790,30102,2277,1141,1136
44085,34163,4060,16527,2790,30103,2277,1141,1136
44090,34168,4061,16529,2790,30107,2277,1141,1136
44095,34170,4061,16530,2790,30109,2278,1141,1137
44100,34178,4063,16535,2792,30115,2279,1142,1137
44105,34181,4063,16537,2792,30118,2279,1142,1137
44110,34186,4064,16540,2792,30122,2279,1142,1137
44115,34190,4064,16543,2792,30126,2279,1142,1137
44120,34193,4064,16544,2792,30129,2279,1142,1137
44125,34194,4064,16544,2792,30130,2279,1142,1137
44130,34199,4065,16547,2793,30134,2280,1142,1138
44135,34201,4065,16548,2793,30136,2281,1142,1139
44140,34209,4066,16551,2794,30143,2281,1142,1139
44145,34212,4066,16551,2794,30146,2281,1142,1139
44150,34217,4067,16555,2795,30150,2281,1142,1139
44155,34221,4067,16559,2795,30154,2281,1142,1139
44160,34224,4068,16560,2796,30156,2281,1142,1139
44165,34225,4068,16560,2796,30157,2281,1142,1139
44170,34230,4069,16564,2797,30161,2282,1143,1139
44175,34232,4069,16564,2797,30163,2283,1143,1140
44180,34240,4069,16570,2797,30171,2283,1143,1140
44185,34243,4069,16571,2797,30174,2283,1143,1140
44190,34248,4070,16574,2797,30178,2283,1143,1140
44195,34252,4070,16576,2797,30182,2283,1143,1140
44200,34255,4070,16578,2797,30185,2283,1143,1140
44205,34256,4070,16578,2797,30186,2283,1143,1140
44210,34261,4071,16581,2797,30190,2283,1143,1140
44215,34263,4071,16582,2797,30192,2284,1143,1141
44220,34271,4074,16588,2800,30197,2286,1145,1141
44225,34274,4074,16589,2800,30200,2286,1145,1141
44230,34279,4074,16591,2800,30205,2286,1145,1141
44235,34283,4074,16593,2800,30208,2286,1145,1141
44240,34286,4075,16594,2801,30211,2286,1145,1141
44245,34287,4076,16595,2802,30211,2286,1145,1141
44250,34292,4077,16596,2802,30215,2286,1145,1141
44255,34294,4077,16596,2802,30217,2287,1145,1142
44260,34302,4078,16601,2802,30224,2287,1145,1142
44265,34305,4078,16604,2802,30227,2287,1145,1142
44270,34310,4078,16605,2802,30232,2287,1145,1142
44275,34314,4078,16606,2802,30235,2287,1145,1142
44280,34317,4079,16606,2803,30238,2287,1145,1142
44285,34318,4079,16607,2803,30239,2287,1145,1142
44290,34323,4080,16608,2803,30243,2288,1145,1143
44295,34325,4080,16609,2803,30245,2289,1145,1144
44300,34333,4081,16613,2803,30252,2289,1145,1144
44305,34336,4081,16614,2803,30255,2289,1145,1144
44310,34341,4081,16617,2803,30260,2289,1145,1144
44315,34345,4081,16621,2803,30263,2289,1145,1144
44320,34348,4082,16623,2804,30266,2289,1145,1144
44325,34349,4082,16623,2804,30267,2289,1145,1144
44330,34354,4083,16626,2805,30271,2290,1145,1145
44335,34356,4083,16626,2805,30273,2291,1145,1146
44340,34364,4085,16629,2806,30278,2293,1146,1147
44345,34367,4086,16631,2807,30281,2293,1146,1147
44350,34372,4087,16632,2807,30285,2293,1146,1147
44355,34376,4087,16635,2807,30288,2293,1146,1147
44360,34379,4088,16636,2808,30291,2293,1146,1147
44365,34380,4088,16636,2808,30292,2293,1146,1147
44370,34385,4089,16640,2809,30296,2294,1147,1147
44375,34387,4089,16642,2809,30298,2295,1148,1147
44380,34395,4090,16645,2809,30305,2295,1148,1147
44385,34398,4090,16648,2809,30308,2295,1148,1147
44390,34403,4091,16648,2809,30312,2295,1148,1147
44395,34407,4091,16648,2809,30316,2295,1148,1147
44400,34410,4092,16650,2810,30318,2295,1148,1147
44405,34411,4093,16651,2811,30318,2295,1148,1147
44410,34416,4094,16655,2812,30322,2295,1148,1147
44415,34418,4094,16656,2812,30324,2296,1148,1148
44420,34426,4096,16660,2814,30330,2296,1148,1148
44425,34429,4096,16662,2814,30333,2296,1148,1148
44430,34434,4096,16665,2814,30338,2296,1148,1148
44435,34438,4096,16668,2814,30342,2296,1148,1148
44440,34441,4096,16670,2814,30345,2296,1148,1148
44445,34442,4097,16671,2815,30345,2296,1148,1148
44450,34447,4098,16671,2815,30349,2296,1148,1148
44455,34449,4098,16672,2815,30351,2297,1149,1148
44460,34457,4100,16677,2817,30357,2299,1151,1148
44465,34460,4100,16679,2817,30360,2299,1151,1148
44470,34465,4100,16682,2817,30365,2299,1151,1148
44475,34469,4100,16683,2817,30369,2299,1151,1148
44480,34472,4100,16684,2817,30372,2299,1151,1148
44485,34473,4100,16685,2817,30373,2299,1151,1148
44490,34478,4100,16689,2817,30378,2299,1151,1148
44495,34480,4100,16691,2817,30380,2300,1152,1148
44500,34488,4100,16695,2817,30388,2300,1152,1148
44505,34491,4100,16697,2817,30391,2300,1152,1148
44510,34496,4100,16700,2817,30396,2300,1152,1148
44515,34500,4100,16701,2817,30400,2300,1152,1148
44520,34503,4100,16701,2817,30403,2300,1152,1148
44525,34504,4100,16701,2817,30404,2300,1152,1148
44530,34509,4101,16705,2818,30408,2300,1152,1148
44535,34511,4101,16705,2818,30410,2301,1152,1149
44540,34519,4102,16710,2819,30417,2301,1152,1149
44545,34522,4102,16711,2819,30420,2301,1152,1149
44550,34527,4103,16713,2820,30424,2301,1152,1149
44555,34531,4103,16714,2820,30427,2301,1152,1149
44560,34534,4105,16717,2822,30429,2301,1152,1149
44565,34535,4106,16718,2823,30429,2301,1152,1149
44570,34540,4107,16721,2824,30433,2301,1152,1149
44575,34542,4107,16722,2824,30435,2302,1153,1149
44580,34550,4110,16726,2826,30440,2304,1153,1151
44585,34553,4110,16727,2826,30443,2304,1153,1151
44590,34558,4110,16728,2826,30448,2304,1153,1151
44595,34562,4110,16730,2826,30452,2304,1153,1151
44600,34565,4110,16732,2826,30455,2304,1153,1151
44605,34566,4110,16732,2826,30456,2304,1153,1151
44610,34571,4110,16733,2826,30461,2304,1153,1151
44615,34573,4110,16734,2826,30463,2305,1153,1152
44620,34581,4111,16738,2826,30470,2305,1153,1152
44625,34584,4111,16739,2826,30473,2305,1153,1152
44630,34589,4111,16743,2826,30478,2305,1153,1152
44635,34593,4111,16744,2826,30482,2305,1153,1152
44640,34596,4111,16745,2826,30485,2305,1153,1152
44645,34597,4111,16745,2826,30486,2305,1153,1152
44650,34602,4111,16746,2826,30491,2306,1153,1153
44655,34604,4111,16747,2826,30493,2307,1154,1153
44660,34612,4112,16750,2827,30500,2307,1154,1153
44665,34615,4112,16751,2827,30503,2307,1154,1153
44670,34620,4112,16754,2827,30508,2307,1154,1153
44675,34624,4112,16756,2827,30512,2307,1154,1153
44680,34627,4112,16758,2827,30515,2307,1154,1153
44685,34628,4112,16758,2827,30516,2307,1154,1153
44690,34633,4113,16760,2827,30520,2307,1154,1153
44695,34635,4113,16761,2827,30522,2308,1155,1153
44700,34643,4115,16765,2828,30527,2309,1156,1153
44705,34646,4116,16767,2829,30530,2309,1156,1153
44710,34651,4117,16771,2830,30534,2309,1156,1153
44715,34655,4117,16773,2830,30538,2309,1156,1153
44720,34658,4118,16775,2831,30540,2309,1156,1153
44725,34659,4119,16776,2832,30540,2309,1156,1153
44730,34664,4120,16778,2833,30544,2309,1156,1153
44735,34666,4120,16779,2833,30546,2310,1156,1154
44740,34674,4121,16784,2834,30553,2310,1156,1154
44745,34677,4121,16784,2834,30556,2310,1156,1154
44750,34682,4122,16786,2834,30560,2310,1156,1154
44755,34686,4122,16788,2834,30564,2310,1156,1154
44760,34689,4122,16790,2834,30567,2310,1156,1154
44765,34690,4122,16790,2834,30568,2310,1156,1154
44770,34695,4123,16792,2834,30572,2310,1156,1154
44775,34697,4123,16792,2834,30574,2311,1156,1155
44780,34705,4124,16797,2834,30581,2311,1156,1155
44785,34708,4124,16798,2834,30584,2311,1156,1155
44790,34713,4125,16801,2834,30588,2311,1156,1155
44795,34717,4125,16802,2834,30592,2311,1156,1155
44800,34720,4125,16803,2834,30595,2311,1156,1155
44805,34721,4125,16803,2834,30596,2311,1156,1155
44810,34726,4126,16805,2835,30600,2311,1156,1155
44815,34728,4126,16806,2835,30602,2312,1156,1156
44820,34736,4129,16811,2838,30607,2314,1157,1157
44825,34739,4129,16812,2838,30610,2314,1157,1157
44830,34744,4130,16813,2838,30614,2314,1157,1157
44835,34748,4130,16816,2838,30617,2314,1157,1157
44840,34751,4131,16817,2839,30620,2314,1157,1157
44845,34752,4131,16817,2839,30621,2314,1157,1157
44850,34757,4132,16819,2840,30625,2314,1157,1157
44855,34759,4132,16819,2840,30627,2315,1157,1158
44860,34767,4133,16823,2841,30634,2316,1158,1158
44865,34770,4133,16823,2841,30637,2316,1158,1158
44870,34775,4134,16828,2842,30641,2316,1158,1158
44875,34779,4134,16830,2842,30645,2316,1158,1158
44880,34782,4134,16830,2842,30648,2316,1158,1158
44885,34783,4134,16830,2842,30649,2316,1158,1158
44890,34788,4135,16832,2843,30653,2316,1158,1158
44895,34790,4135,16833,2843,30655,2317,1159,1158
44900,34798,4135,16836,2843,30663,2318,1159,1159
44905,34801,4135,16838,2843,30666,2318,1159,1159
44910,34806,4135,16839,2843,30671,2318,1159,1159
44915,34810,4135,16841,2843,30675,2318,1159,1159
44920,34813,4135,16844,2843,30678,2318,1159,1159
44925,34814,4136,16845,2844,30678,2318,1159,1159
44930,34819,4137,16849,2845,30682,2318,1159,1159
44935,34821,4137,16851,2845,30684,2319,1160,1159
44940,34829,4138,16853,2845,30691,2321,1161,1160
44945,34832,4138,16856,2845,30694,2321,1161,1160
44950,34837,4138,16859,2845,30699,2321,1161,1160
44955,34841,4138,16862,2845,30702,2321,1161,1160
44960,34844,4139,16864,2846,30705,2321,1161,1160
44965,34845,4139,16865,2846,30706,2321,1161,1160
44970,34850,4140,16866,2846,30710,2321,1161,1160
44975,34852,4140,16867,2846,30712,2322,1161,1161
44980,34860,4142,16872,2848,30718,2322,1161,1161
44985,34863,4142,16874,2848,30721,2322,1161,1161
44990,34868,4143,16876,2848,30725,2322,1161,1161
44995,34872,4143,16877,2848,30729,2322,1161,1161
45000,34875,4144,16878,2849,30731,2322,1161,1161
45005,34876,4144,16878,2849,30732,2322,1161,1161
45010,34881,4145,16879,2849,30736,2322,1161,1161
45015,34883,4145,16879,2849,30738,2323,1161,1162
45020,34891,4146,16882,2850,30745,2323,1161,1162
45025,34894,4146,16883,2850,30748,2323,1161,1162
45030,34899,4147,16885,2851,30752,2323,1161,1162
45035,34903,4147,16888,2851,30756,2323,1161,1162
45040,34906,4147,16889,2851,30759,2323,1161,1162
45045,34907,4148,16890,2852,30759,2323,1161,1162
45050,34912,4149,16893,2853,30763,2324,1161,1163
45055,34914,4149,16893,2853,30765,2325,1161,1164
45060,34922,4150,16896,2854,30771,2327,1161,1166
45065,34925,4151,16897,2855,30774,2327,1161,1166
45070,34930,4151,16900,2855,30779,2327,1161,1166
45075,34934,4151,16903,2855,30783,2327,1161,1166
45080,34937,4151,16904,2855,30786,2327,1161,1166
45085,34938,4151,16904,2855,30787,2327,1161,1166
45090,34943,4151,16908,2855,30792,2327,1161,1166
45095,34945,4151,16908,2855,30794,2328,1161,1167
45100,34953,4152,16911,2855,30801,2328,1161,1167
45105,34956,4152,16913,2855,30804,2328,1161,1167
45110,34961,4152,16916,2855,30809,2328,1161,1167
45115,34965,4152,16917,2855,30813,2328,1161,1167
45120,34968,4152,16918,2855,30816,2328,1161,1167
45125,34969,4152,16919,2855,30817,2328,1161,1167
45130,34974,4152,16920,2855,30822,2329,1162,1167
45135,34976,4152,16920,2855,30824,2330,1162,1168
45140,34984,4153,16923,2855,30831,2330,1162,1168
45145,34987,4153,16925,2855,30834,2330,1162,1168
45150,34992,4153,16929,2855,30839,2330,1162,1168
45155,34996,4153,16930,2855,30843,2330,1162,1168
45160,34999,4153,16931,2855,30846,2330,1162,1168
45165,35000,4153,16931,2855,30847,2330,1162,1168
45170,35005,4154,16934,2856,30851,2331,1163,1168
45175,35007,4154,16936,2856,30853,2332,1164,1168
45180,35015,4155,16939,2856,30859,2334,1164,1170
45185,35018,4156,16939,2857,30862,2334,1164,1170
45190,35023,4157,16943,2858,30866,2334,1164,1170
45195,35027,4157,16945,2858,30870,2334,1164,1170
45200,35030,4157,16946,2858,30873,2334,1164,1170
45205,35031,4157,16946,2858,30874,2334,1164,1170
45210,35036,4158,16950,2858,30878,2335,1165,1170
45215,35038,4158,16951,2858,30880,2336,1166,1170
45220,35046,4159,16953,2859,30887,2336,1166,1170
45225,35049,4159,16954,2859,30890,2336,1166,1170
45230,35054,4160,16955,2859,30894,2336,1166,1170
45235,35058,4160,16957,2859,30897,2336,1166,1170
45240,35061,4162,16959,2861,30899,2336,1166,1170
45245,35062,4162,16959,2861,30900,2336,1166,1170
45250,35067,4163,16962,2861,30904,2336,1166,1170
45255,35069,4163,16964,2861,30906,2337,1167,1170
45260,35077,4165,16972,2863,30912,2337,1167,1170
45265,35080,4165,16974,2863,30915,2337,1167,1170
45270,35085,4165,16977,2863,30920,2337,1167,1170
45275,35089,4165,16978,2863,30924,2337,1167,1170
45280,35092,4165,16978,2863,30927,2337,1167,1170
45285,35093,4165,16979,2863,30928,2337,1167,1170
45290,35098,4166,16983,2864,30932,2337,1167,1170
45295,35100,4166,16984,2864,30934,2338,1168,1170
45300,35108,4168,16987,2866,30940,2340,1169,1171
45305,35111,4168,16987,2866,30943,2340,1169,1171
45310,35116,4168,16989,2866,30948,2340,1169,1171
45315,35120,4168,16990,2866,30952,2340,1169,1171
45320,35123,4168,16991,2866,30955,2340,1169,1171
45325,35124,4168,16992,2866,30956,2340,1169,1171
45330,35129,4169,16994,2866,30960,2341,1169,1172
45335,35131,4169,16994,2866,30962,2342,1169,1173
45340,35139,4172,16998,2868,30967,2343,1169,1174
45345,35142,4172,17001,2868,30970,2343,1169,1174
45350,35147,4173,17003,2868,30974,2343,1169,1174
45355,35151,4173,17005,2868,30977,2343,1169,1174
45360,35154,4175,17006,2870,30979,2343,1169,1174
45365,35155,4175,17006,2870,30980,2343,1169,1174
45370,35160,4175,17011,2870,30985,2344,1170,1174
45375,35162,4175,17013,2870,30987,2345,1171,1174
45380,35170,4177,17017,2871,30993,2345,1171,1174
45385,35173,4177,17019,2871,30996,2345,1171,1174
45390,35178,4178,17021,2871,31000,2345,1171,1174
45395,35182,4178,17024,2871,31003,2345,1171,1174
45400,35185,4179,17025,2872,31006,2345,1171,1174
45405,35186,4179,17026,2872,31007,2345,1171,1174
45410,35191,4179,17027,2872,31012,2345,1171,1174
45415,35193,4179,17028,2872,31014,2346,1172,1174
45420,35201,4181,17035,2874,31020,2347,1172,1175
45425,35204,4181,17037,2874,31023,2347,1172,1175
45430,35209,4181,17038,2874,31028,2347,1172,1175
45435,35213,4181,17040,2874,31032,2347,1172,1175
45440,35216,4181,17040,2874,31035,2347,1172,1175
45445,35217,4181,17041,2874,31036,2347,1172,1175
45450,35222,4181,17042,2874,31041,2347,1172,1175
45455,35224,4181,17043,2874,31043,2348,1173,1175
45460,35232,4181,17047,2874,31051,2348,1173,1175
45465,35235,4181,17048,2874,31054,2348,1173,1175
45470,35240,4181,17051,2874,31059,2348,1173,1175
45475,35244,4181,17053,2874,31062,2348,1173,1175
45480,35247,4182,17055,2875,31065,2348,1173,1175
45485,35248,4183,17056,2876,31065,2348,1173,1175
45490,35253,4184,17060,2876,31069,2348,1173,1175
45495,35255,4184,17060,2876,31071,2349,1173,1176
45500,35263,4184,17062,2876,31079,2349,1173,1176
45505,35266,4184,17064,2876,31082,2349,1173,1176
45510,35271,4184,17068,2876,31087,2349,1173,1176
45515,35275,4184,17068,2876,31091,2349,1173,1176
45520,35278,4184,17069,2876,31094,2349,1173,1176
45525,35279,4184,17069,2876,31095,2349,1173,1176
45530,35284,4185,17070,2876,31099,2350,1174,1176
45535,35286,4185,17072,2876,31101,2351,1175,1176
45540,35294,4186,17076,2877,31108,2352,1175,1177
45545,35297,4186,17076,2877,31111,2352,1175,1177
45550,35302,4187,17078,2877,31115,2352,1175,1177
45555,35306,4187,17080,2877,31119,2352,1175,1177
45560,35309,4187,17082,2877,31122,2352,1175,1177
45565,35310,4187,17082,2877,31123,2352,1175,1177
45570,35315,4188,17085,2878,31127,2353,1175,1178
45575,35317,4188,17087,2878,31129,2354,1176,1178
45580,35325,4189,17091,2879,31136,2354,1176,1178
45585,35328,4189,17091,2879,31139,2354,1176,1178
45590,35333,4190,17093,2880,31143,2354,1176,1178
45595,35337,4190,17095,2880,31147,2354,1176,1178
45600,35340,4191,17097,2881,31149,2354,1176,1178
45605,35341,4191,17098,2881,31150,2354,1176,1178
45610,35346,4192,17098,2881,31154,2355,1176,1179
45615,35348,4192,17098,2881,31156,2356,1176,1180
45620,35356,4193,17099,2881,31163,2356,1176,1180
45625,35359,4193,17100,2881,31166,2356,1176,1180
45630,35364,4194,17104,2882,31170,2356,1176,1180
45635,35368,4194,17108,2882,31173,2356,1176,1180
45640,35371,4195,17110,2883,31176,2356,1176,1180
45645,35372,4195,17111,2883,31177,2356,1176,1180
45650,35377,4196,17113,2883,31181,2356,1176,1180
45655,35379,4196,17114,2883,31183,2357,1176,1181
45660,35387,4198,17117,2884,31189,2359,1177,1182
45665,35390,4198,17118,2884,31192,2359,1177,1182
45670,35395,4198,17122,2884,31197,2359,1177,1182
45675,35399,4198,17124,2884,31201,2359,1177,1182
45680,35402,4198,17126,2884,31204,2359,1177,1182
45685,35403,4198,17127,2884,31205,2359,1177,1182
45690,35408,4199,17130,2885,31209,2359,1177,1182
45695,35410,4199,17131,2885,31211,2360,1178,1182
45700,35418,4199,17134,2885,31219,2360,1178,1182
45705,35421,4199,17137,2885,31222,2360,1178,1182
45710,35426,4199,17139,2885,31227,2360,1178,1182
45715,35430,4199,17140,2885,31231,2360,1178,1182
45720,35433,4199,17141,2885,31234,2360,1178,1182
45725,35434,4199,17141,2885,31235,2360,1178,1182
45730,35439,4200,17144,2886,31239,2360,1178,1182
45735,35441,4200,17145,2886,31241,2361,1179,1182
45740,35449,4200,17148,2886,31249,2361,1179,1182
45745,35452,4200,17148,2886,31252,2361,1179,1182
45750,35457,4200,17152,2886,31257,2361,1179,1182
45755,35461,4200,17153,2886,31261,2361,1179,1182
45760,35464,4200,17154,2886,31264,2361,1179,1182
45765,35465,4200,17154,2886,31265,2361,1179,1182
45770,35470,4201,17157,2887,31269,2361,1179,1182
45775,35472,4201,17159,2887,31271,2362,1180,1182
45780,35480,4203,17164,2889,31277,2364,1182,1182
45785,35483,4203,17165,2889,31280,2364,1182,1182
45790,35488,4204,17167,2890,31284,2364,1182,1182
45795,35492,4204,17168,2890,31288,2364,1182,1182
45800,35495,4204,17169,2890,31291,2364,1182,1182
45805,35496,4204,17170,2890,31292,2364,1182,1182
45810,35501,4205,17175,2891,31296,2364,1182,1182
45815,35503,4205,17177,2891,31298,2365,1183,1182
45820,35511,4207,17182,2892,31304,2365,1183,1182
45825,35514,4207,17183,2892,31307,2365,1183,1182
45830,35519,4208,17185,2892,31311,2365,1183,1182
45835,35523,4208,17187,2892,31314,2365,1183,1182
45840,35526,4209,17187,2893,31317,2365,1183,1182
45845,35527,4209,17187,2893,31318,2365,1183,1182
45850,35532,4210,17191,2894,31322,2365,1183,1182
45855,35534,4210,17192,2894,31324,2366,1184,1182
45860,35542,4211,17195,2895,31331,2366,1184,1182
45865,35545,4211,17196,2895,31334,2366,1184,1182
45870,35550,4211,17199,2895,31339,2366,1184,1182
45875,35554,4211,17201,2895,31343,2366,1184,1182
45880,35557,4211,17202,2895,31346,2366,1184,1182
45885,35558,4211,17202,2895,31347,2366,1184,1182
45890,35563,4212,17206,2896,31351,2367,1185,1182
45895,35565,4212,17207,2896,31353,2368,1186,1182
45900,35573,4214,17211,2897,31358,2370,1186,1184
45905,35576,4215,17211,2898,31361,2370,1186,1184
45910,35581,4215,17213,2898,31366,2370,1186,1184
45915,35585,4215,17216,2898,31370,2370,1186,1184
45920,35588,4215,17217,2898,31373,2370,1186,1184
45925,35589,4215,17217,2898,31374,2370,1186,1184
45930,35594,4216,17221,2899,31378,2371,1187,1184
45935,35596,4216,17223,2899,31380,2372,1188,1184
45940,35604,4217,17227,2900,31387,2373,1188,1185
45945,35607,4217,17229,2900,31390,2373,1188,1185
45950,35612,4217,17230,2900,31395,2373,1188,1185
45955,35616,4217,17233,2900,31398,2373,1188,1185
45960,35619,4219,17235,2902,31400,2373,1188,1185
45965,35620,4219,17236,2902,31401,2373,1188,1185
45970,35625,4220,17238,2902,31405,2373,1188,1185
45975,35627,4220,17238,2902,31407,2374,1188,1186
45980,35635,4221,17240,2902,31414,2374,1188,1186
45985,35638,4221,17242,2902,31417,2374,1188,1186
45990,35643,4222,17244,2903,31421,2374,1188,1186
45995,35647,4222,17246,2903,31425,2374,1188,1186
46000,35650,4222,17247,2903,31428,2374,1188,1186
46005,35651,4222,17247,2903,31429,2374,1188,1186
46010,35656,4223,17249,2903,31433,2374,1188,1186
46015,35658,4223,17250,2903,31435,2375,1188,1187
46020,35666,4226,17256,2906,31440,2376,1188,1188
46025,35669,4226,17257,2906,31443,2376,1188,1188
46030,35674,4226,17259,2906,31448,2376,1188,1188
46035,35678,4226,17262,2906,31452,2376,1188,1188
46040,35681,4226,17262,2906,31455,2376,1188,1188
46045,35682,4226,17262,2906,31456,2376,1188,1188
46050,35687,4227,17264,2906,31460,2377,1189,1188
46055,35689,4227,17264,2906,31462,2378,1189,1189
46060,35697,4227,17270,2906,31470,2378,1189,1189
46065,35700,4227,17270,2906,31473,2378,1189,1189
46070,35705,4227,17271,2906,31478,2378,1189,1189
46075,35709,4227,17274,2906,31482,2378,1189,1189
46080,35712,4227,17274,2906,31485,2378,1189,1189
46085,35713,4228,17275,2907,31485,2378,1189,1189
46090,35718,4229,17278,2908,31489,2378,1189,1189
46095,35720,4229,17278,2908,31491,2379,1189,1190
46100,35728,4229,17282,2908,31499,2379,1189,1190
46105,35731,4229,17283,2908,31502,2379,1189,1190
46110,35736,4229,17286,2908,31507,2379,1189,1190
46115,35740,4229,17288,2908,31511,2379,1189,1190
46120,35743,4229,17291,2908,31514,2379,1189,1190
46125,35744,4230,17292,2909,31514,2379,1189,1190
46130,35749,4231,17296,2909,31518,2379,1189,1190
46135,35751,4231,17296,2909,31520,2380,1189,1191
46140,35759,4233,17301,2911,31526,2382,1191,1191
46145,35762,4233,17302,2911,31529,2382,1191,1191
46150,35767,4234,17303,2912,31533,2382,1191,1191
46155,35771,4234,17304,2912,31537,2382,1191,1191
46160,35774,4235,17305,2913,31539,2382,1191,1191
46165,35775,4235,17306,2913,31540,2382,1191,1191
46170,35780,4235,17311,2913,31545,2382,1191,1191
46175,35782,4235,17312,2913,31547,2383,1192,1191
46180,35790,4237,17317,2914,31553,2383,1192,1191
46185,35793,4237,17319,2914,31556,2383,1192,1191
46190,35798,4238,17323,2915,31560,2383,1192,1191
46195,35802,4238,17326,2915,31564,2383,1192,1191
46200,35805,4238,17326,2915,31567,2383,1192,1191
46205,35806,4238,17326,2915,31568,2383,1192,1191
46210,35811,4238,17326,2915,31573,2383,1192,1191
46215,35813,4238,17327,2915,31575,2384,1193,1191
46220,35821,4239,17330,2915,31582,2384,1193,1191
46225,35824,4239,17331,2915,31585,2384,1193,1191
46230,35829,4239,17335,2915,31590,2384,1193,1191
46235,35833,4239,17336,2915,31594,2384,1193,1191
46240,35836,4239,17339,2915,31597,2384,1193,1191
46245,35837,4239,17339,2915,31598,2384,1193,1191
46250,35842,4240,17341,2915,31602,2385,1194,1191
46255,35844,4240,17341,2915,31604,2386,1194,1192
46260,35852,4242,17346,2916,31609,2388,1196,1192
46265,35855,4243,17347,2917,31612,2388,1196,1192
46270,35860,4243,17350,2917,31617,2388,1196,1192
46275,35864,4243,17352,2917,31621,2388,1196,1192
46280,35867,4243,17354,2917,31624,2388,1196,1192
46285,35868,4244,17355,2918,31624,2388,1196,1192
46290,35873,4245,17358,2919,31628,2388,1196,1192
46295,35875,4245,17360,2919,31630,2389,1197,1192
46300,35883,4247,17363,2920,31636,2389,1197,1192
46305,35886,4247,17365,2920,31639,2389,1197,1192
46310,35891,4247,17369,2920,31644,2389,1197,1192
46315,35895,4247,17370,2920,31647,2389,1197,1192
46320,35898,4249,17372,2922,31649,2389,1197,1192
46325,35899,4249,17373,2922,31650,2389,1197,1192
46330,35904,4249,17376,2922,31655,2389,1197,1192
46335,35906,4249,17376,2922,31657,2390,1197,1193
46340,35914,4251,17380,2923,31663,2390,1197,1193
46345,35917,4251,17381,2923,31666,2390,1197,1193
46350,35922,4252,17382,2923,31670,2390,1197,1193
46355,35926,4252,17383,2923,31674,2390,1197,1193
46360,35929,4253,17384,2924,31676,2390,1197,1193
46365,35930,4253,17385,2924,31677,2390,1197,1193
46370,35935,4253,17388,2924,31682,2391,1198,1193
46375,35937,4253,17390,2924,31684,2392,1199,1193
46380,35945,4254,17395,2924,31691,2393,1200,1193
46385,35948,4254,17395,2924,31694,2393,1200,1193
46390,35953,4255,17400,2925,31698,2393,1200,1193
46395,35957,4255,17401,2925,31702,2393,1200,1193
46400,35960,4256,17404,2926,31704,2393,1200,1193
46405,35961,4256,17405,2926,31705,2393,1200,1193
46410,35966,4256,17408,2926,31710,2394,1201,1193
46415,35968,4256,17409,2926,31712,2395,1202,1193
46420,35976,4256,17413,2926,31720,2395,1202,1193
46425,35979,4256,17416,2926,31723,2395,1202,1193
46430,35984,4257,17417,2926,31727,2395,1202,1193
46435,35988,4257,17420,2926,31730,2395,1202,1193
46440,35991,4258,17421,2927,31733,2395,1202,1193
46445,35992,4259,17422,2928,31733,2395,1202,1193
46450,35997,4260,17425,2928,31737,2395,1202,1193
46455,35999,4260,17426,2928,31739,2396,1202,1194
46460,36007,4260,17430,2928,31747,2396,1202,1194
46465,36010,4260,17432,2928,31750,2396,1202,1194
46470,36015,4260,17434,2928,31755,2396,1202,1194
46475,36019,4260,17435,2928,31759,2396,1202,1194
46480,36022,4260,17436,2928,31762,2396,1202,1194
46485,36023,4260,17436,2928,31763,2396,1202,1194
46490,36028,4261,17440,2929,31767,2396,1202,1194
46495,36030,4261,17440,2929,31769,2397,1202,1195
46500,36038,4263,17444,2930,31774,2399,1203,1196
46505,36041,4264,17446,2931,31777,2399,1203,1196
46510,36046,4264,17448,2931,31782,2399,1203,1196
46515,36050,4264,17450,2931,31785,2399,1203,1196
46520,36053,4265,17452,2932,31788,2399,1203,1196
46525,36054,4265,17452,2932,31789,2399,1203,1196
46530,36059,4266,17456,2933,31793,2399,1203,1196
46535,36061,4266,17456,2933,31795,2400,1203,1197
46540,36069,4268,17460,2935,31801,2400,1203,1197
46545,36072,4268,17463,2935,31804,2400,1203,1197
46550,36077,4269,17465,2936,31808,2400,1203,1197
46555,36081,4269,17467,2936,31812,2400,1203,1197
46560,36084,4270,17470,2937,31814,2400,1203,1197
46565,36085,4270,17471,2937,31815,2400,1203,1197
46570,36090,4271,17473,2937,31819,2401,1204,1197
46575,36092,4271,17475,2937,31821,2402,1205,1197
46580,36100,4273,17479,2939,31827,2402,1205,1197
46585,36103,4273,17480,2939,31830,2402,1205,1197
46590,36108,4274,17484,2940,31834,2402,1205,1197
46595,36112,4274,17487,2940,31838,2402,1205,1197
46600,36115,4275,17488,2941,31840,2402,1205,1197
46605,36116,4275,17488,2941,31841,2402,1205,1197
46610,36121,4276,17491,2942,31845,2403,1206,1197
46615,36123,4276,17493,2942,31847,2404,1207,1197
46620,36131,4279,17496,2944,31852,2406,1207,1199
46625,36134,4279,17498,2944,31855,2406,1207,1199
46630,36139,4279,17501,2944,31860,2406,1207,1199
46635,36143,4279,17504,2944,31863,2406,1207,1199
46640,36146,4280,17506,2945,31866,2406,1207,1199
46645,36147,4280,17506,2945,31867,2406,1207,1199
46650,36152,4281,17509,2945,31871,2407,1208,1199
46655,36154,4281,17511,2945,31873,2408,1209,1199
46660,36162,4281,17514,2945,31881,2408,1209,1199
46665,36165,4281,17515,2945,31884,2408,1209,1199
46670,36170,4281,17516,2945,31889,2408,1209,1199
46675,36174,4281,17517,2945,31893,2408,1209,1199
46680,36177,4281,17517,2945,31896,2408,1209,1199
46685,36178,4281,17517,2945,31897,2408,1209,1199
46690,36183,4282,17518,2945,31901,2409,1209,1200
46695,36185,4282,17520,2945,31903,2410,1210,1200
46700,36193,4282,17523,2945,31911,2410,1210,1200
46705,36196,4282,17526,2945,31914,2410,1210,1200
46710,36201,4282,17527,2945,31919,2410,1210,1200
46715,36205,4282,17529,2945,31922,2410,1210,1200
46720,36208,4283,17531,2946,31925,2410,1210,1200
46725,36209,4283,17532,2946,31926,2410,1210,1200
46730,36214,4284,17535,2947,31930,2410,1210,1200
46735,36216,4284,17536,2947,31932,2411,1210,1201
46740,36224,4287,17541,2949,31937,2413,1211,1202
46745,36227,4287,17542,2949,31940,2413,1211,1202
46750,36232,4288,17545,2950,31944,2413,1211,1202
46755,36236,4288,17548,2950,31948,2413,1211,1202
46760,36239,4288,17549,2950,31951,2413,1211,1202
46765,36240,4288,17550,2950,31952,2413,1211,1202
46770,36245,4289,17552,2951,31956,2413,1211,1202
46775,36247,4289,17553,2951,31958,2414,1211,1203
46780,36255,4290,17557,2952,31965,2414,1211,1203
46785,36258,4290,17558,2952,31968,2414,1211,1203
46790,36263,4291,17561,2952,31972,2414,1211,1203
46795,36267,4291,17565,2952,31975,2414,1211,1203
46800,36270,4293,17566,2954,31977,2414,1211,1203
46805,36271,4294,17567,2955,31977,2414,1211,1203
46810,36276,4295,17570,2955,31981,2415,1212,1203
46815,36278,4295,17572,2955,31983,2416,1213,1203
46820,36286,4295,17577,2955,31991,2416,1213,1203
46825,36289,4295,17579,2955,31994,2416,1213,1203
46830,36294,4295,17581,2955,31999,2416,1213,1203
46835,36298,4295,17582,2955,32003,2416,1213,1203
46840,36301,4295,17583,2955,32006,2416,1213,1203
46845,36302,4296,17584,2956,32006,2416,1213,1203
46850,36307,4297,17589,2957,32010,2417,1214,1203
46855,36309,4297,17589,2957,32012,2418,1214,1204
46860,36317,4298,17590,2957,32019,2420,1215,1205
46865,36320,4298,17592,2957,32022,2420,1215,1205
46870,36325,4298,17593,2957,32027,2420,1215,1205
46875,36329,4298,17596,2957,32031,2420,1215,1205
46880,36332,4298,17597,2957,32034,2420,1215,1205
46885,36333,4298,17598,2957,32035,2420,1215,1205
46890,36338,4299,17600,2958,32039,2420,1215,1205
46895,36340,4299,17600,2958,32041,2421,1215,1206
46900,36348,4300,17602,2958,32048,2421,1215,1206
46905,36351,4300,17604,2958,32051,2421,1215,1206
46910,36356,4301,17606,2959,32055,2421,1215,1206
46915,36360,4301,17608,2959,32059,2421,1215,1206
46920,36363,4301,17609,2959,32062,2421,1215,1206
46925,36364,4301,17609,2959,32063,2421,1215,1206
46930,36369,4302,17613,2959,32067,2421,1215,1206
46935,36371,4302,17614,2959,32069,2422,1215,1207
46940,36379,4303,17618,2959,32076,2422,1215,1207
46945,36382,4303,17620,2959,32079,2422,1215,1207
46950,36387,4304,17624,2959,32083,2422,1215,1207
46955,36391,4304,17627,2959,32086,2422,1215,1207
46960,36394,4305,17628,2960,32089,2422,1215,1207
46965,36395,4305,17628,2960,32090,2422,1215,1207
46970,36400,4306,17629,2960,32094,2422,1215,1207
46975,36402,4306,17629,2960,32096,2423,1215,1208
46980,36410,4308,17634,2962,32102,2425,1216,1209
46985,36413,4308,17635,2962,32105,2425,1216,1209
46990,36418,4309,17639,2963,32109,2425,1216,1209
46995,36422,4309,17641,2963,32112,2425,1216,1209
47000,36425,4310,17642,2964,32115,2425,1216,1209
47005,36426,4310,17643,2964,32116,2425,1216,1209
47010,36431,4311,17646,2965,32120,2425,1216,1209
47015,36433,4311,17647,2965,32122,2426,1216,1210
47020,36441,4312,17650,2965,32129,2426,1216,1210
47025,36444,4312,17651,2965,32132,2426,1216,1210
47030,36449,4313,17651,2965,32136,2426,1216,1210
47035,36453,4313,17652,2965,32139,2426,1216,1210
47040,36456,4315,17653,2967,32141,2426,1216,1210
47045,36457,4315,17653,2967,32142,2426,1216,1210
47050,36462,4316,17655,2967,32146,2427,1216,1211
47055,36464,4316,17657,2967,32148,2428,1217,1211
47060,36472,4317,17660,2968,32155,2428,1217,1211
47065,36475,4317,17662,2968,32158,2428,1217,1211
47070,36480,4318,17663,2968,32162,2428,1217,1211
47075,36484,4318,17665,2968,32165,2428,1217,1211
47080,36487,4320,17666,2970,32167,2428,1217,1211
47085,36488,4321,17667,2971,32167,2428,1217,1211
47090,36493,4322,17670,2972,32171,2429,1217,1212
47095,36495,4322,17671,2972,32173,2430,1218,1212
47100,36503,4325,17674,2974,32178,2432,1219,1213
47105,36506,4326,17676,2975,32180,2432,1219,1213
47110,36511,4326,17678,2975,32185,2432,1219,1213
47115,36515,4326,17680,2975,32189,2432,1219,1213
47120,36518,4326,17683,2975,32192,2432,1219,1213
47125,36519,4326,17684,2975,32193,2432,1219,1213
47130,36524,4326,17686,2975,32198,2432,1219,1213
47135,36526,4326,17686,2975,32200,2433,1219,1214
47140,36534,4326,17691,2975,32208,2434,1220,1214
47145,36537,4326,17693,2975,32211,2434,1220,1214
47150,36542,4326,17695,2975,32216,2434,1220,1214
47155,36546,4326,17696,2975,32220,2434,1220,1214
47160,36549,4326,17697,2975,32223,2434,1220,1214
47165,36550,4326,17697,2975,32224,2434,1220,1214
47170,36555,4326,17699,2975,32229,2434,1220,1214
47175,36557,4326,17700,2975,32231,2435,1221,1214
47180,36565,4326,17704,2975,32239,2435,1221,1214
47185,36568,4326,17704,2975,32242,2435,1221,1214
47190,36573,4326,17707,2975,32247,2435,1221,1214
47195,36577,4326,17707,2975,32251,2435,1221,1214
47200,36580,4326,17709,2975,32254,2435,1221,1214
47205,36581,4326,17710,2975,32255,2435,1221,1214
47210,36586,4327,17712,2975,32259,2436,1222,1214
47215,36588,4327,17713,2975,32261,2437,1222,1215
47220,36596,4329,17717,2976,32267,2438,1223,1215
47225,36599,4329,17719,2976,32270,2438,1223,1215
47230,36604,4330,17722,2977,32274,2438,1223,1215
47235,36608,4330,17723,2977,32278,2438,1223,1215
47240,36611,4331,17725,2978,32280,2438,1223,1215
47245,36612,4332,17726,2979,32280,2438,1223,1215
47250,36617,4333,17727,2979,32284,2439,1223,1216
47255,36619,4333,17727,2979,32286,2440,1223,1217
47260,36627,4334,17730,2980,32293,2440,1223,1217
47265,36630,4334,17731,2980,32296,2440,1223,1217
47270,36635,4335,17732,2980,32300,2440,1223,1217
47275,36639,4335,17733,2980,32304,2440,1223,1217
47280,36642,4335,17734,2980,32307,2440,1223,1217
47285,36643,4336,17735,2981,32307,2440,1223,1217
47290,36648,4337,17738,2981,32311,2440,1223,1217
47295,36650,4337,17739,2981,32313,2441,1223,1218
47300,36658,4339,17743,2983,32319,2441,1223,1218
47305,36661,4339,17744,2983,32322,2441,1223,1218
47310,36666,4339,17748,2983,32327,2441,1223,1218
47315,36670,4339,17748,2983,32331,2441,1223,1218
47320,36673,4339,17749,2983,32334,2441,1223,1218
47325,36674,4340,17750,2984,32334,2441,1223,1218
47330,36679,4341,17751,2985,32338,2441,1223,1218
47335,36681,4341,17753,2985,32340,2442,1224,1218
47340,36689,4342,17758,2985,32346,2444,1226,1218
47345,36692,4343,17758,2986,32349,2444,1226,1218
47350,36697,4343,17762,2986,32354,2444,1226,1218
47355,36701,4343,17765,2986,32358,2444,1226,1218
47360,36704,4343,17766,2986,32361,2444,1226,1218
47365,36705,4343,17766,2986,32362,2444,1226,1218
47370,36710,4343,17768,2986,32367,2444,1226,1218
47375,36712,4343,17768,2986,32369,2445,1226,1219
47380,36720,4345,17771,2988,32375,2445,1226,1219
47385,36723,4345,17771,2988,32378,2445,1226,1219
47390,36728,4345,17773,2988,32383,2445,1226,1219
47395,36732,4345,17776,2988,32387,2445,1226,1219
47400,36735,4345,17778,2988,32390,2445,1226,1219
47405,36736,4345,17778,2988,32391,2445,1226,1219
47410,36741,4346,17780,2989,32395,2445,1226,1219
47415,36743,4346,17782,2989,32397,2446,1227,1219
47420,36751,4348,17786,2990,32403,2446,1227,1219
47425,36754,4348,17787,2990,32406,2446,1227,1219
47430,36759,4349,17789,2990,32410,2446,1227,1219
47435,36763,4349,17791,2990,32413,2446,1227,1219
47440,36766,4350,17793,2991,32416,2446,1227,1219
47445,36767,4350,17793,2991,32417,2446,1227,1219
47450,36772,4351,17795,2991,32421,2446,1227,1219
47455,36774,4351,17796,2991,32423,2447,1227,1220
47460,36782,4354,17799,2994,32428,2449,1227,1222
47465,36785,4354,17802,2994,32431,2449,1227,1222
47470,36790,4354,17806,2994,32436,2449,1227,1222
47475,36794,4354,17809,2994,32440,2449,1227,1222
47480,36797,4354,17810,2994,32443,2449,1227,1222
47485,36798,4354,17810,2994,32444,2449,1227,1222
47490,36803,4354,17814,2994,32449,2449,1227,1222
47495,36805,4354,17814,2994,32451,2450,1227,1223
47500,36813,4354,17817,2994,32459,2450,1227,1223
47505,36816,4354,17819,2994,32462,2450,1227,1223
47510,36821,4354,17822,2994,32467,2450,1227,1223
47515,36825,4354,17823,2994,32471,2450,1227,1223
47520,36828,4354,17824,2994,32474,2450,1227,1223
47525,36829,4354,17824,2994,32475,2450,1227,1223
47530,36834,4354,17826,2994,32480,2450,1227,1223
47535,36836,4354,17826,2994,32482,2451,1227,1224
47540,36844,4354,17829,2994,32490,2451,1227,1224
47545,36847,4354,17830,2994,32493,2451,1227,1224
47550,36852,4354,17832,2994,32498,2451,1227,1224
47555,36856,4354,17835,2994,32502,2451,1227,1224
47560,36859,4354,17838,2994,32505,2451,1227,1224
47565,36860,4354,17838,2994,32506,2451,1227,1224
47570,36865,4355,17839,2995,32510,2451,1227,1224
47575,36867,4355,17840,2995,32512,2452,1228,1224
47580,36875,4358,17844,2997,32517,2454,1229,1225
47585,36878,4358,17845,2997,32520,2454,1229,1225
47590,36883,4359,17848,2998,32524,2454,1229,1225
47595,36887,4359,17849,2998,32527,2454,1229,1225
47600,36890,4360,17849,2999,32530,2454,1229,1225
47605,36891,4360,17850,2999,32531,2454,1229,1225
47610,36896,4361,17853,2999,32535,2454,1229,1225
47615,36898,4361,17854,2999,32537,2455,1230,1225
47620,36906,4363,17859,3001,32543,2455,1230,1225
47625,36909,4363,17859,3001,32546,2455,1230,1225
47630,36914,4364,17863,3002,32550,2455,1230,1225
47635,36918,4364,17864,3002,32554,2455,1230,1225
47640,36921,4365,17866,3003,32556,2455,1230,1225
47645,36922,4365,17866,3003,32557,2455,1230,1225
47650,36927,4366,17869,3003,32561,2455,1230,1225
47655,36929,4366,17869,3003,32563,2456,1230,1226
47660,36937,4367,17871,3003,32570,2456,1230,1226
47665,36940,4367,17871,3003,32573,2456,1230,1226
47670,36945,4367,17874,3003,32578,2456,1230,1226
47675,36949,4367,17875,3003,32582,2456,1230,1226
47680,36952,4367,17877,3003,32585,2456,1230,1226
47685,36953,4367,17878,3003,32586,2456,1230,1226
47690,36958,4368,17880,3003,32590,2457,1230,1227
47695,36960,4368,17882,3003,32592,2458,1231,1227
47700,36968,4370,17885,3005,32598,2460,1232,1228
47705,36971,4371,17887,3006,32600,2460,1232,1228
47710,36976,4371,17889,3006,32605,2460,1232,1228
47715,36980,4371,17889,3006,32609,2460,1232,1228
47720,36983,4371,17890,3006,32612,2460,1232,1228
47725,36984,4371,17891,3006,32613,2460,1232,1228
47730,36989,4371,17893,3006,32618,2460,1232,1228
47735,36991,4371,17894,3006,32620,2461,1232,1229
47740,36999,4372,17897,3007,32627,2462,1233,1229
47745,37002,4373,17898,3008,32629,2462,1233,1229
47750,37007,4374,17902,3009,32633,2462,1233,1229
47755,37011,4374,17904,3009,32637,2462,1233,1229
47760,37014,4374,17905,3009,32640,2462,1233,1229
47765,37015,4374,17905,3009,32641,2462,1233,1229
47770,37020,4374,17908,3009,32646,2462,1233,1229
47775,37022,4374,17908,3009,32648,2463,1233,1230
47780,37030,4376,17914,3011,32654,2463,1233,1230
47785,37033,4376,17917,3011,32657,2463,1233,1230
47790,37038,4377,17919,3011,32661,2463,1233,1230
47795,37042,4377,17920,3011,32665,2463,1233,1230
47800,37045,4377,17920,3011,32668,2463,1233,1230
47805,37046,4377,17920,3011,32669,2463,1233,1230
47810,37051,4378,17923,3011,32673,2463,1233,1230
47815,37053,4378,17925,3011,32675,2464,1234,1230
47820,37061,4380,17930,3013,32681,2465,1235,1230
47825,37064,4380,17933,3013,32684,2465,1235,1230
47830,37069,4380,17935,3013,32689,2465,1235,1230
47835,37073,4380,17938,3013,32692,2465,1235,1230
47840,37076,4381,17941,3014,32695,2465,1235,1230
47845,37077,4381,17941,3014,32696,2465,1235,1230
47850,37082,4382,17942,3014,32700,2465,1235,1230
47855,37084,4382,17944,3014,32702,2466,1236,1230
47860,37092,4383,17947,3015,32709,2466,1236,1230
47865,37095,4383,17948,3015,32712,2466,1236,1230
47870,37100,4383,17951,3015,32717,2466,1236,1230
47875,37104,4383,17952,3015,32721,2466,1236,1230
47880,37107,4383,17954,3015,32724,2466,1236,1230
47885,37108,4383,17955,3015,32725,2466,1236,1230
47890,37113,4383,17956,3015,32730,2466,1236,1230
47895,37115,4383,17958,3015,32732,2467,1237,1230
47900,37123,4383,17962,3015,32740,2467,1237,1230
47905,37126,4383,17962,3015,32743,2467,1237,1230
47910,37131,4383,17963,3015,32748,2467,1237,1230
47915,37135,4383,17964,3015,32752,2467,1237,1230
47920,37138,4383,17967,3015,32755,2467,1237,1230
47925,37139,4383,17967,3015,32756,2467,1237,1230
47930,37144,4383,17969,3015,32761,2467,1237,1230
47935,37146,4383,17970,3015,32763,2468,1237,1231
47940,37154,4384,17976,3016,32770,2469,1238,1231
47945,37157,4384,17977,3016,32773,2469,1238,1231
47950,37162,4385,17979,3017,32777,2469,1238,1231
47955,37166,4385,17980,3017,32781,2469,1238,1231
47960,37169,4385,17981,3017,32784,2469,1238,1231
47965,37170,4385,17981,3017,32785,2469,1238,1231
47970,37175,4386,17983,3017,32789,2469,1238,1231
47975,37177,4386,17983,3017,32791,2470,1238,1232
47980,37185,4388,17986,3018,32797,2470,1238,1232
47985,37188,4388,17988,3018,32800,2470,1238,1232
47990,37193,4389,17989,3018,32804,2470,1238,1232
47995,37197,4389,17990,3018,32808,2470,1238,1232
48000,37200,4390,17992,3019,32810,2470,1238,1232
48005,37201,4390,17992,3019,32811,2470,1238,1232
48010,37206,4391,17993,3019,32815,2470,1238,1232
48015,37208,4391,17993,3019,32817,2471,1238,1233
48020,37216,4392,17996,3019,32824,2472,1238,1234
48025,37219,4392,17996,3019,32827,2472,1238,1234
48030,37224,4393,17999,3020,32831,2472,1238,1234
48035,37228,4393,18000,3020,32835,2472,1238,1234
48040,37231,4394,18002,3021,32837,2472,1238,1234
48045,37232,4395,18003,3022,32837,2472,1238,1234
48050,37237,4396,18006,3022,32841,2473,1239,1234
48055,37239,4396,18006,3022,32843,2474,1239,1235
48060,37247,4398,18011,3024,32848,2476,1239,1237
48065,37250,4399,18012,3025,32851,2476,1239,1237
48070,37255,4399,18013,3025,32856,2476,1239,1237
48075,37259,4399,18016,3025,32860,2476,1239,1237
48080,37262,4399,18016,3025,32863,2476,1239,1237
48085,37263,4399,18017,3025,32864,2476,1239,1237
48090,37268,4399,18020,3025,32869,2476,1239,1237
48095,37270,4399,18022,3025,32871,2477,1240,1237
48100,37278,4401,18025,3026,32877,2477,1240,1237
48105,37281,4401,18027,3026,32880,2477,1240,1237
48110,37286,4401,18031,3026,32885,2477,1240,1237
48115,37290,4401,18032,3026,32889,2477,1240,1237
48120,37293,4401,18034,3026,32892,2477,1240,1237
48125,37294,4401,18035,3026,32893,2477,1240,1237
48130,37299,4401,18038,3026,32898,2477,1240,1237
48135,37301,4401,18039,3026,32900,2478,1240,1238
48140,37309,4403,18045,3027,32906,2478,1240,1238
48145,37312,4403,18046,3027,32909,2478,1240,1238
48150,37317,4403,18049,3027,32914,2478,1240,1238
48155,37321,4403,18051,3027,32918,2478,1240,1238
48160,37324,4403,18054,3027,32921,2478,1240,1238
48165,37325,4403,18054,3027,32922,2478,1240,1238
48170,37330,4404,18055,3027,32926,2479,1241,1238
48175,37332,4404,18056,3027,32928,2480,1242,1238
48180,37340,4407,18061,3029,32932,2482,1243,1239
48185,37343,4408,18064,3030,32935,2482,1243,1239
48190,37348,4409,18067,3030,32939,2482,1243,1239
48195,37352,4409,18070,3030,32942,2482,1243,1239
48200,37355,4411,18072,3032,32944,2482,1243,1239
48205,37356,4411,18072,3032,32945,2482,1243,1239
48210,37361,4412,18075,3032,32949,2483,1244,1239
48215,37363,4412,18077,3032,32951,2484,1245,1239
48220,37371,4412,18081,3032,32959,2484,1245,1239
48225,37374,4412,18083,3032,32962,2484,1245,1239
48230,37379,4413,18086,3032,32966,2484,1245,1239
48235,37383,4413,18089,3032,32969,2484,1245,1239
48240,37386,4415,18091,3034,32971,2484,1245,1239
48245,37387,4415,18091,3034,32972,2484,1245,1239
48250,37392,4416,18092,3034,32976,2484,1245,1239
48255,37394,4416,18093,3034,32978,2485,1246,1239
48260,37402,4416,18099,3034,32986,2485,1246,1239
48265,37405,4416,18100,3034,32989,2485,1246,1239
48270,37410,4416,18102,3034,32994,2485,1246,1239
48275,37414,4416,18105,3034,32997,2485,1246,1239
48280,37417,4417,18106,3035,33000,2485,1246,1239
48285,37418,4417,18106,3035,33001,2485,1246,1239
48290,37423,4418,18108,3035,33005,2485,1246,1239
48295,37425,4418,18109,3035,33007,2486,1246,1240
48300,37433,4421,18114,3037,33011,2488,1247,1241
48305,37436,4422,18116,3038,33014,2488,1247,1241
48310,37441,4422,18118,3038,33019,2488,1247,1241
48315,37445,4422,18120,3038,33023,2488,1247,1241
48320,37448,4422,18121,3038,33026,2488,1247,1241
48325,37449,4422,18121,3038,33027,2488,1247,1241
48330,37454,4423,18125,3039,33031,2488,1247,1241
48335,37456,4423,18126,3039,33033,2489,1247,1242
48340,37464,4424,18129,3039,33040,2489,1247,1242
48345,37467,4424,18129,3039,33043,2489,1247,1242
48350,37472,4425,18131,3040,33047,2489,1247,1242
48355,37476,4425,18132,3040,33051,2489,1247,1242
48360,37479,4425,18133,3040,33054,2489,1247,1242
48365,37480,4425,18133,3040,33055,2489,1247,1242
48370,37485,4426,18135,3040,33059,2489,1247,1242
48375,37487,4426,18135,3040,33061,2490,1247,1243
48380,37495,4427,18137,3041,33068,2490,1247,1243
48385,37498,4427,18138,3041,33071,2490,1247,1243
48390,37503,4428,18139,3041,33075,2490,1247,1243
48395,37507,4428,18139,3041,33079,2490,1247,1243
48400,37510,4429,18140,3042,33081,2490,1247,1243
48405,37511,4429,18140,3042,33082,2490,1247,1243
48410,37516,4430,18142,3043,33086,2490,1247,1243
48415,37518,4430,18143,3043,33088,2491,1247,1244
48420,37526,4433,18147,3045,33093,2493,1248,1245
48425,37529,4433,18147,3045,33096,2493,1248,1245
48430,37534,4433,18151,3045,33101,2493,1248,1245
48435,37538,4433,18153,3045,33105,2493,1248,1245
48440,37541,4433,18155,3045,33108,2493,1248,1245
48445,37542,4433,18155,3045,33109,2493,1248,1245
48450,37547,4433,18159,3045,33114,2494,1248,1246
48455,37549,4433,18160,3045,33116,2495,1249,1246
48460,37557,4433,18165,3045,33124,2495,1249,1246
48465,37560,4433,18168,3045,33127,2495,1249,1246
48470,37565,4433,18170,3045,33132,2495,1249,1246
48475,37569,4433,18170,3045,33136,2495,1249,1246
48480,37572,4433,18172,3045,33139,2495,1249,1246
48485,37573,4433,18173,3045,33140,2495,1249,1246
48490,37578,4433,18176,3045,33145,2496,1250,1246
48495,37580,4433,18178,3045,33147,2497,1251,1246
48500,37588,4433,18182,3045,33155,2497,1251,1246
48505,37591,4433,18185,3045,33158,2497,1251,1246
48510,37596,4433,18188,3045,33163,2497,1251,1246
48515,37600,4433,18189,3045,33167,2497,1251,1246
48520,37603,4433,18190,3045,33170,2497,1251,1246
48525,37604,4433,18191,3045,33171,2497,1251,1246
48530,37609,4434,18194,3045,33175,2497,1251,1246
48535,37611,4434,18194,3045,33177,2498,1251,1247
48540,37619,4436,18197,3046,33183,2500,1252,1248
48545,37622,4436,18199,3046,33186,2500,1252,1248
48550,37627,4437,18200,3046,33190,2500,1252,1248
48555,37631,4437,18203,3046,33194,2500,1252,1248
48560,37634,4437,18204,3046,33197,2500,1252,1248
48565,37635,4438,18205,3047,33197,2500,1252,1248
48570,37640,4439,18207,3047,33201,2501,1252,1249
48575,37642,4439,18207,3047,33203,2502,1252,1250
48580,37650,4439,18209,3047,33211,2502,1252,1250
48585,37653,4439,18211,3047,33214,2502,1252,1250
48590,37658,4440,18214,3047,33218,2502,1252,1250
48595,37662,4440,18217,3047,33221,2502,1252,1250
48600,37665,4442,18220,3049,33223,2502,1252,1250
48605,37666,4442,18220,3049,33224,2502,1252,1250
48610,37671,4443,18221,3049,33228,2503,1252,1251
48615,37673,4443,18222,3049,33230,2504,1252,1252
48620,37681,4443,18227,3049,33238,2504,1252,1252
48625,37684,4443,18227,3049,33241,2504,1252,1252
48630,37689,4443,18231,3049,33246,2504,1252,1252
48635,37693,4443,18233,3049,33250,2504,1252,1252
48640,37696,4443,18233,3049,33253,2504,1252,1252
48645,37697,4443,18234,3049,33254,2504,1252,1252
48650,37702,4444,18236,3049,33258,2504,1252,1252
48655,37704,4444,18236,3049,33260,2505,1252,1253
48660,37712,4446,18239,3050,33266,2507,1253,1254
48665,37715,4446,18240,3050,33269,2507,1253,1254
48670,37720,4446,18242,3050,33274,2507,1253,1254
48675,37724,4446,18245,3050,33278,2507,1253,1254
48680,37727,4446,18247,3050,33281,2507,1253,1254
48685,37728,4446,18248,3050,33282,2507,1253,1254
48690,37733,4446,18250,3050,33287,2507,1253,1254
48695,37735,4446,18252,3050,33289,2508,1254,1254
48700,37743,4448,18257,3052,33295,2508,1254,1254
48705,37746,4448,18258,3052,33298,2508,1254,1254
48710,37751,4449,18261,3053,33302,2508,1254,1254
48715,37755,4449,18263,3053,33305,2508,1254,1254
48720,37758,4450,18264,3054,33308,2508,1254,1254
48725,37759,4450,18265,3054,33309,2508,1254,1254
48730,37764,4450,18266,3054,33314,2509,1254,1255
48735,37766,4450,18267,3054,33316,2510,1254,1256
48740,37774,4451,18272,3055,33323,2510,1254,1256
48745,37777,4451,18275,3055,33326,2510,1254,1256
48750,37782,4452,18278,3055,33330,2510,1254,1256
48755,37786,4452,18280,3055,33334,2510,1254,1256
48760,37789,4452,18280,3055,33337,2510,1254,1256
48765,37790,4452,18281,3055,33338,2510,1254,1256
48770,37795,4453,18284,3056,33342,2511,1255,1256
48775,37797,4453,18284,3056,33344,2512,1255,1257
48780,37805,4454,18288,3056,33350,2514,1256,1258
48785,37808,4455,18289,3057,33353,2514,1256,1258
48790,37813,4456,18292,3058,33357,2514,1256,1258
48795,37817,4456,18292,3058,33361,2514,1256,1258
48800,37820,4456,18293,3058,33364,2514,1256,1258
48805,37821,4457,18294,3059,33364,2514,1256,1258
48810,37826,4458,18297,3059,33368,2515,1257,1258
48815,37828,4458,18298,3059,33370,2516,1258,1258
48820,37836,4458,18304,3059,33378,2516,1258,1258
48825,37839,4458,18305,3059,33381,2516,1258,1258
48830,37844,4459,18307,3060,33385,2516,1258,1258
48835,37848,4459,18308,3060,33389,2516,1258,1258
48840,37851,4460,18310,3061,33391,2516,1258,1258
48845,37852,4460,18310,3061,33392,2516,1258,1258
48850,37857,4461,18313,3061,33396,2516,1258,1258
48855,37859,4461,18314,3061,33398,2517,1258,1259
48860,37867,4461,18316,3061,33406,2518,1258,1260
48865,37870,4461,18318,3061,33409,2518,1258,1260
48870,37875,4462,18321,3062,33413,2518,1258,1260
48875,37879,4462,18322,3062,33417,2518,1258,1260
48880,37882,4463,18325,3063,33419,2518,1258,1260
48885,37883,4463,18325,3063,33420,2518,1258,1260
48890,37888,4464,18327,3063,33424,2518,1258,1260
48895,37890,4464,18327,3063,33426,2519,1258,1261
48900,37898,4465,18331,3064,33432,2521,1259,1262
48905,37901,4466,18333,3065,33435,2521,1259,1262
48910,37906,4466,18334,3065,33440,2521,1259,1262
48915,37910,4466,18337,3065,33443,2521,1259,1262
48920,37913,4467,18339,3066,33446,2521,1259,1262
48925,37914,4467,18340,3066,33447,2521,1259,1262
48930,37919,4468,18342,3067,33451,2522,1259,1263
48935,37921,4468,18342,3067,33453,2523,1259,1264
48940,37929,4470,18348,3069,33459,2523,1259,1264
48945,37932,4470,18348,3069,33462,2523,1259,1264
48950,37937,4470,18350,3069,33467,2523,1259,1264
48955,37941,4470,18353,3069,33470,2523,1259,1264
48960,37944,4471,18354,3070,33473,2523,1259,1264
48965,37945,4471,18355,3070,33474,2523,1259,1264
48970,37950,4472,18356,3070,33478,2524,1260,1264
48975,37952,4472,18357,3070,33480,2525,1261,1264
48980,37960,4474,18361,3071,33486,2525,1261,1264
48985,37963,4474,18363,3071,33489,2525,1261,1264
48990,37968,4474,18365,3071,33494,2525,1261,1264
48995,37972,4474,18367,3071,33498,2525,1261,1264
49000,37975,4474,18368,3071,33501,2525,1261,1264
49005,37976,4475,18369,3072,33501,2525,1261,1264
49010,37981,4476,18371,3072,33505,2526,1262,1264
49015,37983,4476,18371,3072,33507,2527,1262,1265
49020,37991,4478,18378,3074,33513,2529,1264,1265
49025,37994,4478,18378,3074,33516,2529,1264,1265
49030,37999,4479,18381,3075,33520,2529,1264,1265
49035,38003,4479,18383,3075,33524,2529,1264,1265
49040,38006,4480,18384,3076,33526,2529,1264,1265
49045,38007,4481,18385,3077,33526,2529,1264,1265
49050,38012,4482,18387,3077,33530,2529,1264,1265
49055,38014,4482,18388,3077,33532,2530,1265,1265
49060,38022,4483,18392,3078,33539,2530,1265,1265
49065,38025,4483,18395,3078,33542,2530,1265,1265
49070,38030,4484,18400,3079,33546,2530,1265,1265
49075,38034,4484,18401,3079,33550,2530,1265,1265
49080,38037,4485,18404,3080,33552,2530,1265,1265
49085,38038,4485,18404,3080,33553,2530,1265,1265
49090,38043,4485,18408,3080,33558,2530,1265,1265
49095,38045,4485,18409,3080,33560,2531,1266,1265
49100,38053,4486,18411,3080,33567,2532,1266,1266
49105,38056,4486,18414,3080,33570,2532,1266,1266
49110,38061,4487,18417,3081,33574,2532,1266,1266
49115,38065,4487,18419,3081,33578,2532,1266,1266
49120,38068,4487,18419,3081,33581,2532,1266,1266
49125,38069,4487,18419,3081,33582,2532,1266,1266
49130,38074,4487,18421,3081,33587,2533,1266,1267
49135,38076,4487,18423,3081,33589,2534,1267,1267
49140,38084,4490,18429,3084,33593,2536,1268,1268
49145,38087,4491,18432,3085,33596,2536,1268,1268
49150,38092,4492,18433,3086,33600,2536,1268,1268
49155,38096,4492,18435,3086,33604,2536,1268,1268
49160,38099,4492,18436,3086,33607,2536,1268,1268
49165,38100,4492,18436,3086,33608,2536,1268,1268
49170,38105,4492,18439,3086,33613,2536,1268,1268
49175,38107,4492,18440,3086,33615,2537,1268,1269
49180,38115,4493,18446,3087,33622,2537,1268,1269
49185,38118,4493,18447,3087,33625,2537,1268,1269
49190,38123,4494,18450,3088,33629,2537,1268,1269
49195,38127,4494,18452,3088,33633,2537,1268,1269
49200,38130,4495,18453,3089,33635,2537,1268,1269
49205,38131,4495,18453,3089,33636,2537,1268,1269
49210,38136,4496,18455,3089,33640,2537,1268,1269
49215,38138,4496,18456,3089,33642,2538,1269,1269
49220,38146,4498,18460,3091,33648,2539,1269,1270
49225,38149,4498,18462,3091,33651,2539,1269,1270
49230,38154,4498,18463,3091,33656,2539,1269,1270
49235,38158,4498,18465,3091,33660,2539,1269,1270
49240,38161,4498,18467,3091,33663,2539,1269,1270
49245,38162,4499,18468,3092,33663,2539,1269,1270
49250,38167,4500,18472,3093,33667,2540,1270,1270
49255,38169,4500,18473,3093,33669,2541,1271,1270
49260,38177,4502,18477,3095,33675,2543,1272,1271
49265,38180,4502,18477,3095,33678,2543,1272,1271
49270,38185,4502,18481,3095,33683,2543,1272,1271
49275,38189,4502,18481,3095,33687,2543,1272,1271
49280,38192,4502,18482,3095,33690,2543,1272,1271
49285,38193,4502,18483,3095,33691,2543,1272,1271
49290,38198,4503,18484,3095,33695,2543,1272,1271
49295,38200,4503,18485,3095,33697,2544,1272,1272
49300,38208,4503,18489,3095,33705,2544,1272,1272
49305,38211,4503,18490,3095,33708,2544,1272,1272
49310,38216,4504,18492,3095,33712,2544,1272,1272
49315,38220,4504,18493,3095,33715,2544,1272,1272
49320,38223,4506,18495,3097,33717,2544,1272,1272
49325,38224,4506,18495,3097,33718,2544,1272,1272
49330,38229,4507,18498,3098,33722,2544,1272,1272
49335,38231,4507,18498,3098,33724,2545,1272,1273
49340,38239,4508,18503,3099,33731,2545,1272,1273
49345,38242,4508,18505,3099,33734,2545,1272,1273
49350,38247,4509,18507,3099,33738,2545,1272,1273
49355,38251,4509,18508,3099,33742,2545,1272,1273
49360,38254,4510,18511,3100,33744,2545,1272,1273
49365,38255,4511,18512,3101,33744,2545,1272,1273
49370,38260,4512,18515,3102,33748,2545,1272,1273
49375,38262,4512,18516,3102,33750,2546,1273,1273
49380,38270,4514,18518,3103,33756,2548,1274,1274
49385,38273,4514,18519,3103,33759,2548,1274,1274
49390,38278,4514,18523,3103,33764,2548,1274,1274
49395,38282,4514,18526,3103,33767,2548,1274,1274
49400,38285,4515,18526,3104,33770,2548,1274,1274
49405,38286,4516,18527,3105,33770,2548,1274,1274
49410,38291,4517,18528,3106,33774,2548,1274,1274
49415,38293,4517,18528,3106,33776,2549,1274,1275
49420,38301,4519,18533,3107,33782,2549,1274,1275
49425,38304,4519,18533,3107,33785,2549,1274,1275
49430,38309,4519,18535,3107,33790,2549,1274,1275
49435,38313,4519,18539,3107,33793,2549,1274,1275
49440,38316,4520,18539,3108,33796,2549,1274,1275
49445,38317,4520,18539,3108,33797,2549,1274,1275
49450,38322,4521,18543,3108,33801,2550,1275,1275
49455,38324,4521,18544,3108,33803,2551,1276,1275
49460,38332,4523,18547,3109,33809,2551,1276,1275
49465,38335,4523,18548,3109,33812,2551,1276,1275
49470,38340,4523,18551,3109,33817,2551,1276,1275
49475,38344,4523,18553,3109,33821,2551,1276,1275
49480,38347,4523,18555,3109,33824,2551,1276,1275
49485,38348,4523,18555,3109,33825,2551,1276,1275
49490,38353,4524,18557,3110,33829,2552,1276,1276
49495,38355,4524,18558,3110,33831,2553,1276,1277
49500,38363,4527,18561,3112,33836,2555,1277,1278
49505,38366,4527,18563,3112,33839,2555,1277,1278
49510,38371,4528,18565,3112,33843,2555,1277,1278
49515,38375,4528,18567,3112,33847,2555,1277,1278
49520,38378,4529,18569,3113,33849,2555,1277,1278
49525,38379,4529,18570,3113,33850,2555,1277,1278
49530,38384,4530,18572,3114,33854,2555,1277,1278
49535,38386,4530,18573,3114,33856,2556,1277,1279
49540,38394,4530,18577,3114,33864,2556,1277,1279
49545,38397,4530,18578,3114,33867,2556,1277,1279
49550,38402,4531,18581,3115,33871,2556,1277,1279
49555,38406,4531,18581,3115,33875,2556,1277,1279
49560,38409,4532,18584,3116,33877,2556,1277,1279
49565,38410,4532,18584,3116,33878,2556,1277,1279
49570,38415,4533,18586,3117,33882,2557,1277,1280
49575,38417,4533,18587,3117,33884,2558,1277,1281
49580,38425,4533,18591,3117,33892,2558,1277,1281
49585,38428,4533,18592,3117,33895,2558,1277,1281
49590,38433,4533,18594,3117,33900,2558,1277,1281
49595,38437,4533,18595,3117,33904,2558,1277,1281
49600,38440,4533,18597,3117,33907,2558,1277,1281
49605,38441,4534,18598,3118,33907,2558,1277,1281
49610,38446,4535,18602,3119,33911,2559,1278,1281
49615,38448,4535,18604,3119,33913,2560,1279,1281
49620,38456,4538,18608,3122,33918,2561,1279,1282
49625,38459,4538,18608,3122,33921,2561,1279,1282
49630,38464,4538,18609,3122,33926,2561,1279,1282
49635,38468,4538,18610,3122,33930,2561,1279,1282
49640,38471,4538,18612,3122,33933,2561,1279,1282
49645,38472,4538,18612,3122,33934,2561,1279,1282
49650,38477,4538,18612,3122,33939,2562,1279,1283
49655,38479,4538,18613,3122,33941,2563,1280,1283
49660,38487,4538,18614,3122,33949,2564,1280,1284
49665,38490,4538,18614,3122,33952,2564,1280,1284
49670,38495,4538,18616,3122,33957,2564,1280,1284
49675,38499,4538,18620,3122,33960,2564,1280,1284
49680,38502,4540,18621,3124,33962,2564,1280,1284
49685,38503,4540,18621,3124,33963,2564,1280,1284
49690,38508,4540,18623,3124,33968,2564,1280,1284
49695,38510,4540,18625,3124,33970,2565,1281,1284
49700,38518,4542,18629,3125,33976,2565,1281,1284
49705,38521,4542,18631,3125,33979,2565,1281,1284
49710,38526,4543,18634,3125,33983,2565,1281,1284
49715,38530,4543,18635,3125,33987,2565,1281,1284
49720,38533,4543,18637,3125,33990,2565,1281,1284
49725,38534,4543,18637,3125,33991,2565,1281,1284
49730,38539,4544,18639,3125,33995,2565,1281,1284
49735,38541,4544,18639,3125,33997,2566,1281,1285
49740,38549,4547,18642,3127,34001,2567,1281,1286
49745,38552,4548,18644,3128,34004,2567,1281,1286
49750,38557,4549,18646,3129,34008,2567,1281,1286
49755,38561,4549,18648,3129,34012,2567,1281,1286
49760,38564,4550,18650,3130,34014,2567,1281,1286
49765,38565,4551,18651,3131,34014,2567,1281,1286
49770,38570,4552,18654,3132,34018,2568,1281,1287
49775,38572,4552,18655,3132,34020,2569,1281,1288
49780,38580,4552,18658,3132,34028,2570,1281,1289
49785,38583,4552,18659,3132,34031,2570,1281,1289
49790,38588,4553,18662,3133,34035,2570,1281,1289
49795,38592,4553,18663,3133,34038,2570,1281,1289
49800,38595,4555,18665,3135,34040,2570,1281,1289
49805,38596,4556,18666,3136,34040,2570,1281,1289
49810,38601,4557,18669,3136,34044,2571,1281,1290
49815,38603,4557,18670,3136,34046,2572,1282,1290
49820,38611,4558,18671,3136,34053,2572,1282,1290
49825,38614,4558,18673,3136,34056,2572,1282,1290
49830,38619,4558,18675,3136,34061,2572,1282,1290
49835,38623,4558,18679,3136,34065,2572,1282,1290
49840,38626,4558,18680,3136,34068,2572,1282,1290
49845,38627,4558,18680,3136,34069,2572,1282,1290
49850,38632,4559,18682,3137,34073,2573,1282,1291
49855,38634,4559,18683,3137,34075,2574,1282,1292
49860,38642,4561,18687,3138,34081,2575,1283,1292
49865,38645,4561,18687,3138,34084,2575,1283,1292
49870,38650,4561,18689,3138,34089,2575,1283,1292
49875,38654,4561,18692,3138,34092,2575,1283,1292
49880,38657,4562,18694,3139,34095,2575,1283,1292
49885,38658,4562,18695,3139,34096,2575,1283,1292
49890,38663,4563,18697,3140,34100,2576,1284,1292
49895,38665,4563,18697,3140,34102,2577,1284,1293
49900,38673,4565,18700,3141,34108,2577,1284,1293
49905,38676,4565,18702,3141,34111,2577,1284,1293
49910,38681,4565,18704,3141,34116,2577,1284,1293
49915,38685,4565,18705,3141,34120,2577,1284,1293
49920,38688,4565,18705,3141,34123,2577,1284,1293
49925,38689,4565,18705,3141,34124,2577,1284,1293
49930,38694,4566,18708,3141,34128,2577,1284,1293
49935,38696,4566,18709,3141,34130,2578,1285,1293
49940,38704,4567,18711,3142,34137,2579,1286,1293
49945,38707,4567,18712,3142,34140,2579,1286,1293
49950,38712,4567,18714,3142,34145,2579,1286,1293
49955,38716,4567,18716,3142,34148,2579,1286,1293
49960,38719,4568,18718,3143,34151,2579,1286,1293
49965,38720,4569,18719,3144,34151,2579,1286,1293
49970,38725,4570,18723,3145,34155,2579,1286,1293
49975,38727,4570,18724,3145,34157,2580,1287,1293
49980,38735,4573,18730,3148,34161,2582,1288,1294
49985,38738,4574,18731,3149,34164,2582,1288,1294
49990,38743,4575,18736,3150,34168,2582,1288,1294
49995,38747,4575,18738,3150,34172,2582,1288,1294
50000,38750,4575,18738,3150,34175,2582,1288,1294
50005,38751,4575,18738,3150,34176,2582,1288,1294
50010,38756,4576,18742,3151,34180,2582,1288,1294
50015,38758,4576,18744,3151,34182,2583,1289,1294
50020,38766,4576,18749,3151,34190,2583,1289,1294
50025,38769,4576,18751,3151,34193,2583,1289,1294
50030,38774,4577,18753,3151,34197,2583,1289,1294
50035,38778,4577,18755,3151,34201,2583,1289,1294
50040,38781,4577,18756,3151,34204,2583,1289,1294
50045,38782,4577,18756,3151,34205,2583,1289,1294
50050,38787,4578,18759,3151,34209,2584,1289,1295
50055,38789,4578,18759,3151,34211,2585,1289,1296
50060,38797,4579,18760,3151,34218,2587,1289,1298
50065,38800,4579,18761,3151,34221,2587,1289,1298
50070,38805,4580,18763,3152,34225,2587,1289,1298
50075,38809,4580,18765,3152,34229,2587,1289,1298
50080,38812,4581,18767,3153,34231,2587,1289,1298
50085,38813,4581,18767,3153,34232,2587,1289,1298
50090,38818,4582,18770,3154,34236,2587,1289,1298
50095,38820,4582,18771,3154,34238,2588,1290,1298
50100,38828,4583,18774,3154,34245,2590,1292,1298
50105,38831,4583,18777,3154,34248,2590,1292,1298
50110,38836,4583,18779,3154,34253,2590,1292,1298
50115,38840,4583,18783,3154,34256,2590,1292,1298
50120,38843,4584,18783,3155,34259,2590,1292,1298
50125,38844,4584,18783,3155,34260,2590,1292,1298
50130,38849,4585,18787,3155,34264,2590,1292,1298
50135,38851,4585,18788,3155,34266,2591,1293,1298
50140,38859,4586,18794,3156,34273,2591,1293,1298
50145,38862,4586,18795,3156,34276,2591,1293,1298
50150,38867,4586,18800,3156,34281,2591,1293,1298
50155,38871,4586,18803,3156,34284,2591,1293,1298
50160,38874,4587,18804,3157,34287,2591,1293,1298
50165,38875,4587,18805,3157,34288,2591,1293,1298
50170,38880,4588,18808,3157,34292,2591,1293,1298
50175,38882,4588,18809,3157,34294,2592,1293,1299
50180,38890,4590,18813,3158,34300,2592,1293,1299
50185,38893,4590,18815,3158,34303,2592,1293,1299
50190,38898,4590,18819,3158,34308,2592,1293,1299
50195,38902,4590,18821,3158,34311,2592,1293,1299
50200,38905,4591,18822,3159,34314,2592,1293,1299
50205,38906,4591,18822,3159,34315,2592,1293,1299
50210,38911,4592,18822,3159,34319,2592,1293,1299
50215,38913,4592,18822,3159,34321,2593,1293,1300
50220,38921,4594,18827,3161,34326,2595,1294,1301
50225,38924,4595,18828,3162,34329,2595,1294,1301
50230,38929,4596,18831,3163,34333,2595,1294,1301
50235,38933,4596,18834,3163,34336,2595,1294,1301
50240,38936,4597,18835,3164,34339,2595,1294,1301
50245,38937,4597,18835,3164,34340,2595,1294,1301
50250,38942,4598,18837,3165,34344,2595,1294,1301
50255,38944,4598,18839,3165,34346,2596,1295,1301
50260,38952,4599,18845,3166,34353,2597,1295,1302
50265,38955,4599,18846,3166,34356,2597,1295,1302
50270,38960,4600,18848,3167,34360,2597,1295,1302
50275,38964,4600,18850,3167,34363,2597,1295,1302
50280,38967,4601,18852,3168,34366,2597,1295,1302
50285,38968,4602,18853,3169,34366,2597,1295,1302
50290,38973,4603,18856,3169,34370,2597,1295,1302
50295,38975,4603,18856,3169,34372,2598,1295,1303
50300,38983,4604,18859,3169,34379,2599,1296,1303
50305,38986,4604,18860,3169,34382,2599,1296,1303
50310,38991,4604,18864,3169,34387,2599,1296,1303
50315,38995,4604,18867,3169,34391,2599,1296,1303
50320,38998,4604,18868,3169,34394,2599,1296,1303
50325,38999,4604,18868,3169,34395,2599,1296,1303
50330,39004,4605,18871,3170,34399,2599,1296,1303
50335,39006,4605,18871,3170,34401,2600,1296,1304
50340,39014,4606,18872,3170,34408,2601,1296,1305
50345,39017,4606,18875,3170,34411,2601,1296,1305
50350,39022,4606,18878,3170,34416,2601,1296,1305
50355,39026,4606,18880,3170,34420,2601,1296,1305
50360,39029,4606,18882,3170,34423,2601,1296,1305
50365,39030,4606,18883,3170,34424,2601,1296,1305
50370,39035,4606,18887,3170,34429,2601,1296,1305
50375,39037,4606,18888,3170,34431,2602,1296,1306
50380,39045,4609,18895,3173,34436,2603,1297,1306
50385,39048,4609,18896,3173,34439,2603,1297,1306
50390,39053,4610,18896,3173,34443,2603,1297,1306
50395,39057,4610,18899,3173,34446,2603,1297,1306
50400,39060,4612,18901,3175,34448,2603,1297,1306
50405,39061,4612,18901,3175,34449,2603,1297,1306
50410,39066,4612,18903,3175,34454,2604,1297,1307
50415,39068,4612,18904,3175,34456,2605,1298,1307
50420,39076,4612,18908,3175,34464,2605,1298,1307
50425,39079,4612,18910,3175,34467,2605,1298,1307
50430,39084,4612,18913,3175,34472,2605,1298,1307
50435,39088,4612,18914,3175,34476,2605,1298,1307
50440,39091,4612,18915,3175,34479,2605,1298,1307
50445,39092,4612,18916,3175,34480,2605,1298,1307
50450,39097,4613,18920,3176,34484,2605,1298,1307
50455,39099,4613,18920,3176,34486,2606,1298,1308
50460,39107,4613,18923,3176,34494,2606,1298,1308
50465,39110,4613,18924,3176,34497,2606,1298,1308
50470,39115,4613,18926,3176,34502,2606,1298,1308
50475,39119,4613,18929,3176,34505,2606,1298,1308
50480,39122,4614,18929,3177,34508,2606,1298,1308
50485,39123,4615,18930,3178,34508,2606,1298,1308
50490,39128,4616,18932,3178,34512,2606,1298,1308
50495,39130,4616,18933,3178,34514,2607,1298,1309
50500,39138,4616,18938,3178,34522,2607,1298,1309
50505,39141,4616,18939,3178,34525,2607,1298,1309
50510,39146,4617,18942,3179,34529,2607,1298,1309
50515,39150,4617,18942,3179,34533,2607,1298,1309
50520,39153,4617,18943,3179,34536,2607,1298,1309
50525,39154,4617,18944,3179,34537,2607,1298,1309
50530,39159,4618,18947,3180,34541,2607,1298,1309
50535,39161,4618,18948,3180,34543,2608,1299,1309
50540,39169,4620,18953,3182,34549,2609,1300,1309
50545,39172,4621,18954,3183,34551,2609,1300,1309
50550,39177,4622,18957,3183,34555,2609,1300,1309
50555,39181,4622,18960,3183,34559,2609,1300,1309
50560,39184,4622,18961,3183,34562,2609,1300,1309
50565,39185,4622,18962,3183,34563,2609,1300,1309
50570,39190,4623,18965,3183,34567,2609,1300,1309
50575,39192,4623,18966,3183,34569,2610,1300,1310
50580,39200,4626,18971,3185,34574,2612,1301,1311
50585,39203,4626,18973,3185,34577,2612,1301,1311
50590,39208,4626,18975,3185,34582,2612,1301,1311
50595,39212,4626,18977,3185,34586,2612,1301,1311
50600,39215,4626,18980,3185,34589,2612,1301,1311
50605,39216,4626,18981,3185,34590,2612,1301,1311
50610,39221,4627,18983,3185,34594,2612,1301,1311
50615,39223,4627,18984,3185,34596,2613,1302,1311
50620,39231,4627,18988,3185,34604,2613,1302,1311
50625,39234,4627,18989,3185,34607,2613,1302,1311
50630,39239,4627,18991,3185,34612,2613,1302,1311
50635,39243,4627,18993,3185,34616,2613,1302,1311
50640,39246,4627,18995,3185,34619,2613,1302,1311
50645,39247,4627,18995,3185,34620,2613,1302,1311
50650,39252,4628,18996,3185,34624,2614,1302,1312
50655,39254,4628,18996,3185,34626,2615,1302,1313
50660,39262,4628,19000,3185,34634,2615,1302,1313
50665,39265,4628,19000,3185,34637,2615,1302,1313
50670,39270,4629,19004,3186,34641,2615,1302,1313
50675,39274,4629,19006,3186,34644,2615,1302,1313
50680,39277,4630,19007,3187,34647,2615,1302,1313
50685,39278,4631,19008,3188,34647,2615,1302,1313
50690,39283,4632,19009,3188,34651,2615,1302,1313
50695,39285,4632,19010,3188,34653,2616,1303,1313
50700,39293,4635,19015,3191,34658,2618,1304,1314
50705,39296,4635,19018,3191,34661,2618,1304,1314
50710,39301,4635,19020,3191,34666,2618,1304,1314
50715,39305,4635,19022,3191,34670,2618,1304,1314
50720,39308,4635,19024,3191,34673,2618,1304,1314
50725,39309,4635,19024,3191,34674,2618,1304,1314
50730,39314,4636,19027,3192,34678,2618,1304,1314
50735,39316,4636,19029,3192,34680,2619,1305,1314
50740,39324,4638,19033,3193,34686,2619,1305,1314
50745,39327,4638,19035,3193,34689,2619,1305,1314
50750,39332,4638,19038,3193,34694,2619,1305,1314
50755,39336,4638,19040,3193,34698,2619,1305,1314
50760,39339,4638,19043,3193,34701,2619,1305,1314
50765,39340,4638,19043,3193,34702,2619,1305,1314
50770,39345,4639,19047,3194,34706,2619,1305,1314
50775,39347,4639,19049,3194,34708,2620,1306,1314
50780,39355,4640,19054,3194,34715,2620,1306,1314
50785,39358,4640,19057,3194,34718,2620,1306,1314
50790,39363,4640,19061,3194,34723,2620,1306,1314
50795,39367,4640,19063,3194,34727,2620,1306,1314
50800,39370,4640,19064,3194,34730,2620,1306,1314
50805,39371,4640,19064,3194,34731,2620,1306,1314
50810,39376,4641,19066,3195,34735,2620,1306,1314
50815,39378,4641,19066,3195,34737,2621,1306,1315
50820,39386,4644,19070,3198,34742,2623,1306,1317
50825,39389,4644,19072,3198,34745,2623,1306,1317
50830,39394,4645,19074,3199,34749,2623,1306,1317
50835,39398,4645,19075,3199,34752,2623,1306,1317
50840,39401,4646,19075,3200,34755,2623,1306,1317
50845,39402,4647,19076,3201,34755,2623,1306,1317
50850,39407,4648,19079,3202,34759,2623,1306,1317
50855,39409,4648,19080,3202,34761,2624,1307,1317
50860,39417,4648,19083,3202,34769,2624,1307,1317
50865,39420,4648,19085,3202,34772,2624,1307,1317
50870,39425,4649,19086,3202,34776,2624,1307,1317
50875,39429,4649,19089,3202,34779,2624,1307,1317
50880,39432,4650,19090,3203,34782,2624,1307,1317
50885,39433,4650,19091,3203,34783,2624,1307,1317
50890,39438,4651,19093,3203,34787,2625,1307,1318
50895,39440,4651,19094,3203,34789,2626,1308,1318
50900,39448,4651,19096,3203,34797,2626,1308,1318
50905,39451,4651,19098,3203,34800,2626,1308,1318
50910,39456,4652,19099,3204,34804,2626,1308,1318
50915,39460,4652,19100,3204,34808,2626,1308,1318
50920,39463,4653,19103,3205,34810,2626,1308,1318
50925,39464,4653,19104,3205,34811,2626,1308,1318
50930,39469,4654,19109,3206,34815,2627,1309,1318
50935,39471,4654,19110,3206,34817,2628,1309,1319
50940,39479,4657,19113,3208,34822,2630,1310,1320
50945,39482,4657,19114,3208,34825,2630,1310,1320
50950,39487,4657,19117,3208,34830,2630,1310,1320
50955,39491,4657,19118,3208,34834,2630,1310,1320
50960,39494,4657,19121,3208,34837,2630,1310,1320
50965,39495,4657,19122,3208,34838,2630,1310,1320
50970,39500,4658,19126,3209,34842,2631,1311,1320
50975,39502,4658,19127,3209,34844,2632,1311,1321
50980,39510,4658,19133,3209,34852,2632,1311,1321
50985,39513,4658,19134,3209,34855,2632,1311,1321
50990,39518,4658,19136,3209,34860,2632,1311,1321
50995,39522,4658,19139,3209,34863,2632,1311,1321
51000,39525,4659,19140,3210,34866,2632,1311,1321
51005,39526,4659,19140,3210,34867,2632,1311,1321
51010,39531,4660,19145,3211,34871,2632,1311,1321
51015,39533,4660,19146,3211,34873,2633,1312,1321
51020,39541,4660,19150,3211,34881,2633,1312,1321
51025,39544,4660,19151,3211,34884,2633,1312,1321
51030,39549,4660,19154,3211,34889,2633,1312,1321
51035,39553,4660,19157,3211,34893,2633,1312,1321
51040,39556,4660,19159,3211,34896,2633,1312,1321
51045,39557,4661,19160,3212,34896,2633,1312,1321
51050,39562,4662,19163,3213,34900,2633,1312,1321
51055,39564,4662,19163,3213,34902,2634,1312,1322
51060,39572,4665,19165,3215,34907,2636,1312,1324
51065,39575,4665,19166,3215,34910,2636,1312,1324
51070,39580,4666,19169,3215,34914,2636,1312,1324
51075,39584,4666,19169,3215,34918,2636,1312,1324
51080,39587,4667,19171,3216,34920,2636,1312,1324
51085,39588,4667,19171,3216,34921,2636,1312,1324
51090,39593,4667,19173,3216,34926,2636,1312,1324
51095,39595,4667,19174,3216,34928,2637,1312,1325
51100,39603,4668,19177,3216,34935,2637,1312,1325
51105,39606,4668,19179,3216,34938,2637,1312,1325
51110,39611,4669,19182,3217,34942,2637,1312,1325
51115,39615,4669,19184,3217,34945,2637,1312,1325
51120,39618,4671,19187,3219,34947,2637,1312,1325
51125,39619,4671,19188,3219,34948,2637,1312,1325
51130,39624,4671,19192,3219,34953,2638,1313,1325
51135,39626,4671,19192,3219,34955,2639,1313,1326
51140,39634,4672,19194,3219,34962,2639,1313,1326
51145,39637,4672,19196,3219,34965,2639,1313,1326
51150,39642,4672,19200,3219,34970,2639,1313,1326
51155,39646,4672,19203,3219,34974,2639,1313,1326
51160,39649,4672,19204,3219,34977,2639,1313,1326
51165,39650,4672,19204,3219,34978,2639,1313,1326
51170,39655,4673,19206,3219,34982,2640,1314,1326
51175,39657,4673,19207,3219,34984,2641,1314,1327
51180,39665,4675,19213,3221,34989,2643,1315,1328
51185,39668,4676,19214,3222,34992,2643,1315,1328
51190,39673,4676,19216,3222,34997,2643,1315,1328
51195,39677,4676,19217,3222,35001,2643,1315,1328
51200,39680,4676,19217,3222,35004,2643,1315,1328
51205,39681,4677,19218,3223,35004,2643,1315,1328
51210,39686,4678,19221,3223,35008,2644,1316,1328
51215,39688,4678,19223,3223,35010,2645,1317,1328
51220,39696,4678,19227,3223,35018,2645,1317,1328
51225,39699,4678,19228,3223,35021,2645,1317,1328
51230,39704,4679,19231,3223,35025,2645,1317,1328
51235,39708,4679,19233,3223,35029,2645,1317,1328
51240,39711,4680,19236,3224,35031,2645,1317,1328
51245,39712,4680,19236,3224,35032,2645,1317,1328
51250,39717,4681,19237,3224,35036,2645,1317,1328
51255,39719,4681,19239,3224,35038,2646,1318,1328
51260,39727,4682,19243,3225,35045,2646,1318,1328
51265,39730,4682,19245,3225,35048,2646,1318,1328
51270,39735,4683,19248,3225,35052,2646,1318,1328
51275,39739,4683,19251,3225,35056,2646,1318,1328
51280,39742,4684,19252,3226,35058,2646,1318,1328
51285,39743,4685,19253,3227,35058,2646,1318,1328
51290,39748,4686,19255,3227,35062,2646,1318,1328
51295,39750,4686,19255,3227,35064,2647,1318,1329
51300,39758,4687,19259,3227,35071,2649,1320,1329
51305,39761,4687,19259,3227,35074,2649,1320,1329
51310,39766,4687,19260,3227,35079,2649,1320,1329
51315,39770,4687,19262,3227,35083,2649,1320,1329
51320,39773,4687,19264,3227,35086,2649,1320,1329
51325,39774,4687,19264,3227,35087,2649,1320,1329
51330,39779,4687,19266,3227,35092,2650,1321,1329
51335,39781,4687,19266,3227,35094,2651,1321,1330
51340,39789,4689,19267,3228,35100,2652,1321,1331
51345,39792,4689,19268,3228,35103,2652,1321,1331
51350,39797,4689,19271,3228,35108,2652,1321,1331
51355,39801,4689,19273,3228,35112,2652,1321,1331
51360,39804,4689,19275,3228,35115,2652,1321,1331
51365,39805,4689,19275,3228,35116,2652,1321,1331
51370,39810,4689,19278,3228,35121,2653,1321,1332
51375,39812,4689,19278,3228,35123,2654,1321,1333
51380,39820,4691,19286,3230,35129,2654,1321,1333
51385,39823,4691,19286,3230,35132,2654,1321,1333
51390,39828,4691,19290,3230,35137,2654,1321,1333
51395,39832,4691,19294,3230,35141,2654,1321,1333
51400,39835,4691,19295,3230,35144,2654,1321,1333
51405,39836,4691,19296,3230,35145,2654,1321,1333
51410,39841,4692,19297,3231,35149,2655,1321,1334
51415,39843,4692,19298,3231,35151,2656,1322,1334
51420,39851,4694,19300,3232,35157,2657,1323,1334
51425,39854,4694,19302,3232,35160,2657,1323,1334
51430,39859,4695,19303,3233,35164,2657,1323,1334
51435,39863,4695,19306,3233,35167,2657,1323,1334
51440,39866,4697,19307,3235,35169,2657,1323,1334
51445,39867,4697,19307,3235,35170,2657,1323,1334
51450,39872,4698,19308,3235,35174,2657,1323,1334
51455,39874,4698,19308,3235,35176,2658,1323,1335
51460,39882,4698,19311,3235,35184,2658,1323,1335
51465,39885,4698,19313,3235,35187,2658,1323,1335
51470,39890,4699,19315,3235,35191,2658,1323,1335
51475,39894,4699,19318,3235,35195,2658,1323,1335
51480,39897,4700,19321,3236,35197,2658,1323,1335
51485,39898,4700,19322,3236,35198,2658,1323,1335
51490,39903,4701,19325,3237,35202,2658,1323,1335
51495,39905,4701,19325,3237,35204,2659,1323,1336
51500,39913,4701,19327,3237,35212,2659,1323,1336
51505,39916,4701,19329,3237,35215,2659,1323,1336
51510,39921,4701,19329,3237,35220,2659,1323,1336
51515,39925,4701,19331,3237,35223,2659,1323,1336
51520,39928,4702,19333,3238,35226,2659,1323,1336
51525,39929,4702,19333,3238,35227,2659,1323,1336
51530,39934,4703,19335,3238,35231,2659,1323,1336
51535,39936,4703,19335,3238,35233,2660,1323,1337
51540,39944,4705,19338,3240,35239,2661,1323,1338
51545,39947,4706,19340,3241,35241,2661,1323,1338
51550,39952,4706,19342,3241,35246,2661,1323,1338
51555,39956,4706,19342,3241,35250,2661,1323,1338
51560,39959,4706,19343,3241,35253,2661,1323,1338
51565,39960,4706,19343,3241,35254,2661,1323,1338
51570,39965,4707,19346,3242,35258,2662,1324,1338
51575,39967,4707,19346,3242,35260,2663,1324,1339
51580,39975,4708,19350,3243,35267,2664,1324,1340
51585,39978,4708,19351,3243,35270,2664,1324,1340
51590,39983,4708,19354,3243,35275,2664,1324,1340
51595,39987,4708,19354,3243,35279,2664,1324,1340
51600,39990,4708,19355,3243,35282,2664,1324,1340
51605,39991,4708,19355,3243,35283,2664,1324,1340
51610,39996,4708,19357,3243,35288,2664,1324,1340
51615,39998,4708,19357,3243,35290,2665,1324,1341
51620,40006,4709,19361,3244,35296,2666,1324,1342
51625,40009,4711,19363,3246,35298,2666,1324,1342
51630,40014,4713,19365,3247,35301,2666,1324,1342
51635,40018,4713,19368,3247,35305,2666,1324,1342
51640,40021,4713,19368,3247,35308,2666,1324,1342
51645,40022,4713,19368,3247,35309,2666,1324,1342
51650,40027,4713,19370,3247,35314,2666,1324,1342
51655,40029,4713,19371,3247,35316,2667,1324,1343
51660,40037,4714,19375,3247,35323,2668,1325,1343
51665,40040,4714,19378,3247,35326,2668,1325,1343
51670,40045,4715,19380,3247,35330,2668,1325,1343
51675,40049,4715,19383,3247,35334,2668,1325,1343
51680,40052,4716,19386,3248,35336,2668,1325,1343
51685,40053,4716,19387,3248,35337,2668,1325,1343
51690,40058,4716,19392,3248,35342,2668,1325,1343
51695,40060,4716,19394,3248,35344,2669,1326,1343
51700,40068,4717,19399,3249,35350,2669,1326,1343
51705,40071,4718,19401,3250,35353,2669,1326,1343
51710,40076,4719,19402,3250,35357,2669,1326,1343
51715,40080,4719,19404,3250,35361,2669,1326,1343
51720,40083,4720,19406,3251,35363,2669,1326,1343
51725,40084,4720,19406,3251,35364,2669,1326,1343
51730,40089,4721,19407,3251,35368,2670,1327,1343
51735,40091,4721,19407,3251,35370,2671,1327,1344
51740,40099,4721,19409,3251,35378,2671,1327,1344
51745,40102,4721,19410,3251,35381,2671,1327,1344
51750,40107,4721,19413,3251,35386,2671,1327,1344
51755,40111,4721,19414,3251,35389,2671,1327,1344
51760,40114,4722,19415,3252,35392,2671,1327,1344
51765,40115,4723,19416,3253,35392,2671,1327,1344
51770,40120,4724,19418,3253,35396,2672,1327,1345
51775,40122,4724,19420,3253,35398,2673,1328,1345
51780,40130,4724,19425,3253,35406,2674,1329,1345
51785,40133,4724,19428,3253,35409,2674,1329,1345
51790,40138,4724,19432,3253,35414,2674,1329,1345
51795,40142,4724,19432,3253,35418,2674,1329,1345
51800,40145,4724,19433,3253,35421,2674,1329,1345
51805,40146,4724,19433,3253,35422,2674,1329,1345
51810,40151,4725,19436,3254,35426,2674,1329,1345
51815,40153,4725,19436,3254,35428,2675,1329,1346
51820,40161,4725,19441,3254,35436,2675,1329,1346
51825,40164,4725,19442,3254,35439,2675,1329,1346
51830,40169,4726,19444,3255,35443,2675,1329,1346
51835,40173,4726,19445,3255,35447,2675,1329,1346
51840,40176,4726,19446,3255,35450,2675,1329,1346
51845,40177,4726,19446,3255,35451,2675,1329,1346
51850,40182,4727,19450,3255,35455,2675,1329,1346
51855,40184,4727,19451,3255,35457,2676,1329,1347
51860,40192,4729,19456,3257,35463,2676,1329,1347
51865,40195,4729,19456,3257,35466,2676,1329,1347
51870,40200,4730,19457,3257,35470,2676,1329,1347
51875,40204,4730,19458,3257,35473,2676,1329,1347
51880,40207,4732,19460,3259,35475,2676,1329,1347
51885,40208,4732,19460,3259,35476,2676,1329,1347
51890,40213,4733,19462,3259,35480,2676,1329,1347
51895,40215,4733,19462,3259,35482,2677,1329,1348
51900,40223,4735,19464,3260,35488,2678,1329,1349
51905,40226,4736,19467,3261,35490,2678,1329,1349
51910,40231,4737,19468,3261,35494,2678,1329,1349
51915,40235,4737,19470,3261,35498,2678,1329,1349
51920,40238,4737,19470,3261,35501,2678,1329,1349
51925,40239,4737,19471,3261,35502,2678,1329,1349
51930,40244,4737,19475,3261,35507,2679,1330,1349
51935,40246,4737,19476,3261,35509,2680,1331,1349
51940,40254,4737,19481,3261,35517,2681,1332,1349
51945,40257,4737,19482,3261,35520,2681,1332,1349
51950,40262,4738,19484,3262,35524,2681,1332,1349
51955,40266,4738,19487,3262,35528,2681,1332,1349
51960,40269,4738,19487,3262,35531,2681,1332,1349
51965,40270,4738,19487,3262,35532,2681,1332,1349
51970,40275,4738,19490,3262,35537,2681,1332,1349
51975,40277,4738,19490,3262,35539,2682,1332,1350
51980,40285,4739,19494,3263,35546,2682,1332,1350
51985,40288,4739,19495,3263,35549,2682,1332,1350
51990,40293,4740,19496,3263,35553,2682,1332,1350
51995,40297,4740,19497,3263,35557,2682,1332,1350
52000,40300,4741,19500,3264,35559,2682,1332,1350
52005,40301,4741,19501,3264,35560,2682,1332,1350
52010,40306,4742,19505,3265,35564,2682,1332,1350
52015,40308,4742,19506,3265,35566,2683,1333,1350
52020,40316,4744,19511,3266,35571,2683,1333,1350
52025,40319,4745,19512,3267,35574,2683,1333,1350
52030,40324,4746,19514,3267,35578,2683,1333,1350
52035,40328,4746,19516,3267,35582,2683,1333,1350
52040,40331,4746,19517,3267,35585,2683,1333,1350
52045,40332,4746,19517,3267,35586,2683,1333,1350
52050,40337,4747,19519,3267,35590,2684,1333,1351
52055,40339,4747,19520,3267,35592,2685,1333,1352
52060,40347,4749,19524,3268,35598,2685,1333,1352
52065,40350,4749,19527,3268,35601,2685,1333,1352
52070,40355,4750,19531,3269,35605,2685,1333,1352
52075,40359,4750,19533,3269,35609,2685,1333,1352
52080,40362,4751,19535,3270,35611,2685,1333,1352
52085,40363,4751,19535,3270,35612,2685,1333,1352
52090,40368,4752,19537,3270,35616,2686,1333,1353
52095,40370,4752,19537,3270,35618,2687,1333,1354
52100,40378,4752,19538,3270,35626,2687,1333,1354
52105,40381,4752,19538,3270,35629,2687,1333,1354
52110,40386,4752,19541,3270,35634,2687,1333,1354
52115,40390,4752,19543,3270,35638,2687,1333,1354
52120,40393,4752,19545,3270,35641,2687,1333,1354
52125,40394,4753,19546,3271,35641,2687,1333,1354
52130,40399,4754,19547,3271,35645,2688,1333,1355
52135,40401,4754,19549,3271,35647,2689,1334,1355
52140,40409,4754,19553,3271,35655,2689,1334,1355
52145,40412,4754,19554,3271,35658,2689,1334,1355
52150,40417,4754,19556,3271,35663,2689,1334,1355
52155,40421,4754,19556,3271,35667,2689,1334,1355
52160,40424,4754,19558,3271,35670,2689,1334,1355
52165,40425,4755,19559,3272,35670,2689,1334,1355
52170,40430,4756,19560,3272,35674,2689,1334,1355
52175,40432,4756,19561,3272,35676,2690,1334,1356
52180,40440,4756,19563,3272,35684,2690,1334,1356
52185,40443,4756,19564,3272,35687,2690,1334,1356
52190,40448,4757,19566,3273,35691,2690,1334,1356
52195,40452,4757,19568,3273,35695,2690,1334,1356
52200,40455,4758,19570,3274,35697,2690,1334,1356
52205,40456,4759,19571,3275,35697,2690,1334,1356
52210,40461,4760,19574,3276,35701,2690,1334,1356
52215,40463,4760,19575,3276,35703,2691,1334,1357
52220,40471,4763,19582,3278,35707,2691,1334,1357
52225,40474,4764,19583,3279,35710,2691,1334,1357
52230,40479,4764,19586,3279,35715,2691,1334,1357
52235,40483,4764,19587,3279,35719,2691,1334,1357
52240,40486,4764,19588,3279,35722,2691,1334,1357
52245,40487,4764,19589,3279,35723,2691,1334,1357
52250,40492,4765,19592,3280,35727,2691,1334,1357
52255,40494,4765,19593,3280,35729,2692,1334,1358
52260,40502,4767,19598,3281,35734,2692,1334,1358
52265,40505,4768,19598,3282,35737,2692,1334,1358
52270,40510,4768,19601,3282,35742,2692,1334,1358
52275,40514,4768,19602,3282,35746,2692,1334,1358
52280,40517,4768,19604,3282,35749,2692,1334,1358
52285,40518,4768,19604,3282,35750,2692,1334,1358
52290,40523,4768,19605,3282,35755,2693,1334,1359
52295,40525,4768,19606,3282,35757,2694,1335,1359
52300,40533,4768,19609,3282,35765,2694,1335,1359
52305,40536,4768,19610,3282,35768,2694,1335,1359
52310,40541,4769,19610,3282,35772,2694,1335,1359
52315,40545,4769,19611,3282,35776,2694,1335,1359
52320,40548,4769,19612,3282,35779,2694,1335,1359
52325,40549,4769,19613,3282,35780,2694,1335,1359
52330,40554,4769,19615,3282,35785,2694,1335,1359
52335,40556,4769,19615,3282,35787,2695,1335,1360
52340,40564,4769,19619,3282,35795,2695,1335,1360
52345,40567,4769,19621,3282,35798,2695,1335,1360
52350,40572,4770,19625,3283,35802,2695,1335,1360
52355,40576,4770,19626,3283,35806,2695,1335,1360
52360,40579,4771,19628,3284,35808,2695,1335,1360
52365,40580,4771,19629,3284,35809,2695,1335,1360
52370,40585,4772,19632,3285,35813,2695,1335,1360
52375,40587,4772,19632,3285,35815,2696,1335,1361
52380,40595,4773,19635,3286,35821,2696,1335,1361
52385,40598,4774,19637,3287,35824,2696,1335,1361
52390,40603,4775,19638,3288,35828,2696,1335,1361
52395,40607,4775,19641,3288,35832,2696,1335,1361
52400,40610,4776,19642,3289,35834,2696,1335,1361
52405,40611,4776,19642,3289,35835,2696,1335,1361
52410,40616,4777,19644,3290,35839,2696,1335,1361
52415,40618,4777,19646,3290,35841,2697,1336,1361
52420,40626,4778,19650,3291,35848,2697,1336,1361
52425,40629,4778,19653,3291,35851,2697,1336,1361
52430,40634,4779,19654,3291,35855,2697,1336,1361
52435,40638,4779,19654,3291,35859,2697,1336,1361
52440,40641,4779,19655,3291,35862,2697,1336,1361
52445,40642,4779,19656,3291,35863,2697,1336,1361
52450,40647,4780,19658,3291,35867,2697,1336,1361
52455,40649,4780,19659,3291,35869,2698,1337,1361
52460,40657,4782,19664,3292,35875,2698,1337,1361
52465,40660,4782,19664,3292,35878,2698,1337,1361
52470,40665,4783,19665,3292,35882,2698,1337,1361
52475,40669,4783,19667,3292,35886,2698,1337,1361
52480,40672,4783,19667,3292,35889,2698,1337,1361
52485,40673,4783,19667,3292,35890,2698,1337,1361
52490,40678,4784,19669,3293,35894,2698,1337,1361
52495,40680,4784,19670,3293,35896,2699,1337,1362
52500,40688,4785,19672,3293,35903,2699,1337,1362
52505,40691,4785,19674,3293,35906,2699,1337,1362
52510,40696,4786,19677,3294,35910,2699,1337,1362
52515,40700,4786,19678,3294,35914,2699,1337,1362
52520,40703,4786,19680,3294,35917,2699,1337,1362
52525,40704,4786,19680,3294,35918,2699,1337,1362
52530,40709,4787,19681,3294,35922,2699,1337,1362
52535,40711,4787,19681,3294,35924,2700,1337,1363
52540,40719,4788,19683,3294,35931,2700,1337,1363
52545,40722,4789,19686,3295,35933,2700,1337,1363
52550,40727,4790,19688,3296,35937,2700,1337,1363
52555,40731,4790,19691,3296,35941,2700,1337,1363
52560,40734,4790,19691,3296,35944,2700,1337,1363
52565,40735,4790,19691,3296,35945,2700,1337,1363
52570,40740,4791,19694,3296,35949,2700,1337,1363
52575,40742,4791,19696,3296,35951,2701,1338,1363
52580,40750,4793,19699,3297,35957,2701,1338,1363
52585,40753,4793,19699,3297,35960,2701,1338,1363
52590,40758,4793,19702,3297,35965,2701,1338,1363
52595,40762,4793,19704,3297,35969,2701,1338,1363
52600,40765,4793,19705,3297,35972,2701,1338,1363
52605,40766,4793,19705,3297,35973,2701,1338,1363
52610,40771,4794,19709,3297,35977,2701,1338,1363
52615,40773,4794,19711,3297,35979,2702,1339,1363
52620,40781,4796,19714,3299,35985,2702,1339,1363
52625,40784,4796,19716,3299,35988,2702,1339,1363
52630,40789,4796,19720,3299,35993,2702,1339,1363
52635,40793,4796,19724,3299,35996,2702,1339,1363
52640,40796,4797,19725,3300,35999,2702,1339,1363
52645,40797,4798,19726,3301,35999,2702,1339,1363
52650,40802,4799,19727,3302,36003,2703,1339,1364
52655,40804,4799,19729,3302,36005,2704,1340,1364
52660,40812,4800,19730,3302,36012,2704,1340,1364
52665,40815,4800,19732,3302,36015,2704,1340,1364
52670,40820,4801,19733,3302,36019,2704,1340,1364
52675,40824,4801,19734,3302,36022,2704,1340,1364
52680,40827,4803,19736,3304,36024,2704,1340,1364
52685,40828,4803,19737,3304,36025,2704,1340,1364
52690,40833,4804,19738,3304,36029,2704,1340,1364
52695,40835,4804,19739,3304,36031,2705,1340,1365
52700,40843,4805,19742,3304,36038,2705,1340,1365
52705,40846,4805,19745,3304,36041,2705,1340,1365
52710,40851,4806,19748,3305,36045,2705,1340,1365
52715,40855,4806,19751,3305,36048,2705,1340,1365
52720,40858,4807,19753,3306,36051,2705,1340,1365
52725,40859,4807,19754,3306,36052,2705,1340,1365
52730,40864,4808,19757,3306,36056,2705,1340,1365
52735,40866,4808,19757,3306,36058,2706,1340,1366
52740,40874,4810,19761,3307,36064,2706,1340,1366
52745,40877,4810,19763,3307,36067,2706,1340,1366
52750,40882,4810,19765,3307,36072,2706,1340,1366
52755,40886,4810,19767,3307,36076,2706,1340,1366
52760,40889,4810,19768,3307,36079,2706,1340,1366
52765,40890,4810,19769,3307,36080,2706,1340,1366
52770,40895,4810,19772,3307,36085,2706,1340,1366
52775,40897,4810,19773,3307,36087,2707,1341,1366
52780,40905,4810,19776,3307,36095,2707,1341,1366
52785,40908,4810,19778,3307,36098,2707,1341,1366
52790,40913,4810,19781,3307,36103,2707,1341,1366
52795,40917,4810,19783,3307,36107,2707,1341,1366
52800,40920,4810,19784,3307,36110,2707,1341,1366
52805,40921,4811,19785,3308,36110,2707,1341,1366
52810,40926,4812,19788,3308,36114,2708,1342,1366
52815,40928,4812,19789,3308,36116,2709,1343,1366
52820,40936,4812,19792,3308,36124,2709,1343,1366
52825,40939,4812,19795,3308,36127,2709,1343,1366
52830,40944,4812,19799,3308,36132,2709,1343,1366
52835,40948,4812,19801,3308,36136,2709,1343,1366
52840,40951,4812,19802,3308,36139,2709,1343,1366
52845,40952,4812,19802,3308,36140,2709,1343,1366
52850,40957,4813,19804,3309,36144,2710,1343,1367
52855,40959,4813,19804,3309,36146,2711,1343,1368
52860,40967,4815,19807,3310,36152,2711,1343,1368
52865,40970,4815,19808,3310,36155,2711,1343,1368
52870,40975,4816,19811,3311,36159,2711,1343,1368
52875,40979,4816,19812,3311,36163,2711,1343,1368
52880,40982,4816,19812,3311,36166,2711,1343,1368
52885,40983,4816,19813,3311,36167,2711,1343,1368
52890,40988,4817,19816,3311,36171,2711,1343,1368
52895,40990,4817,19818,3311,36173,2712,1344,1368
52900,40998,4819,19822,3312,36179,2712,1344,1368
52905,41001,4819,19823,3312,36182,2712,1344,1368
52910,41006,4820,19827,3313,36186,2712,1344,1368
52915,41010,4820,19829,3313,36190,2712,1344,1368
52920,41013,4820,19829,3313,36193,2712,1344,1368
52925,41014,4820,19830,3313,36194,2712,1344,1368
52930,41019,4821,19831,3313,36198,2712,1344,1368
52935,41021,4821,19833,3313,36200,2713,1345,1368
52940,41029,4823,19839,3315,36206,2713,1345,1368
52945,41032,4824,19841,3316,36208,2713,1345,1368
52950,41037,4825,19846,3317,36212,2713,1345,1368
52955,41041,4825,19847,3317,36216,2713,1345,1368
52960,41044,4826,19849,3318,36218,2713,1345,1368
52965,41045,4826,19850,3318,36219,2713,1345,1368
52970,41050,4827,19853,3319,36223,2713,1345,1368
52975,41052,4827,19854,3319,36225,2714,1345,1369
52980,41060,4829,19859,3321,36231,2714,1345,1369
52985,41063,4829,19862,3321,36234,2714,1345,1369
52990,41068,4829,19864,3321,36239,2714,1345,1369
52995,41072,4829,19865,3321,36242,2714,1345,1369
53000,41075,4830,19868,3322,36245,2714,1345,1369
53005,41076,4830,19868,3322,36246,2714,1345,1369
53010,41081,4831,19871,3323,36250,2714,1345,1369
53015,41083,4831,19872,3323,36252,2715,1345,1370
53020,41091,4831,19877,3323,36260,2715,1345,1370
53025,41094,4831,19879,3323,36263,2715,1345,1370
53030,41099,4831,19881,3323,36268,2715,1345,1370
53035,41103,4831,19882,3323,36272,2715,1345,1370
53040,41106,4831,19883,3323,36275,2715,1345,1370
53045,41107,4831,19884,3323,36276,2715,1345,1370
53050,41112,4832,19887,3324,36280,2715,1345,1370
53055,41114,4832,19889,3324,36282,2716,1346,1370
53060,41122,4832,19894,3324,36290,2716,1346,1370
53065,41125,4832,19896,3324,36293,2716,1346,1370
53070,41130,4832,19899,3324,36298,2716,1346,1370
53075,41134,4832,19901,3324,36301,2716,1346,1370
53080,41137,4833,19902,3325,36304,2716,1346,1370
53085,41138,4833,19902,3325,36305,2716,1346,1370
53090,41143,4834,19906,3326,36309,2716,1346,1370
53095,41145,4834,19908,3326,36311,2717,1347,1370
53100,41153,4837,19911,3328,36316,2717,1347,1370
53105,41156,4837,19912,3328,36319,2717,1347,1370
53110,41161,4838,19915,3329,36323,2717,1347,1370
53115,41165,4838,19917,3329,36327,2717,1347,1370
53120,41168,4838,19919,3329,36330,2717,1347,1370
53125,41169,4838,19919,3329,36331,2717,1347,1370
53130,41174,4839,19924,3330,36335,2718,1348,1370
53135,41176,4839,19925,3330,36337,2719,1349,1370
53140,41184,4841,19932,3332,36343,2719,1349,1370
53145,41187,4841,19934,3332,36346,2719,1349,1370
53150,41192,4842,19938,3333,36350,2719,1349,1370
53155,41196,4842,19941,3333,36354,2719,1349,1370
53160,41199,4843,19943,3334,36356,2719,1349,1370
53165,41200,4843,19943,3334,36357,2719,1349,1370
53170,41205,4844,19945,3335,36361,2719,1349,1370
53175,41207,4844,19946,3335,36363,2720,1350,1370
53180,41215,4845,19948,3335,36370,2720,1350,1370
53185,41218,4845,19950,3335,36373,2720,1350,1370
53190,41223,4846,19954,3336,36377,2720,1350,1370
53195,41227,4846,19954,3336,36381,2720,1350,1370
53200,41230,4847,19957,3337,36383,2720,1350,1370
53205,41231,4848,19958,3338,36383,2720,1350,1370
53210,41236,4849,19961,3339,36387,2720,1350,1370
53215,41238,4849,19961,3339,36389,2721,1350,1371
53220,41246,4850,19963,3340,36396,2721,1350,1371
53225,41249,4851,19964,3341,36398,2721,1350,1371
53230,41254,4852,19967,3341,36402,2721,1350,1371
53235,41258,4852,19968,3341,36406,2721,1350,1371
53240,41261,4853,19971,3342,36408,2721,1350,1371
53245,41262,4853,19972,3342,36409,2721,1350,1371
53250,41267,4853,19973,3342,36414,2721,1350,1371
53255,41269,4853,19974,3342,36416,2722,1351,1371
53260,41277,4854,19979,3343,36423,2722,1351,1371
53265,41280,4854,19980,3343,36426,2722,1351,1371
53270,41285,4855,19982,3344,36430,2722,1351,1371
53275,41289,4855,19985,3344,36433,2722,1351,1371
53280,41292,4857,19988,3346,36435,2722,1351,1371
53285,41293,4857,19988,3346,36436,2722,1351,1371
53290,41298,4857,19989,3346,36441,2722,1351,1371
53295,41300,4857,19990,3346,36443,2723,1351,1372
53300,41308,4858,19993,3346,36450,2723,1351,1372
53305,41311,4858,19994,3346,36453,2723,1351,1372
53310,41316,4858,19996,3346,36458,2723,1351,1372
53315,41320,4858,19998,3346,36462,2723,1351,1372
53320,41323,4858,19998,3346,36465,2723,1351,1372
53325,41324,4858,19998,3346,36466,2723,1351,1372
53330,41329,4858,20001,3346,36471,2724,1351,1373
53335,41331,4858,20003,3346,36473,2725,1352,1373
53340,41339,4860,20009,3348,36479,2725,1352,1373
53345,41342,4860,20010,3348,36482,2725,1352,1373
53350,41347,4860,20014,3348,36487,2725,1352,1373
53355,41351,4860,20015,3348,36491,2725,1352,1373
53360,41354,4860,20016,3348,36494,2725,1352,1373
53365,41355,4860,20017,3348,36495,2725,1352,1373
53370,41360,4860,20019,3348,36500,2725,1352,1373
53375,41362,4860,20020,3348,36502,2726,1353,1373
53380,41370,4861,20024,3349,36509,2726,1353,1373
53385,41373,4861,20025,3349,36512,2726,1353,1373
53390,41378,4861,20027,3349,36517,2726,1353,1373
53395,41382,4861,20031,3349,36520,2726,1353,1373
53400,41385,4862,20032,3350,36523,2726,1353,1373
53405,41386,4862,20032,3350,36524,2726,1353,1373
53410,41391,4863,20034,3350,36528,2726,1353,1373
53415,41393,4863,20035,3350,36530,2727,1353,1374
53420,41401,4864,20036,3350,36537,2727,1353,1374
53425,41404,4864,20037,3350,36540,2727,1353,1374
53430,41409,4865,20038,3350,36544,2727,1353,1374
53435,41413,4865,20040,3350,36548,2727,1353,1374
53440,41416,4865,20041,3350,36551,2727,1353,1374
53445,41417,4865,20041,3350,36552,2727,1353,1374
53450,41422,4866,20045,3351,36556,2727,1353,1374
53455,41424,4866,20046,3351,36558,2728,1354,1374
53460,41432,4868,20048,3352,36564,2728,1354,1374
53465,41435,4868,20050,3352,36567,2728,1354,1374
53470,41440,4869,20051,3352,36571,2728,1354,1374
53475,41444,4869,20052,3352,36575,2728,1354,1374
53480,41447,4869,20053,3352,36578,2728,1354,1374
53485,41448,4870,20054,3353,36578,2728,1354,1374
53490,41453,4871,20056,3354,36582,2728,1354,1374
53495,41455,4871,20056,3354,36584,2729,1354,1375
53500,41463,4872,20058,3355,36591,2729,1354,1375
53505,41466,4872,20058,3355,36594,2729,1354,1375
53510,41471,4874,20060,3357,36597,2729,1354,1375
53515,41475,4874,20061,3357,36600,2729,1354,1375
53520,41478,4875,20061,3358,36603,2729,1354,1375
53525,41479,4875,20062,3358,36604,2729,1354,1375
53530,41484,4876,20065,3359,36608,2730,1354,1376
53535,41486,4876,20065,3359,36610,2731,1354,1377
53540,41494,4877,20067,3360,36617,2731,1354,1377
53545,41497,4877,20069,3360,36620,2731,1354,1377
53550,41502,4878,20072,3361,36624,2731,1354,1377
53555,41506,4878,20075,3361,36627,2731,1354,1377
53560,41509,4879,20076,3362,36630,2731,1354,1377
53565,41510,4879,20076,3362,36631,2731,1354,1377
53570,41515,4880,20078,3363,36635,2732,1355,1377
53575,41517,4880,20080,3363,36637,2733,1356,1377
53580,41525,4881,20084,3364,36644,2733,1356,1377
53585,41528,4881,20085,3364,36647,2733,1356,1377
53590,41533,4881,20089,3364,36652,2733,1356,1377
53595,41537,4881,20091,3364,36655,2733,1356,1377
53600,41540,4882,20092,3365,36658,2733,1356,1377
53605,41541,4882,20092,3365,36659,2733,1356,1377
53610,41546,4883,20095,3365,36663,2733,1356,1377
53615,41548,4883,20095,3365,36665,2734,1356,1378
53620,41556,4883,20099,3365,36673,2734,1356,1378
53625,41559,4883,20101,3365,36676,2734,1356,1378
53630,41564,4883,20105,3365,36681,2734,1356,1378
53635,41568,4883,20106,3365,36685,2734,1356,1378
53640,41571,4883,20108,3365,36688,2734,1356,1378
53645,41572,4883,20108,3365,36689,2734,1356,1378
53650,41577,4884,20110,3365,36693,2734,1356,1378
53655,41579,4884,20110,3365,36695,2735,1356,1379
53660,41587,4886,20116,3367,36701,2735,1356,1379
53665,41590,4886,20119,3367,36704,2735,1356,1379
53670,41595,4886,20122,3367,36709,2735,1356,1379
53675,41599,4886,20125,3367,36712,2735,1356,1379
53680,41602,4887,20128,3368,36715,2735,1356,1379
53685,41603,4887,20128,3368,36716,2735,1356,1379
53690,41608,4888,20132,3369,36720,2735,1356,1379
53695,41610,4888,20133,3369,36722,2736,1357,1379
53700,41618,4890,20137,3370,36728,2736,1357,1379
53705,41621,4890,20139,3370,36731,2736,1357,1379
53710,41626,4891,20142,3370,36735,2736,1357,1379
53715,41630,4891,20143,3370,36739,2736,1357,1379
53720,41633,4892,20144,3371,36741,2736,1357,1379
53725,41634,4892,20144,3371,36742,2736,1357,1379
53730,41639,4893,20147,3371,36746,2737,1358,1379
53735,41641,4893,20149,3371,36748,2738,1359,1379
53740,41649,4894,20151,3372,36755,2738,1359,1379
53745,41652,4894,20153,3372,36758,2738,1359,1379
53750,41657,4895,20154,3373,36762,2738,1359,1379
53755,41661,4895,20156,3373,36766,2738,1359,1379
53760,41664,4896,20158,3374,36768,2738,1359,1379
53765,41665,4896,20158,3374,36769,2738,1359,1379
53770,41670,4897,20160,3374,36773,2739,1360,1379
53775,41672,4897,20161,3374,36775,2740,1361,1379
53780,41680,4898,20167,3375,36782,2740,1361,1379
53785,41683,4898,20168,3375,36785,2740,1361,1379
53790,41688,4899,20171,3376,36789,2740,1361,1379
53795,41692,4899,20173,3376,36793,2740,1361,1379
53800,41695,4899,20174,3376,36796,2740,1361,1379
53805,41696,4899,20174,3376,36797,2740,1361,1379
53810,41701,4900,20177,3376,36801,2741,1362,1379
53815,41703,4900,20178,3376,36803,2742,1363,1379
53820,41711,4903,20184,3379,36808,2742,1363,1379
53825,41714,4903,20186,3379,36811,2742,1363,1379
53830,41719,4903,20188,3379,36816,2742,1363,1379
53835,41723,4903,20190,3379,36820,2742,1363,1379
53840,41726,4903,20192,3379,36823,2742,1363,1379
53845,41727,4904,20193,3380,36823,2742,1363,1379
53850,41732,4905,20196,3381,36827,2742,1363,1379
53855,41734,4905,20197,3381,36829,2743,1363,1380
53860,41742,4906,20202,3382,36836,2743,1363,1380
53865,41745,4906,20203,3382,36839,2743,1363,1380
53870,41750,4906,20206,3382,36844,2743,1363,1380
53875,41754,4906,20208,3382,36848,2743,1363,1380
53880,41757,4906,20209,3382,36851,2743,1363,1380
53885,41758,4907,20210,3383,36851,2743,1363,1380
53890,41763,4908,20213,3384,36855,2743,1363,1380
53895,41765,4908,20215,3384,36857,2744,1364,1380
53900,41773,4909,20218,3385,36864,2744,1364,1380
53905,41776,4909,20219,3385,36867,2744,1364,1380
53910,41781,4909,20221,3385,36872,2744,1364,1380
53915,41785,4909,20222,3385,36876,2744,1364,1380
53920,41788,4909,20224,3385,36879,2744,1364,1380
53925,41789,4910,20225,3386,36879,2744,1364,1380
53930,41794,4911,20226,3386,36883,2745,1364,1381
53935,41796,4911,20226,3386,36885,2746,1364,1382
53940,41804,4912,20228,3386,36892,2746,1364,1382
53945,41807,4912,20231,3386,36895,2746,1364,1382
53950,41812,4913,20234,3386,36899,2746,1364,1382
53955,41816,4913,20235,3386,36903,2746,1364,1382
53960,41819,4913,20236,3386,36906,2746,1364,1382
53965,41820,4913,20236,3386,36907,2746,1364,1382
53970,41825,4914,20238,3386,36911,2747,1364,1383
53975,41827,4914,20239,3386,36913,2748,1365,1383
53980,41835,4915,20243,3387,36920,2748,1365,1383
53985,41838,4915,20245,3387,36923,2748,1365,1383
53990,41843,4916,20248,3387,36927,2748,1365,1383
53995,41847,4916,20250,3387,36931,2748,1365,1383
54000,41850,4916,20251,3387,36934,2748,1365,1383
54005,41851,4916,20252,3387,36935,2748,1365,1383
54010,41856,4917,20254,3387,36939,2748,1365,1383
54015,41858,4917,20255,3387,36941,2749,1365,1384
54020,41866,4919,20259,3388,36947,2749,1365,1384
54025,41869,4919,20260,3388,36950,2749,1365,1384
54030,41874,4920,20263,3388,36954,2749,1365,1384
54035,41878,4920,20265,3388,36958,2749,1365,1384
54040,41881,4920,20265,3388,36961,2749,1365,1384
54045,41882,4920,20266,3388,36962,2749,1365,1384
54050,41887,4921,20268,3388,36966,2749,1365,1384
54055,41889,4921,20269,3388,36968,2750,1365,1385
54060,41897,4923,20274,3390,36974,2750,1365,1385
54065,41900,4923,20275,3390,36977,2750,1365,1385
54070,41905,4923,20276,3390,36982,2750,1365,1385
54075,41909,4923,20278,3390,36986,2750,1365,1385
54080,41912,4923,20281,3390,36989,2750,1365,1385
54085,41913,4923,20281,3390,36990,2750,1365,1385
54090,41918,4924,20284,3390,36994,2750,1365,1385
54095,41920,4924,20285,3390,36996,2751,1366,1385
54100,41928,4924,20289,3390,37004,2751,1366,1385
54105,41931,4924,20290,3390,37007,2751,1366,1385
54110,41936,4924,20291,3390,37012,2751,1366,1385
54115,41940,4924,20294,3390,37016,2751,1366,1385
54120,41943,4924,20295,3390,37019,2751,1366,1385
54125,41944,4925,20296,3391,37019,2751,1366,1385
54130,41949,4926,20298,3391,37023,2751,1366,1385
54135,41951,4926,20298,3391,37025,2752,1366,1386
54140,41959,4926,20301,3391,37033,2752,1366,1386
54145,41962,4926,20301,3391,37036,2752,1366,1386
54150,41967,4926,20303,3391,37041,2752,1366,1386
54155,41971,4926,20304,3391,37045,2752,1366,1386
54160,41974,4926,20307,3391,37048,2752,1366,1386
54165,41975,4926,20307,3391,37049,2752,1366,1386
54170,41980,4927,20310,3391,37053,2753,1367,1386
54175,41982,4927,20311,3391,37055,2754,1367,1387
54180,41990,4929,20316,3392,37061,2754,1367,1387
54185,41993,4929,20317,3392,37064,2754,1367,1387
54190,41998,4930,20321,3393,37068,2754,1367,1387
54195,42002,4930,20322,3393,37072,2754,1367,1387
54200,42005,4930,20324,3393,37075,2754,1367,1387
54205,42006,4930,20325,3393,37076,2754,1367,1387
54210,42011,4931,20327,3393,37080,2754,1367,1387
54215,42013,4931,20328,3393,37082,2755,1367,1388
54220,42021,4932,20330,3393,37089,2755,1367,1388
54225,42024,4932,20332,3393,37092,2755,1367,1388
54230,42029,4933,20333,3393,37096,2755,1367,1388
54235,42033,4933,20335,3393,37099,2755,1367,1388
54240,42036,4935,20336,3395,37101,2755,1367,1388
54245,42037,4935,20336,3395,37102,2755,1367,1388
54250,42042,4936,20339,3395,37106,2755,1367,1388
54255,42044,4936,20340,3395,37108,2756,1368,1388
54260,42052,4937,20343,3395,37115,2756,1368,1388
54265,42055,4937,20344,3395,37118,2756,1368,1388
54270,42060,4937,20346,3395,37123,2756,1368,1388
54275,42064,4937,20349,3395,37126,2756,1368,1388
54280,42067,4938,20352,3396,37129,2756,1368,1388
54285,42068,4938,20353,3396,37130,2756,1368,1388
54290,42073,4939,20355,3396,37134,2757,1368,1389
54295,42075,4939,20356,3396,37136,2758,1368,1390
54300,42083,4941,20358,3398,37142,2758,1368,1390
54305,42086,4941,20359,3398,37145,2758,1368,1390
54310,42091,4941,20361,3398,37150,2758,1368,1390
54315,42095,4941,20363,3398,37154,2758,1368,1390
54320,42098,4941,20364,3398,37157,2758,1368,1390
54325,42099,4941,20364,3398,37158,2758,1368,1390
54330,42104,4942,20367,3398,37162,2758,1368,1390
54335,42106,4942,20368,3398,37164,2759,1368,1391
54340,42114,4943,20372,3399,37171,2759,1368,1391
54345,42117,4944,20373,3400,37173,2759,1368,1391
54350,42122,4945,20376,3400,37177,2759,1368,1391
54355,42126,4945,20377,3400,37181,2759,1368,1391
54360,42129,4945,20378,3400,37184,2759,1368,1391
54365,42130,4945,20378,3400,37185,2759,1368,1391
54370,42135,4946,20382,3401,37189,2759,1368,1391
54375,42137,4946,20383,3401,37191,2760,1369,1391
54380,42145,4948,20387,3402,37197,2760,1369,1391
54385,42148,4948,20387,3402,37200,2760,1369,1391
54390,42153,4949,20390,3402,37204,2760,1369,1391
54395,42157,4949,20392,3402,37207,2760,1369,1391
54400,42160,4950,20394,3403,37210,2760,1369,1391
54405,42161,4950,20394,3403,37211,2760,1369,1391
54410,42166,4951,20396,3403,37215,2761,1370,1391
54415,42168,4951,20397,3403,37217,2762,1371,1391
54420,42176,4953,20402,3404,37223,2762,1371,1391
54425,42179,4953,20405,3404,37226,2762,1371,1391
54430,42184,4954,20408,3405,37230,2762,1371,1391
54435,42188,4954,20411,3405,37233,2762,1371,1391
54440,42191,4956,20414,3407,37235,2762,1371,1391
54445,42192,4956,20414,3407,37236,2762,1371,1391
54450,42197,4956,20416,3407,37241,2762,1371,1391
54455,42199,4956,20417,3407,37243,2763,1371,1392
54460,42207,4956,20420,3407,37251,2763,1371,1392
54465,42210,4956,20423,3407,37254,2763,1371,1392
54470,42215,4957,20427,3408,37258,2763,1371,1392
54475,42219,4957,20429,3408,37261,2763,1371,1392
54480,42222,4959,20431,3410,37263,2763,1371,1392
54485,42223,4959,20432,3410,37264,2763,1371,1392
54490,42228,4959,20433,3410,37269,2764,1371,1393
54495,42230,4959,20435,3410,37271,2765,1372,1393
54500,42238,4959,20440,3410,37279,2765,1372,1393
54505,42241,4959,20442,3410,37282,2765,1372,1393
54510,42246,4959,20445,3410,37287,2765,1372,1393
54515,42250,4959,20446,3410,37291,2765,1372,1393
54520,42253,4959,20447,3410,37294,2765,1372,1393
54525,42254,4959,20448,3410,37295,2765,1372,1393
54530,42259,4960,20450,3410,37299,2766,1373,1393
54535,42261,4960,20450,3410,37301,2767,1373,1394
54540,42269,4962,20452,3411,37307,2767,1373,1394
54545,42272,4963,20455,3412,37309,2767,1373,1394
54550,42277,4963,20458,3412,37314,2767,1373,1394
54555,42281,4963,20461,3412,37318,2767,1373,1394
54560,42284,4963,20461,3412,37321,2767,1373,1394
54565,42285,4963,20462,3412,37322,2767,1373,1394
54570,42290,4964,20465,3412,37326,2768,1374,1394
54575,42292,4964,20466,3412,37328,2769,1375,1394
54580,42300,4966,20470,3413,37334,2769,1375,1394
54585,42303,4966,20471,3413,37337,2769,1375,1394
54590,42308,4967,20471,3413,37341,2769,1375,1394
54595,42312,4967,20474,3413,37345,2769,1375,1394
54600,42315,4967,20475,3413,37348,2769,1375,1394
54605,42316,4968,20476,3414,37348,2769,1375,1394
54610,42321,4969,20478,3414,37352,2770,1376,1394
54615,42323,4969,20479,3414,37354,2771,1377,1394
54620,42331,4970,20484,3415,37361,2771,1377,1394
54625,42334,4970,20486,3415,37364,2771,1377,1394
54630,42339,4971,20489,3415,37368,2771,1377,1394
54635,42343,4971,20492,3415,37371,2771,1377,1394
54640,42346,4972,20493,3416,37374,2771,1377,1394
54645,42347,4972,20493,3416,37375,2771,1377,1394
54650,42352,4973,20495,3417,37379,2771,1377,1394
54655,42354,4973,20496,3417,37381,2772,1377,1395
54660,42362,4975,20499,3419,37387,2772,1377,1395
54665,42365,4975,20500,3419,37390,2772,1377,1395
54670,42370,4976,20503,3419,37394,2772,1377,1395
54675,42374,4976,20504,3419,37397,2772,1377,1395
54680,42377,4978,20505,3421,37399,2772,1377,1395
54685,42378,4979,20506,3422,37399,2772,1377,1395
54690,42383,4980,20508,3422,37403,2772,1377,1395
54695,42385,4980,20509,3422,37405,2773,1378,1395
54700,42393,4981,20512,3423,37412,2773,1378,1395
54705,42396,4981,20512,3423,37415,2773,1378,1395
54710,42401,4982,20515,3423,37419,2773,1378,1395
54715,42405,4982,20517,3423,37423,2773,1378,1395
54720,42408,4983,20519,3424,37425,2773,1378,1395
54725,42409,4983,20520,3424,37426,2773,1378,1395
54730,42414,4983,20522,3424,37431,2774,1378,1396
54735,42416,4983,20523,3424,37433,2775,1378,1397
54740,42424,4984,20527,3425,37440,2775,1378,1397
54745,42427,4984,20527,3425,37443,2775,1378,1397
54750,42432,4985,20530,3426,37447,2775,1378,1397
54755,42436,4985,20530,3426,37451,2775,1378,1397
54760,42439,4985,20531,3426,37454,2775,1378,1397
54765,42440,4985,20531,3426,37455,2775,1378,1397
54770,42445,4985,20534,3426,37460,2775,1378,1397
54775,42447,4985,20536,3426,37462,2776,1379,1397
54780,42455,4988,20543,3429,37467,2776,1379,1397
54785,42458,4988,20544,3429,37470,2776,1379,1397
54790,42463,4989,20545,3429,37474,2776,1379,1397
54795,42467,4989,20548,3429,37478,2776,1379,1397
54800,42470,4990,20551,3430,37480,2776,1379,1397
54805,42471,4990,20551,3430,37481,2776,1379,1397
54810,42476,4990,20553,3430,37486,2776,1379,1397
54815,42478,4990,20554,3430,37488,2777,1380,1397
54820,42486,4992,20556,3431,37494,2777,1380,1397
54825,42489,4992,20557,3431,37497,2777,1380,1397
54830,42494,4993,20559,3431,37501,2777,1380,1397
54835,42498,4993,20561,3431,37504,2777,1380,1397
54840,42501,4994,20563,3432,37507,2777,1380,1397
54845,42502,4995,20564,3433,37507,2777,1380,1397
54850,42507,4996,20566,3433,37511,2778,1380,1398
54855,42509,4996,20566,3433,37513,2779,1380,1399
54860,42517,4997,20570,3434,37520,2779,1380,1399
54865,42520,4997,20572,3434,37523,2779,1380,1399
54870,42525,4997,20574,3434,37528,2779,1380,1399
54875,42529,4997,20577,3434,37531,2779,1380,1399
54880,42532,4998,20580,3435,37534,2779,1380,1399
54885,42533,4998,20580,3435,37535,2779,1380,1399
54890,42538,4999,20584,3436,37539,2779,1380,1399
54895,42540,4999,20584,3436,37541,2780,1380,1400
54900,42548,4999,20589,3436,37549,2780,1380,1400
54905,42551,4999,20590,3436,37552,2780,1380,1400
54910,42556,4999,20594,3436,37557,2780,1380,1400
54915,42560,4999,20594,3436,37561,2780,1380,1400
54920,42563,4999,20595,3436,37564,2780,1380,1400
54925,42564,4999,20595,3436,37565,2780,1380,1400
54930,42569,4999,20598,3436,37570,2780,1380,1400
54935,42571,4999,20599,3436,37572,2781,1380,1401
54940,42579,4999,20605,3436,37580,2781,1380,1401
54945,42582,4999,20607,3436,37583,2781,1380,1401
54950,42587,5000,20610,3436,37587,2781,1380,1401
54955,42591,5000,20612,3436,37591,2781,1380,1401
54960,42594,5001,20615,3437,37593,2781,1380,1401
54965,42595,5001,20615,3437,37594,2781,1380,1401
54970,42600,5001,20619,3437,37599,2782,1380,1402
54975,42602,5001,20620,3437,37601,2783,1380,1403
54980,42610,5002,20620,3437,37608,2783,1380,1403
54985,42613,5002,20620,3437,37611,2783,1380,1403
54990,42618,5003,20622,3437,37615,2783,1380,1403
54995,42622,5003,20623,3437,37619,2783,1380,1403
55000,42625,5003,20623,3437,37622,2783,1380,1403
55005,42626,5003,20624,3437,37623,2783,1380,1403
55010,42631,5004,20625,3437,37627,2784,1380,1404
55015,42633,5004,20625,3437,37629,2785,1380,1405
55020,42641,5005,20632,3438,37636,2785,1380,1405
55025,42644,5006,20635,3439,37638,2785,1380,1405
55030,42649,5007,20635,3439,37642,2785,1380,1405
55035,42653,5007,20637,3439,37646,2785,1380,1405
55040,42656,5008,20639,3440,37648,2785,1380,1405
55045,42657,5009,20640,3441,37648,2785,1380,1405
55050,42662,5010,20644,3441,37652,2786,1381,1405
55055,42664,5010,20645,3441,37654,2787,1382,1405
55060,42672,5011,20649,3441,37661,2787,1382,1405
55065,42675,5011,20651,3441,37664,2787,1382,1405
55070,42680,5012,20651,3441,37668,2787,1382,1405
55075,42684,5012,20653,3441,37671,2787,1382,1405
55080,42687,5013,20653,3442,37674,2787,1382,1405
55085,42688,5014,20654,3443,37674,2787,1382,1405
55090,42693,5015,20656,3443,37678,2787,1382,1405
55095,42695,5015,20657,3443,37680,2788,1383,1405
55100,42703,5017,20659,3444,37686,2788,1383,1405
55105,42706,5017,20661,3444,37689,2788,1383,1405
55110,42711,5017,20665,3444,37694,2788,1383,1405
55115,42715,5017,20667,3444,37698,2788,1383,1405
55120,42718,5017,20668,3444,37701,2788,1383,1405
55125,42719,5017,20668,3444,37702,2788,1383,1405
55130,42724,5018,20669,3444,37706,2788,1383,1405
55135,42726,5018,20671,3444,37708,2789,1384,1405
55140,42734,5021,20676,3447,37713,2789,1384,1405
55145,42737,5021,20678,3447,37716,2789,1384,1405
55150,42742,5021,20681,3447,37721,2789,1384,1405
55155,42746,5021,20684,3447,37725,2789,1384,1405
55160,42749,5021,20686,3447,37728,2789,1384,1405
55165,42750,5021,20687,3447,37729,2789,1384,1405
55170,42755,5021,20687,3447,37734,2789,1384,1405
55175,42757,5021,20687,3447,37736,2790,1384,1406
55180,42765,5022,20691,3447,37743,2790,1384,1406
55185,42768,5022,20693,3447,37746,2790,1384,1406
55190,42773,5023,20694,3447,37750,2790,1384,1406
55195,42777,5023,20697,3447,37753,2790,1384,1406
55200,42780,5025,20699,3449,37755,2790,1384,1406
55205,42781,5025,20699,3449,37756,2790,1384,1406
55210,42786,5025,20701,3449,37761,2790,1384,1406
55215,42788,5025,20702,3449,37763,2791,1385,1406
55220,42796,5026,20707,3450,37770,2791,1385,1406
55225,42799,5026,20708,3450,37773,2791,1385,1406
55230,42804,5027,20709,3450,37777,2791,1385,1406
55235,42808,5027,20712,3450,37781,2791,1385,1406
55240,42811,5027,20713,3450,37784,2791,1385,1406
55245,42812,5027,20714,3450,37785,2791,1385,1406
55250,42817,5028,20718,3451,37789,2791,1385,1406
55255,42819,5028,20718,3451,37791,2792,1385,1407
55260,42827,5030,20723,3453,37797,2792,1385,1407
55265,42830,5030,20724,3453,37800,2792,1385,1407
55270,42835,5031,20726,3454,37804,2792,1385,1407
55275,42839,5031,20729,3454,37808,2792,1385,1407
55280,42842,5031,20730,3454,37811,2792,1385,1407
55285,42843,5032,20731,3455,37811,2792,1385,1407
55290,42848,5033,20734,3455,37815,2792,1385,1407
55295,42850,5033,20736,3455,37817,2793,1386,1407
55300,42858,5034,20741,3456,37824,2793,1386,1407
55305,42861,5035,20742,3457,37826,2793,1386,1407
55310,42866,5036,20745,3458,37830,2793,1386,1407
55315,42870,5036,20748,3458,37834,2793,1386,1407
55320,42873,5037,20751,3459,37836,2793,1386,1407
55325,42874,5037,20751,3459,37837,2793,1386,1407
55330,42879,5038,20753,3459,37841,2793,1386,1407
55335,42881,5038,20754,3459,37843,2794,1386,1408
55340,42889,5038,20757,3459,37851,2794,1386,1408
55345,42892,5038,20757,3459,37854,2794,1386,1408
55350,42897,5038,20759,3459,37859,2794,1386,1408
55355,42901,5038,20760,3459,37863,2794,1386,1408
55360,42904,5038,20761,3459,37866,2794,1386,1408
55365,42905,5039,20762,3460,37866,2794,1386,1408
55370,42910,5040,20762,3460,37870,2795,1386,1409
55375,42912,5040,20763,3460,37872,2796,1387,1409
55380,42920,5040,20767,3460,37880,2796,1387,1409
55385,42923,5040,20768,3460,37883,2796,1387,1409
55390,42928,5040,20771,3460,37888,2796,1387,1409
55395,42932,5040,20774,3460,37891,2796,1387,1409
55400,42935,5041,20774,3461,37894,2796,1387,1409
55405,42936,5042,20775,3462,37894,2796,1387,1409
55410,42941,5043,20777,3462,37898,2796,1387,1409
55415,42943,5043,20778,3462,37900,2797,1387,1410
55420,42951,5043,20782,3462,37908,2797,1387,1410
55425,42954,5043,20784,3462,37911,2797,1387,1410
55430,42959,5044,20787,3463,37915,2797,1387,1410
55435,42963,5044,20790,3463,37918,2797,1387,1410
55440,42966,5045,20791,3464,37921,2797,1387,1410
55445,42967,5045,20791,3464,37922,2797,1387,1410
55450,42972,5045,20792,3464,37927,2797,1387,1410
55455,42974,5045,20792,3464,37929,2798,1387,1411
55460,42982,5047,20794,3465,37935,2798,1387,1411
55465,42985,5047,20794,3465,37938,2798,1387,1411
55470,42990,5048,20794,3465,37942,2798,1387,1411
55475,42994,5048,20796,3465,37946,2798,1387,1411
55480,42997,5049,20797,3466,37948,2798,1387,1411
55485,42998,5049,20798,3466,37949,2798,1387,1411
55490,43003,5049,20800,3466,37954,2799,1387,1412
55495,43005,5049,20800,3466,37956,2800,1387,1413
55500,43013,5052,20805,3468,37961,2800,1387,1413
55505,43016,5052,20807,3468,37964,2800,1387,1413
55510,43021,5052,20809,3468,37969,2800,1387,1413
55515,43025,5052,20812,3468,37973,2800,1387,1413
55520,43028,5052,20814,3468,37976,2800,1387,1413
55525,43029,5052,20815,3468,37977,2800,1387,1413
55530,43034,5052,20817,3468,37982,2800,1387,1413
55535,43036,5052,20817,3468,37984,2801,1387,1414
55540,43044,5055,20823,3471,37989,2801,1387,1414
55545,43047,5055,20824,3471,37992,2801,1387,1414
55550,43052,5055,20825,3471,37997,2801,1387,1414
55555,43056,5055,20827,3471,38001,2801,1387,1414
55560,43059,5055,20827,3471,38004,2801,1387,1414
55565,43060,5055,20827,3471,38005,2801,1387,1414
55570,43065,5056,20830,3472,38009,2801,1387,1414
55575,43067,5056,20831,3472,38011,2802,1388,1414
55580,43075,5056,20833,3472,38019,2802,1388,1414
55585,43078,5056,20835,3472,38022,2802,1388,1414
55590,43083,5056,20838,3472,38027,2802,1388,1414
55595,43087,5056,20839,3472,38031,2802,1388,1414
55600,43090,5056,20842,3472,38034,2802,1388,1414
55605,43091,5057,20843,3473,38034,2802,1388,1414
55610,43096,5058,20845,3474,38038,2802,1388,1414
55615,43098,5058,20845,3474,38040,2803,1388,1415
55620,43106,5058,20848,3474,38048,2803,1388,1415
55625,43109,5058,20851,3474,38051,2803,1388,1415
55630,43114,5059,20853,3474,38055,2803,1388,1415
55635,43118,5059,20853,3474,38059,2803,1388,1415
55640,43121,5059,20853,3474,38062,2803,1388,1415
55645,43122,5059,20853,3474,38063,2803,1388,1415
55650,43127,5060,20854,3474,38067,2803,1388,1415
55655,43129,5060,20855,3474,38069,2804,1388,1416
55660,43137,5060,20858,3474,38077,2804,1388,1416
55665,43140,5060,20859,3474,38080,2804,1388,1416
55670,43145,5061,20861,3474,38084,2804,1388,1416
55675,43149,5061,20863,3474,38087,2804,1388,1416
55680,43152,5062,20864,3475,38090,2804,1388,1416
55685,43153,5062,20864,3475,38091,2804,1388,1416
55690,43158,5062,20868,3475,38096,2804,1388,1416
55695,43160,5062,20868,3475,38098,2805,1388,1417
55700,43168,5063,20869,3475,38105,2805,1388,1417
55705,43171,5064,20871,3476,38107,2805,1388,1417
55710,43176,5065,20874,3477,38111,2805,1388,1417
55715,43180,5065,20877,3477,38115,2805,1388,1417
55720,43183,5066,20879,3478,38117,2805,1388,1417
55725,43184,5066,20879,3478,38118,2805,1388,1417
55730,43189,5066,20882,3478,38123,2806,1389,1417
55735,43191,5066,20883,3478,38125,2807,1389,1418
55740,43199,5067,20887,3479,38132,2807,1389,1418
55745,43202,5067,20889,3479,38135,2807,1389,1418
55750,43207,5068,20891,3480,38139,2807,1389,1418
55755,43211,5068,20893,3480,38143,2807,1389,1418
55760,43214,5068,20894,3480,38146,2807,1389,1418
55765,43215,5068,20895,3480,38147,2807,1389,1418
55770,43220,5068,20899,3480,38152,2807,1389,1418
55775,43222,5068,20899,3480,38154,2808,1389,1419
55780,43230,5069,20900,3480,38161,2808,1389,1419
55785,43233,5069,20900,3480,38164,2808,1389,1419
55790,43238,5070,20902,3480,38168,2808,1389,1419
55795,43242,5070,20903,3480,38172,2808,1389,1419
55800,43245,5070,20904,3480,38175,2808,1389,1419
55805,43246,5070,20904,3480,38176,2808,1389,1419
55810,43251,5071,20905,3480,38180,2808,1389,1419
55815,43253,5071,20905,3480,38182,2809,1389,1420
55820,43261,5073,20911,3482,38188,2809,1389,1420
55825,43264,5073,20913,3482,38191,2809,1389,1420
55830,43269,5074,20914,3482,38195,2809,1389,1420
55835,43273,5074,20918,3482,38198,2809,1389,1420
55840,43276,5076,20920,3484,38200,2809,1389,1420
55845,43277,5076,20920,3484,38201,2809,1389,1420
55850,43282,5077,20924,3485,38205,2809,1389,1420
55855,43284,5077,20925,3485,38207,2810,1389,1421
55860,43292,5078,20928,3486,38214,2810,1389,1421
55865,43295,5078,20930,3486,38217,2810,1389,1421
55870,43300,5078,20934,3486,38222,2810,1389,1421
55875,43304,5078,20937,3486,38225,2810,1389,1421
55880,43307,5079,20938,3487,38228,2810,1389,1421
55885,43308,5079,20938,3487,38229,2810,1389,1421
55890,43313,5080,20939,3488,38233,2810,1389,1421
55895,43315,5080,20941,3488,38235,2811,1390,1421
55900,43323,5083,20945,3490,38240,2811,1390,1421
55905,43326,5083,20946,3490,38243,2811,1390,1421
55910,43331,5083,20948,3490,38248,2811,1390,1421
55915,43335,5083,20949,3490,38251,2811,1390,1421
55920,43338,5084,20952,3491,38254,2811,1390,1421
55925,43339,5084,20953,3491,38255,2811,1390,1421
55930,43344,5084,20955,3491,38260,2811,1390,1421
55935,43346,5084,20956,3491,38262,2812,1390,1422
55940,43354,5084,20960,3491,38270,2812,1390,1422
55945,43357,5084,20961,3491,38273,2812,1390,1422
55950,43362,5084,20963,3491,38278,2812,1390,1422
55955,43366,5084,20964,3491,38282,2812,1390,1422
55960,43369,5084,20964,3491,38285,2812,1390,1422
55965,43370,5084,20964,3491,38286,2812,1390,1422
55970,43375,5084,20966,3491,38291,2812,1390,1422
55975,43377,5084,20967,3491,38293,2813,1391,1422
55980,43385,5084,20972,3491,38301,2813,1391,1422
55985,43388,5084,20972,3491,38304,2813,1391,1422
55990,43393,5085,20973,3491,38308,2813,1391,1422
55995,43397,5085,20974,3491,38312,2813,1391,1422
56000,43400,5085,20975,3491,38315,2813,1391,1422
56005,43401,5085,20975,3491,38316,2813,1391,1422
56010,43406,5085,20976,3491,38321,2813,1391,1422
56015,43408,5085,20977,3491,38323,2814,1391,1423
56020,43416,5085,20982,3491,38331,2814,1391,1423
56025,43419,5085,20983,3491,38334,2814,1391,1423
56030,43424,5086,20986,3491,38338,2814,1391,1423
56035,43428,5086,20988,3491,38341,2814,1391,1423
56040,43431,5087,20990,3492,38344,2814,1391,1423
56045,43432,5088,20991,3493,38344,2814,1391,1423
56050,43437,5089,20995,3494,38348,2814,1391,1423
56055,43439,5089,20995,3494,38350,2815,1391,1424
56060,43447,5090,21000,3494,38357,2815,1391,1424
56065,43450,5090,21001,3494,38360,2815,1391,1424
56070,43455,5091,21005,3495,38364,2815,1391,1424
56075,43459,5091,21006,3495,38368,2815,1391,1424
56080,43462,5091,21007,3495,38371,2815,1391,1424
56085,43463,5092,21008,3496,38371,2815,1391,1424
56090,43468,5093,21010,3497,38375,2816,1391,1425
56095,43470,5093,21012,3497,38377,2817,1392,1425
56100,43478,5094,21014,3498,38384,2817,1392,1425
56105,43481,5094,21015,3498,38387,2817,1392,1425
56110,43486,5094,21016,3498,38392,2817,1392,1425
56115,43490,5094,21017,3498,38396,2817,1392,1425
56120,43493,5094,21019,3498,38399,2817,1392,1425
56125,43494,5094,21019,3498,38400,2817,1392,1425
56130,43499,5095,21021,3498,38404,2817,1392,1425
56135,43501,5095,21022,3498,38406,2818,1392,1426
56140,43509,5096,21028,3499,38413,2818,1392,1426
56145,43512,5096,21030,3499,38416,2818,1392,1426
56150,43517,5096,21033,3499,38421,2818,1392,1426
56155,43521,5096,21035,3499,38424,2818,1392,1426
56160,43524,5097,21038,3500,38427,2818,1392,1426
56165,43525,5098,21039,3501,38427,2818,1392,1426
56170,43530,5099,21041,3502,38431,2819,1392,1427
56175,43532,5099,21041,3502,38433,2820,1392,1428
56180,43540,5101,21045,3504,38439,2820,1392,1428
56185,43543,5101,21046,3504,38442,2820,1392,1428
56190,43548,5101,21048,3504,38447,2820,1392,1428
56195,43552,5101,21050,3504,38451,2820,1392,1428
56200,43555,5101,21051,3504,38454,2820,1392,1428
56205,43556,5101,21051,3504,38455,2820,1392,1428
56210,43561,5102,21055,3505,38459,2821,1393,1428
56215,43563,5102,21057,3505,38461,2822,1394,1428
56220,43571,5104,21062,3507,38467,2822,1394,1428
56225,43574,5105,21064,3508,38469,2822,1394,1428
56230,43579,5106,21066,3508,38473,2822,1394,1428
56235,43583,5106,21068,3508,38477,2822,1394,1428
56240,43586,5107,21071,3509,38479,2822,1394,1428
56245,43587,5107,21071,3509,38480,2822,1394,1428
56250,43592,5107,21072,3509,38485,2822,1394,1428
56255,43594,5107,21073,3509,38487,2823,1395,1428
56260,43602,5108,21074,3509,38494,2823,1395,1428
56265,43605,5109,21077,3510,38496,2823,1395,1428
56270,43610,5110,21079,3510,38500,2823,1395,1428
56275,43614,5110,21081,3510,38503,2823,1395,1428
56280,43617,5111,21083,3511,38506,2823,1395,1428
56285,43618,5111,21084,3511,38507,2823,1395,1428
56290,43623,5111,21086,3511,38512,2823,1395,1428
56295,43625,5111,21088,3511,38514,2824,1396,1428
56300,43633,5112,21094,3512,38521,2824,1396,1428
56305,43636,5112,21096,3512,38524,2824,1396,1428
56310,43641,5113,21100,3513,38528,2824,1396,1428
56315,43645,5113,21101,3513,38532,2824,1396,1428
56320,43648,5113,21102,3513,38535,2824,1396,1428
56325,43649,5113,21103,3513,38536,2824,1396,1428
56330,43654,5114,21107,3514,38540,2825,1396,1429
56335,43656,5114,21108,3514,38542,2826,1397,1429
56340,43664,5115,21113,3515,38549,2826,1397,1429
56345,43667,5115,21115,3515,38552,2826,1397,1429
56350,43672,5116,21116,3515,38556,2826,1397,1429
56355,43676,5116,21117,3515,38560,2826,1397,1429
56360,43679,5116,21119,3515,38563,2826,1397,1429
56365,43680,5116,21119,3515,38564,2826,1397,1429
56370,43685,5117,21122,3515,38568,2827,1398,1429
56375,43687,5117,21123,3515,38570,2828,1398,1430
56380,43695,5119,21129,3517,38576,2828,1398,1430
56385,43698,5119,21130,3517,38579,2828,1398,1430
56390,43703,5120,21132,3518,38583,2828,1398,1430
56395,43707,5120,21134,3518,38587,2828,1398,1430
56400,43710,5120,21135,3518,38590,2828,1398,1430
56405,43711,5120,21135,3518,38591,2828,1398,1430
56410,43716,5121,21136,3518,38595,2828,1398,1430
56415,43718,5121,21136,3518,38597,2829,1398,1431
56420,43726,5122,21140,3518,38604,2829,1398,1431
56425,43729,5122,21141,3518,38607,2829,1398,1431
56430,43734,5123,21143,3519,38611,2829,1398,1431
56435,43738,5123,21144,3519,38615,2829,1398,1431
56440,43741,5123,21146,3519,38618,2829,1398,1431
56445,43742,5124,21147,3520,38618,2829,1398,1431
56450,43747,5125,21149,3521,38622,2829,1398,1431
56455,43749,5125,21150,3521,38624,2830,1399,1431
56460,43757,5127,21154,3523,38630,2830,1399,1431
56465,43760,5128,21156,3524,38632,2830,1399,1431
56470,43765,5129,21161,3525,38636,2830,1399,1431
56475,43769,5129,21161,3525,38640,2830,1399,1431
56480,43772,5129,21162,3525,38643,2830,1399,1431
56485,43773,5130,21163,3526,38643,2830,1399,1431
56490,43778,5131,21165,3526,38647,2830,1399,1431
56495,43780,5131,21165,3526,38649,2831,1399,1432
56500,43788,5132,21169,3527,38656,2831,1399,1432
56505,43791,5133,21171,3528,38658,2831,1399,1432
56510,43796,5134,21174,3528,38662,2831,1399,1432
56515,43800,5134,21178,3528,38665,2831,1399,1432
56520,43803,5135,21178,3529,38668,2831,1399,1432
56525,43804,5136,21179,3530,38668,2831,1399,1432
56530,43809,5137,21182,3530,38672,2831,1399,1432
56535,43811,5137,21183,3530,38674,2832,1400,1432
56540,43819,5138,21188,3530,38681,2832,1400,1432
56545,43822,5139,21190,3531,38683,2832,1400,1432
56550,43827,5140,21192,3531,38687,2832,1400,1432
56555,43831,5140,21194,3531,38690,2832,1400,1432
56560,43834,5141,21196,3532,38693,2832,1400,1432
56565,43835,5142,21197,3533,38693,2832,1400,1432
56570,43840,5143,21197,3533,38697,2833,1400,1433
56575,43842,5143,21199,3533,38699,2834,1401,1433
56580,43850,5145,21203,3534,38705,2834,1401,1433
56585,43853,5146,21205,3535,38707,2834,1401,1433
56590,43858,5147,21207,3536,38711,2834,1401,1433
56595,43862,5147,21208,3536,38715,2834,1401,1433
56600,43865,5147,21208,3536,38718,2834,1401,1433
56605,43866,5147,21208,3536,38719,2834,1401,1433
56610,43871,5147,21209,3536,38724,2834,1401,1433
56615,43873,5147,21210,3536,38726,2835,1401,1434
56620,43881,5149,21216,3538,38732,2835,1401,1434
56625,43884,5149,21217,3538,38735,2835,1401,1434
56630,43889,5150,21219,3539,38739,2835,1401,1434
56635,43893,5150,21222,3539,38742,2835,1401,1434
56640,43896,5151,21223,3540,38745,2835,1401,1434
56645,43897,5151,21223,3540,38746,2835,1401,1434
56650,43902,5151,21225,3540,38751,2835,1401,1434
56655,43904,5151,21225,3540,38753,2836,1401,1435
56660,43912,5151,21227,3540,38761,2836,1401,1435
56665,43915,5151,21227,3540,38764,2836,1401,1435
56670,43920,5152,21229,3540,38768,2836,1401,1435
56675,43924,5152,21230,3540,38771,2836,1401,1435
56680,43927,5153,21231,3541,38774,2836,1401,1435
56685,43928,5153,21231,3541,38775,2836,1401,1435
56690,43933,5154,21233,3541,38779,2837,1401,1436
56695,43935,5154,21234,3541,38781,2838,1401,1437
56700,43943,5154,21235,3541,38789,2838,1401,1437
56705,43946,5154,21236,3541,38792,2838,1401,1437
56710,43951,5155,21238,3541,38796,2838,1401,1437
56715,43955,5155,21240,3541,38799,2838,1401,1437
56720,43958,5156,21242,3542,38802,2838,1401,1437
56725,43959,5156,21242,3542,38803,2838,1401,1437
56730,43964,5157,21245,3542,38807,2839,1402,1437
56735,43966,5157,21245,3542,38809,2840,1402,1438
56740,43974,5158,21249,3543,38816,2840,1402,1438
56745,43977,5158,21250,3543,38819,2840,1402,1438
56750,43982,5159,21252,3543,38823,2840,1402,1438
56755,43986,5159,21256,3543,38826,2840,1402,1438
56760,43989,5160,21257,3544,38829,2840,1402,1438
56765,43990,5161,21258,3545,38829,2840,1402,1438
56770,43995,5162,21261,3545,38833,2841,1402,1439
56775,43997,5162,21262,3545,38835,2842,1402,1440
56780,44005,5165,21266,3547,38840,2842,1402,1440
56785,44008,5165,21266,3547,38843,2842,1402,1440
56790,44013,5166,21268,3547,38847,2842,1402,1440
56795,44017,5166,21270,3547,38850,2842,1402,1440
56800,44020,5167,21272,3548,38853,2842,1402,1440
56805,44021,5167,21272,3548,38854,2842,1402,1440
56810,44026,5167,21275,3548,38859,2843,1403,1440
56815,44028,5167,21276,3548,38861,2844,1404,1440
56820,44036,5169,21280,3550,38867,2844,1404,1440
56825,44039,5170,21281,3551,38869,2844,1404,1440
56830,44044,5170,21285,3551,38874,2844,1404,1440
56835,44048,5170,21286,3551,38878,2844,1404,1440
56840,44051,5170,21288,3551,38881,2844,1404,1440
56845,44052,5170,21289,3551,38882,2844,1404,1440
56850,44057,5170,21290,3551,38887,2844,1404,1440
56855,44059,5170,21290,3551,38889,2845,1404,1441
56860,44067,5170,21294,3551,38897,2845,1404,1441
56865,44070,5170,21296,3551,38900,2845,1404,1441
56870,44075,5170,21300,3551,38905,2845,1404,1441
56875,44079,5170,21301,3551,38909,2845,1404,1441
56880,44082,5170,21302,3551,38912,2845,1404,1441
56885,44083,5171,21303,3552,38912,2845,1404,1441
56890,44088,5172,21304,3552,38916,2845,1404,1441
56895,44090,5172,21304,3552,38918,2846,1404,1442
56900,44098,5173,21307,3553,38925,2846,1404,1442
56905,44101,5174,21310,3554,38927,2846,1404,1442
56910,44106,5174,21313,3554,38932,2846,1404,1442
56915,44110,5174,21315,3554,38935,2846,1404,1442
56920,44113,5175,21317,3555,38938,2846,1404,1442
56925,44114,5175,21317,3555,38939,2846,1404,1442
56930,44119,5176,21320,3556,38943,2847,1405,1442
56935,44121,5176,21322,3556,38945,2848,1406,1442
56940,44129,5178,21325,3557,38951,2848,1406,1442
56945,44132,5178,21326,3557,38954,2848,1406,1442
56950,44137,5179,21329,3558,38958,2848,1406,1442
56955,44141,5179,21332,3558,38961,2848,1406,1442
56960,44144,5180,21334,3559,38964,2848,1406,1442
56965,44145,5181,21335,3560,38964,2848,1406,1442
56970,44150,5182,21337,3561,38968,2849,1407,1442
56975,44152,5182,21339,3561,38970,2850,1408,1442
56980,44160,5183,21343,3562,38977,2850,1408,1442
56985,44163,5183,21346,3562,38980,2850,1408,1442
56990,44168,5184,21350,3562,38984,2850,1408,1442
56995,44172,5184,21352,3562,38988,2850,1408,1442
57000,44175,5184,21354,3562,38991,2850,1408,1442
57005,44176,5184,21355,3562,38992,2850,1408,1442
57010,44181,5184,21356,3562,38997,2850,1408,1442
57015,44183,5184,21357,3562,38999,2851,1409,1442
57020,44191,5184,21362,3562,39007,2851,1409,1442
57025,44194,5184,21364,3562,39010,2851,1409,1442
57030,44199,5185,21367,3563,39014,2851,1409,1442
57035,44203,5185,21369,3563,39018,2851,1409,1442
57040,44206,5185,21371,3563,39021,2851,1409,1442
57045,44207,5185,21371,3563,39022,2851,1409,1442
57050,44212,5185,21375,3563,39027,2851,1409,1442
57055,44214,5185,21375,3563,39029,2852,1409,1443
57060,44222,5187,21379,3565,39035,2852,1409,1443
57065,44225,5188,21380,3566,39037,2852,1409,1443
57070,44230,5189,21382,3566,39041,2852,1409,1443
57075,44234,5189,21383,3566,39044,2852,1409,1443
57080,44237,5190,21383,3567,39047,2852,1409,1443
57085,44238,5190,21384,3567,39048,2852,1409,1443
57090,44243,5190,21386,3567,39053,2852,1409,1443
57095,44245,5190,21386,3567,39055,2853,1409,1444
57100,44253,5193,21390,3569,39060,2853,1409,1444
57105,44256,5194,21393,3570,39062,2853,1409,1444
57110,44261,5195,21397,3570,39066,2853,1409,1444
57115,44265,5195,21399,3570,39070,2853,1409,1444
57120,44268,5195,21400,3570,39073,2853,1409,1444
57125,44269,5196,21401,3571,39073,2853,1409,1444
57130,44274,5197,21402,3571,39077,2854,1409,1445
57135,44276,5197,21404,3571,39079,2855,1410,1445
57140,44284,5198,21409,3572,39086,2855,1410,1445
57145,44287,5198,21412,3572,39089,2855,1410,1445
57150,44292,5199,21414,3572,39093,2855,1410,1445
57155,44296,5199,21414,3572,39097,2855,1410,1445
57160,44299,5199,21415,3572,39100,2855,1410,1445
57165,44300,5200,21416,3573,39100,2855,1410,1445
57170,44305,5201,21418,3573,39104,2856,1410,1446
57175,44307,5201,21419,3573,39106,2857,1411,1446
57180,44315,5202,21421,3574,39113,2857,1411,1446
57185,44318,5202,21423,3574,39116,2857,1411,1446
57190,44323,5203,21426,3575,39120,2857,1411,1446
57195,44327,5203,21427,3575,39124,2857,1411,1446
57200,44330,5203,21430,3575,39127,2857,1411,1446
57205,44331,5203,21430,3575,39128,2857,1411,1446
57210,44336,5204,21431,3575,39132,2857,1411,1446
57215,44338,5204,21432,3575,39134,2858,1412,1446
57220,44346,5204,21436,3575,39142,2858,1412,1446
57225,44349,5204,21438,3575,39145,2858,1412,1446
57230,44354,5205,21442,3576,39149,2858,1412,1446
57235,44358,5205,21444,3576,39153,2858,1412,1446
57240,44361,5205,21444,3576,39156,2858,1412,1446
57245,44362,5205,21444,3576,39157,2858,1412,1446
57250,44367,5206,21449,3577,39161,2858,1412,1446
57255,44369,5206,21450,3577,39163,2859,1413,1446
57260,44377,5208,21455,3578,39169,2859,1413,1446
57265,44380,5209,21457,3579,39171,2859,1413,1446
57270,44385,5210,21461,3579,39175,2859,1413,1446
57275,44389,5210,21464,3579,39179,2859,1413,1446
57280,44392,5210,21466,3579,39182,2859,1413,1446
57285,44393,5211,21467,3580,39182,2859,1413,1446
57290,44398,5212,21471,3580,39186,2859,1413,1446
57295,44400,5212,21472,3580,39188,2860,1414,1446
57300,44408,5213,21477,3581,39195,2860,1414,1446
57305,44411,5213,21478,3581,39198,2860,1414,1446
57310,44416,5214,21481,3582,39202,2860,1414,1446
57315,44420,5214,21483,3582,39206,2860,1414,1446
57320,44423,5214,21485,3582,39209,2860,1414,1446
57325,44424,5215,21486,3583,39209,2860,1414,1446
57330,44429,5216,21487,3583,39213,2860,1414,1446
57335,44431,5216,21487,3583,39215,2861,1414,1447
57340,44439,5217,21490,3583,39222,2861,1414,1447
57345,44442,5218,21493,3584,39224,2861,1414,1447
57350,44447,5219,21496,3585,39228,2861,1414,1447
57355,44451,5219,21498,3585,39231,2861,1414,1447
57360,44454,5220,21501,3586,39234,2861,1414,1447
57365,44455,5220,21501,3586,39235,2861,1414,1447
57370,44460,5220,21504,3586,39240,2861,1414,1447
57375,44462,5220,21504,3586,39242,2862,1414,1448
57380,44470,5220,21508,3586,39250,2862,1414,1448
57385,44473,5220,21509,3586,39253,2862,1414,1448
57390,44478,5221,21512,3587,39257,2862,1414,1448
57395,44482,5221,21513,3587,39260,2862,1414,1448
57400,44485,5222,21515,3588,39263,2862,1414,1448
57405,44486,5222,21516,3588,39264,2862,1414,1448
57410,44491,5222,21518,3588,39269,2862,1414,1448
57415,44493,5222,21519,3588,39271,2863,1414,1449
57420,44501,5222,21521,3588,39279,2863,1414,1449
57425,44504,5222,21523,3588,39282,2863,1414,1449
57430,44509,5223,21527,3588,39286,2863,1414,1449
57435,44513,5223,21529,3588,39290,2863,1414,1449
57440,44516,5223,21530,3588,39293,2863,1414,1449
57445,44517,5223,21530,3588,39294,2863,1414,1449
57450,44522,5223,21534,3588,39299,2863,1414,1449
57455,44524,5223,21535,3588,39301,2864,1414,1450
57460,44532,5223,21540,3588,39309,2864,1414,1450
57465,44535,5223,21541,3588,39312,2864,1414,1450
57470,44540,5224,21543,3588,39316,2864,1414,1450
57475,44544,5224,21543,3588,39320,2864,1414,1450
57480,44547,5224,21545,3588,39323,2864,1414,1450
57485,44548,5225,21546,3589,39323,2864,1414,1450
57490,44553,5226,21548,3589,39327,2864,1414,1450
57495,44555,5226,21549,3589,39329,2865,1415,1450
57500,44563,5227,21552,3590,39336,2865,1415,1450
57505,44566,5228,21553,3591,39338,2865,1415,1450
57510,44571,5229,21553,3591,39342,2865,1415,1450
57515,44575,5229,21557,3591,39345,2865,1415,1450
57520,44578,5230,21558,3592,39348,2865,1415,1450
57525,44579,5231,21559,3593,39348,2865,1415,1450
57530,44584,5232,21560,3593,39352,2865,1415,1450
57535,44586,5232,21561,3593,39354,2866,1415,1451
57540,44594,5233,21565,3594,39361,2866,1415,1451
57545,44597,5234,21568,3595,39363,2866,1415,1451
57550,44602,5235,21571,3596,39367,2866,1415,1451
57555,44606,5235,21574,3596,39371,2866,1415,1451
57560,44609,5235,21575,3596,39374,2866,1415,1451
57565,44610,5236,21576,3597,39374,2866,1415,1451
57570,44615,5237,21577,3598,39378,2866,1415,1451
57575,44617,5237,21577,3598,39380,2867,1415,1452
57580,44625,5238,21577,3598,39387,2867,1415,1452
57585,44628,5239,21580,3599,39389,2867,1415,1452
57590,44633,5240,21584,3600,39393,2867,1415,1452
57595,44637,5240,21587,3600,39396,2867,1415,1452
57600,44640,5241,21588,3601,39399,2867,1415,1452
57605,44641,5241,21588,3601,39400,2867,1415,1452
57610,44646,5241,21590,3601,39405,2867,1415,1452
57615,44648,5241,21591,3601,39407,2868,1416,1452
57620,44656,5242,21593,3601,39414,2868,1416,1452
57625,44659,5243,21594,3602,39416,2868,1416,1452
57630,44664,5244,21597,3603,39420,2868,1416,1452
57635,44668,5244,21599,3603,39423,2868,1416,1452
57640,44671,5245,21600,3604,39426,2868,1416,1452
57645,44672,5245,21600,3604,39427,2868,1416,1452
57650,44677,5245,21603,3604,39432,2868,1416,1452
57655,44679,5245,21604,3604,39434,2869,1416,1453
57660,44687,5246,21605,3604,39441,2869,1416,1453
57665,44690,5247,21607,3605,39443,2869,1416,1453
57670,44695,5248,21610,3605,39447,2869,1416,1453
57675,44699,5248,21611,3605,39451,2869,1416,1453
57680,44702,5248,21613,3605,39454,2869,1416,1453
57685,44703,5248,21613,3605,39455,2869,1416,1453
57690,44708,5248,21615,3605,39460,2869,1416,1453
57695,44710,5248,21617,3605,39462,2870,1417,1453
57700,44718,5249,21620,3605,39469,2870,1417,1453
57705,44721,5250,21621,3606,39471,2870,1417,1453
57710,44726,5251,21623,3607,39475,2870,1417,1453
57715,44730,5251,21625,3607,39479,2870,1417,1453
57720,44733,5251,21626,3607,39482,2870,1417,1453
57725,44734,5251,21626,3607,39483,2870,1417,1453
57730,44739,5252,21629,3608,39487,2870,1417,1453
57735,44741,5252,21629,3608,39489,2871,1417,1454
57740,44749,5253,21632,3609,39496,2871,1417,1454
57745,44752,5253,21633,3609,39499,2871,1417,1454
57750,44757,5254,21634,3609,39503,2871,1417,1454
57755,44761,5254,21635,3609,39507,2871,1417,1454
57760,44764,5254,21636,3609,39510,2871,1417,1454
57765,44765,5255,21637,3610,39510,2871,1417,1454
57770,44770,5256,21640,3610,39514,2871,1417,1454
57775,44772,5256,21641,3610,39516,2872,1417,1455
57780,44780,5257,21644,3611,39523,2872,1417,1455
57785,44783,5257,21645,3611,39526,2872,1417,1455
57790,44788,5258,21647,3611,39530,2872,1417,1455
57795,44792,5258,21649,3611,39533,2872,1417,1455
57800,44795,5259,21649,3612,39536,2872,1417,1455
57805,44796,5259,21649,3612,39537,2872,1417,1455
57810,44801,5259,21650,3612,39542,2873,1417,1456
57815,44803,5259,21651,3612,39544,2874,1418,1456
57820,44811,5260,21656,3613,39551,2874,1418,1456
57825,44814,5260,21657,3613,39554,2874,1418,1456
57830,44819,5261,21658,3613,39558,2874,1418,1456
57835,44823,5261,21661,3613,39561,2874,1418,1456
57840,44826,5262,21662,3614,39564,2874,1418,1456
57845,44827,5262,21662,3614,39565,2874,1418,1456
57850,44832,5262,21664,3614,39570,2874,1418,1456
57855,44834,5262,21665,3614,39572,2875,1418,1457
57860,44842,5264,21669,3616,39578,2875,1418,1457
57865,44845,5265,21671,3617,39580,2875,1418,1457
57870,44850,5266,21673,3617,39584,2875,1418,1457
57875,44854,5266,21673,3617,39588,2875,1418,1457
57880,44857,5266,21674,3617,39591,2875,1418,1457
57885,44858,5266,21674,3617,39592,2875,1418,1457
57890,44863,5266,21674,3617,39597,2875,1418,1457
57895,44865,5266,21675,3617,39599,2876,1418,1458
57900,44873,5269,21680,3619,39604,2876,1418,1458
57905,44876,5269,21682,3619,39607,2876,1418,1458
57910,44881,5270,21685,3619,39611,2876,1418,1458
57915,44885,5270,21688,3619,39614,2876,1418,1458
57920,44888,5271,21690,3620,39617,2876,1418,1458
57925,44889,5271,21691,3620,39618,2876,1418,1458
57930,44894,5271,21692,3620,39623,2876,1418,1458
57935,44896,5271,21692,3620,39625,2877,1418,1459
57940,44904,5271,21696,3620,39633,2877,1418,1459
57945,44907,5271,21697,3620,39636,2877,1418,1459
57950,44912,5272,21699,3621,39640,2877,1418,1459
57955,44916,5272,21700,3621,39644,2877,1418,1459
57960,44919,5272,21702,3621,39647,2877,1418,1459
57965,44920,5272,21703,3621,39648,2877,1418,1459
57970,44925,5272,21706,3621,39653,2878,1419,1459
57975,44927,5272,21707,3621,39655,2879,1420,1459
57980,44935,5272,21711,3621,39663,2879,1420,1459
57985,44938,5272,21714,3621,39666,2879,1420,1459
57990,44943,5273,21717,3622,39670,2879,1420,1459
57995,44947,5273,21720,3622,39673,2879,1420,1459
58000,44950,5274,21722,3623,39676,2879,1420,1459
58005,44951,5274,21723,3623,39677,2879,1420,1459
58010,44956,5274,21726,3623,39682,2879,1420,1459
58015,44958,5274,21728,3623,39684,2880,1421,1459
58020,44966,5276,21730,3624,39690,2880,1421,1459
58025,44969,5276,21732,3624,39693,2880,1421,1459
58030,44974,5277,21735,3624,39697,2880,1421,1459
58035,44978,5277,21738,3624,39701,2880,1421,1459
58040,44981,5277,21740,3624,39704,2880,1421,1459
58045,44982,5277,21740,3624,39705,2880,1421,1459
58050,44987,5277,21742,3624,39710,2880,1421,1459
58055,44989,5277,21744,3624,39712,2881,1422,1459
58060,44997,5280,21750,3627,39717,2881,1422,1459
58065,45000,5280,21751,3627,39720,2881,1422,1459
58070,45005,5281,21755,3628,39724,2881,1422,1459
58075,45009,5281,21758,3628,39727,2881,1422,1459
58080,45012,5282,21759,3629,39730,2881,1422,1459
58085,45013,5282,21760,3629,39731,2881,1422,1459
58090,45018,5282,21763,3629,39736,2882,1422,1460
58095,45020,5282,21763,3629,39738,2883,1422,1461
58100,45028,5284,21766,3631,39744,2883,1422,1461
58105,45031,5284,21767,3631,39747,2883,1422,1461
58110,45036,5285,21768,3632,39751,2883,1422,1461
58115,45040,5285,21770,3632,39754,2883,1422,1461
58120,45043,5286,21771,3633,39757,2883,1422,1461
58125,45044,5286,21772,3633,39758,2883,1422,1461
58130,45049,5286,21774,3633,39763,2884,1422,1462
58135,45051,5286,21774,3633,39765,2885,1422,1463
58140,45059,5287,21777,3634,39772,2885,1422,1463
58145,45062,5287,21778,3634,39775,2885,1422,1463
58150,45067,5288,21778,3634,39779,2885,1422,1463
58155,45071,5288,21780,3634,39783,2885,1422,1463
58160,45074,5288,21781,3634,39786,2885,1422,1463
58165,45075,5288,21782,3634,39787,2885,1422,1463
58170,45080,5288,21784,3634,39792,2885,1422,1463
58175,45082,5288,21786,3634,39794,2886,1423,1463
58180,45090,5290,21789,3635,39800,2886,1423,1463
58185,45093,5290,21790,3635,39803,2886,1423,1463
58190,45098,5291,21792,3635,39807,2886,1423,1463
58195,45102,5291,21794,3635,39811,2886,1423,1463
58200,45105,5291,21796,3635,39814,2886,1423,1463
58205,45106,5291,21796,3635,39815,2886,1423,1463
58210,45111,5291,21800,3635,39820,2886,1423,1463
58215,45113,5291,21800,3635,39822,2887,1423,1464
58220,45121,5291,21804,3635,39830,2887,1423,1464
58225,45124,5291,21805,3635,39833,2887,1423,1464
58230,45129,5291,21809,3635,39838,2887,1423,1464
58235,45133,5291,21811,3635,39842,2887,1423,1464
58240,45136,5291,21812,3635,39845,2887,1423,1464
58245,45137,5291,21812,3635,39846,2887,1423,1464
58250,45142,5291,21812,3635,39851,2887,1423,1464
58255,45144,5291,21812,3635,39853,2888,1423,1465
58260,45152,5291,21817,3635,39861,2888,1423,1465
58265,45155,5291,21817,3635,39864,2888,1423,1465
58270,45160,5291,21819,3635,39869,2888,1423,1465
58275,45164,5291,21821,3635,39873,2888,1423,1465
58280,45167,5291,21823,3635,39876,2888,1423,1465
58285,45168,5291,21823,3635,39877,2888,1423,1465
58290,45173,5291,21826,3635,39882,2889,1424,1465
58295,45175,5291,21827,3635,39884,2890,1425,1465
58300,45183,5291,21832,3635,39892,2890,1425,1465
58305,45186,5291,21834,3635,39895,2890,1425,1465
58310,45191,5292,21836,3635,39899,2890,1425,1465
58315,45195,5292,21836,3635,39903,2890,1425,1465
58320,45198,5292,21837,3635,39906,2890,1425,1465
58325,45199,5292,21838,3635,39907,2890,1425,1465
58330,45204,5292,21839,3635,39912,2890,1425,1465
58335,45206,5292,21841,3635,39914,2891,1426,1465
58340,45214,5294,21846,3636,39920,2891,1426,1465
58345,45217,5295,21848,3637,39922,2891,1426,1465
58350,45222,5296,21851,3637,39926,2891,1426,1465
58355,45226,5296,21854,3637,39929,2891,1426,1465
58360,45229,5297,21855,3638,39932,2891,1426,1465
58365,45230,5297,21856,3638,39933,2891,1426,1465
58370,45235,5297,21858,3638,39938,2891,1426,1465
58375,45237,5297,21860,3638,39940,2892,1427,1465
58380,45245,5298,21864,3638,39947,2892,1427,1465
58385,45248,5298,21865,3638,39950,2892,1427,1465
58390,45253,5299,21867,3638,39954,2892,1427,1465
58395,45257,5299,21868,3638,39958,2892,1427,1465
58400,45260,5299,21868,3638,39961,2892,1427,1465
58405,45261,5299,21869,3638,39962,2892,1427,1465
58410,45266,5299,21870,3638,39967,2892,1427,1465
58415,45268,5299,21871,3638,39969,2893,1428,1465
58420,45276,5300,21877,3639,39976,2893,1428,1465
58425,45279,5301,21880,3640,39978,2893,1428,1465
58430,45284,5302,21880,3640,39982,2893,1428,1465
58435,45288,5302,21883,3640,39985,2893,1428,1465
58440,45291,5303,21883,3641,39988,2893,1428,1465
58445,45292,5303,21884,3641,39989,2893,1428,1465
58450,45297,5303,21884,3641,39994,2893,1428,1465
58455,45299,5303,21885,3641,39996,2894,1429,1465
58460,45307,5304,21889,3642,40003,2894,1429,1465
58465,45310,5304,21889,3642,40006,2894,1429,1465
58470,45315,5305,21890,3642,40010,2894,1429,1465
58475,45319,5305,21893,3642,40014,2894,1429,1465
58480,45322,5305,21893,3642,40017,2894,1429,1465
58485,45323,5305,21894,3642,40018,2894,1429,1465
58490,45328,5305,21897,3642,40023,2894,1429,1465
58495,45330,5305,21897,3642,40025,2895,1429,1466
58500,45338,5307,21903,3644,40031,2895,1429,1466
58505,45341,5308,21905,3645,40033,2895,1429,1466
58510,45346,5309,21909,3646,40037,2895,1429,1466
58515,45350,5309,21913,3646,40040,2895,1429,1466
58520,45353,5310,21915,3647,40043,2895,1429,1466
58525,45354,5310,21915,3647,40044,2895,1429,1466
58530,45359,5310,21919,3647,40049,2895,1429,1466
58535,45361,5310,21920,3647,40051,2896,1430,1466
58540,45369,5312,21921,3648,40057,2896,1430,1466
58545,45372,5312,21923,3648,40060,2896,1430,1466
58550,45377,5313,21927,3649,40064,2896,1430,1466
58555,45381,5313,21929,3649,40067,2896,1430,1466
58560,45384,5314,21930,3650,40070,2896,1430,1466
58565,45385,5314,21931,3650,40071,2896,1430,1466
58570,45390,5314,21932,3650,40076,2896,1430,1466
58575,45392,5314,21934,3650,40078,2897,1431,1466
58580,45400,5315,21937,3650,40085,2897,1431,1466
58585,45403,5315,21939,3650,40088,2897,1431,1466
58590,45408,5316,21942,3651,40092,2897,1431,1466
58595,45412,5316,21944,3651,40096,2897,1431,1466
58600,45415,5316,21946,3651,40099,2897,1431,1466
58605,45416,5316,21946,3651,40100,2897,1431,1466
58610,45421,5316,21949,3651,40105,2897,1431,1466
58615,45423,5316,21950,3651,40107,2898,1432,1466
58620,45431,5318,21955,3653,40113,2898,1432,1466
58625,45434,5318,21957,3653,40116,2898,1432,1466
58630,45439,5319,21959,3653,40120,2898,1432,1466
58635,45443,5319,21960,3653,40123,2898,1432,1466
58640,45446,5320,21961,3654,40126,2898,1432,1466
58645,45447,5320,21961,3654,40127,2898,1432,1466
58650,45452,5320,21963,3654,40132,2898,1432,1466
58655,45454,5320,21964,3654,40134,2899,1432,1467
58660,45462,5320,21967,3654,40142,2899,1432,1467
58665,45465,5320,21968,3654,40145,2899,1432,1467
58670,45470,5321,21971,3654,40149,2899,1432,1467
58675,45474,5321,21972,3654,40153,2899,1432,1467
58680,45477,5321,21973,3654,40156,2899,1432,1467
58685,45478,5321,21973,3654,40157,2899,1432,1467
58690,45483,5321,21974,3654,40162,2899,1432,1467
58695,45485,5321,21976,3654,40164,2900,1433,1467
58700,45493,5322,21980,3655,40171,2900,1433,1467
58705,45496,5322,21982,3655,40174,2900,1433,1467
58710,45501,5323,21985,3655,40178,2900,1433,1467
58715,45505,5323,21987,3655,40182,2900,1433,1467
58720,45508,5323,21988,3655,40185,2900,1433,1467
58725,45509,5323,21988,3655,40186,2900,1433,1467
58730,45514,5323,21990,3655,40191,2900,1433,1467
58735,45516,5323,21992,3655,40193,2901,1434,1467
58740,45524,5325,21996,3656,40199,2901,1434,1467
58745,45527,5325,21997,3656,40202,2901,1434,1467
58750,45532,5326,21998,3657,40206,2901,1434,1467
58755,45536,5326,22000,3657,40210,2901,1434,1467
58760,45539,5326,22002,3657,40213,2901,1434,1467
58765,45540,5326,22003,3657,40214,2901,1434,1467
58770,45545,5326,22007,3657,40219,2901,1434,1467
58775,45547,5326,22007,3657,40221,2902,1434,1468
58780,45555,5328,22011,3659,40227,2902,1434,1468
58785,45558,5329,22014,3660,40229,2902,1434,1468
58790,45563,5330,22014,3660,40233,2902,1434,1468
58795,45567,5330,22018,3660,40236,2902,1434,1468
58800,45570,5331,22020,3661,40239,2902,1434,1468
58805,45571,5331,22020,3661,40240,2902,1434,1468
58810,45576,5331,22023,3661,40245,2903,1434,1469
58815,45578,5331,22024,3661,40247,2904,1434,1470
58820,45586,5333,22030,3663,40253,2904,1434,1470
58825,45589,5333,22031,3663,40256,2904,1434,1470
58830,45594,5334,22034,3664,40260,2904,1434,1470
58835,45598,5334,22037,3664,40263,2904,1434,1470
58840,45601,5335,22039,3665,40266,2904,1434,1470
58845,45602,5335,22040,3665,40267,2904,1434,1470
58850,45607,5335,22043,3665,40272,2905,1434,1471
58855,45609,5335,22043,3665,40274,2906,1434,1472
58860,45617,5337,22048,3667,40280,2906,1434,1472
58865,45620,5337,22050,3667,40283,2906,1434,1472
58870,45625,5338,22054,3668,40287,2906,1434,1472
58875,45629,5338,22056,3668,40290,2906,1434,1472
58880,45632,5339,22057,3669,40293,2906,1434,1472
58885,45633,5339,22058,3669,40294,2906,1434,1472
58890,45638,5339,22060,3669,40299,2906,1434,1472
58895,45640,5339,22061,3669,40301,2907,1434,1473
58900,45648,5339,22065,3669,40309,2907,1434,1473
58905,45651,5339,22065,3669,40312,2907,1434,1473
58910,45656,5340,22067,3670,40316,2907,1434,1473
58915,45660,5340,22069,3670,40319,2907,1434,1473
58920,45663,5341,22070,3671,40322,2907,1434,1473
58925,45664,5341,22071,3671,40323,2907,1434,1473
58930,45669,5341,22073,3671,40328,2908,1434,1474
58935,45671,5341,22074,3671,40330,2909,1434,1475
58940,45679,5341,22076,3671,40338,2909,1434,1475
58945,45682,5341,22077,3671,40341,2909,1434,1475
58950,45687,5342,22079,3671,40345,2909,1434,1475
58955,45691,5342,22081,3671,40349,2909,1434,1475
58960,45694,5342,22081,3671,40352,2909,1434,1475
58965,45695,5342,22082,3671,40353,2909,1434,1475
58970,45700,5342,22084,3671,40358,2909,1434,1475
58975,45702,5342,22085,3671,40360,2910,1434,1476
58980,45710,5345,22088,3673,40365,2910,1434,1476
58985,45713,5346,22091,3674,40367,2910,1434,1476
58990,45718,5347,22094,3675,40371,2910,1434,1476
58995,45722,5347,22096,3675,40374,2910,1434,1476
59000,45725,5348,22097,3676,40377,2910,1434,1476
59005,45726,5348,22098,3676,40378,2910,1434,1476
59010,45731,5348,22100,3676,40383,2910,1434,1476
59015,45733,5348,22100,3676,40385,2911,1434,1477
59020,45741,5349,22103,3676,40392,2911,1434,1477
59025,45744,5350,22105,3677,40394,2911,1434,1477
59030,45749,5351,22107,3677,40398,2911,1434,1477
59035,45753,5351,22108,3677,40402,2911,1434,1477
59040,45756,5351,22109,3677,40405,2911,1434,1477
59045,45757,5351,22109,3677,40406,2911,1434,1477
59050,45762,5351,22110,3677,40411,2912,1434,1478
59055,45764,5351,22111,3677,40413,2913,1435,1478
59060,45772,5353,22117,3679,40419,2913,1435,1478
59065,45775,5354,22120,3680,40421,2913,1435,1478
59070,45780,5355,22122,3680,40425,2913,1435,1478
59075,45784,5355,22124,3680,40429,2913,1435,1478
59080,45787,5355,22126,3680,40432,2913,1435,1478
59085,45788,5355,22127,3680,40433,2913,1435,1478
59090,45793,5355,22131,3680,40438,2913,1435,1478
59095,45795,5355,22132,3680,40440,2914,1435,1479
59100,45803,5357,22135,3681,40446,2914,1435,1479
59105,45806,5357,22137,3681,40449,2914,1435,1479
59110,45811,5358,22138,3681,40453,2914,1435,1479
59115,45815,5358,22141,3681,40456,2914,1435,1479
59120,45818,5359,22143,3682,40459,2914,1435,1479
59125,45819,5359,22144,3682,40460,2914,1435,1479
59130,45824,5359,22146,3682,40465,2914,1435,1479
59135,45826,5359,22146,3682,40467,2915,1435,1480
59140,45834,5359,22149,3682,40475,2915,1435,1480
59145,45837,5359,22152,3682,40478,2915,1435,1480
59150,45842,5360,22154,3682,40482,2915,1435,1480
59155,45846,5360,22158,3682,40485,2915,1435,1480
59160,45849,5361,22159,3683,40488,2915,1435,1480
59165,45850,5361,22159,3683,40489,2915,1435,1480
59170,45855,5361,22163,3683,40494,2915,1435,1480
59175,45857,5361,22164,3683,40496,2916,1436,1480
59180,45865,5362,22169,3684,40503,2916,1436,1480
59185,45868,5362,22171,3684,40506,2916,1436,1480
59190,45873,5363,22175,3685,40510,2916,1436,1480
59195,45877,5363,22178,3685,40514,2916,1436,1480
59200,45880,5363,22179,3685,40517,2916,1436,1480
59205,45881,5363,22179,3685,40518,2916,1436,1480
59210,45886,5363,22181,3685,40523,2916,1436,1480
59215,45888,5363,22182,3685,40525,2917,1437,1480
59220,45896,5365,22188,3687,40531,2917,1437,1480
59225,45899,5365,22189,3687,40534,2917,1437,1480
59230,45904,5366,22192,3687,40538,2917,1437,1480
59235,45908,5366,22195,3687,40542,2917,1437,1480
59240,45911,5366,22198,3687,40545,2917,1437,1480
59245,45912,5366,22198,3687,40546,2917,1437,1480
59250,45917,5366,22200,3687,40551,2917,1437,1480
59255,45919,5366,22201,3687,40553,2918,1437,1481
59260,45927,5368,22206,3688,40559,2918,1437,1481
59265,45930,5369,22208,3689,40561,2918,1437,1481
59270,45935,5370,22210,3690,40565,2918,1437,1481
59275,45939,5370,22211,3690,40569,2918,1437,1481
59280,45942,5370,22213,3690,40572,2918,1437,1481
59285,45943,5370,22214,3690,40573,2918,1437,1481
59290,45948,5370,22218,3690,40578,2919,1438,1481
59295,45950,5370,22219,3690,40580,2920,1438,1482
59300,45958,5372,22225,3692,40586,2920,1438,1482
59305,45961,5372,22225,3692,40589,2920,1438,1482
59310,45966,5373,22226,3692,40593,2920,1438,1482
59315,45970,5373,22228,3692,40597,2920,1438,1482
59320,45973,5373,22229,3692,40600,2920,1438,1482
59325,45974,5373,22230,3692,40601,2920,1438,1482
59330,45979,5373,22232,3692,40606,2921,1439,1482
59335,45981,5373,22233,3692,40608,2922,1440,1482
59340,45989,5374,22236,3693,40615,2922,1440,1482
59345,45992,5374,22238,3693,40618,2922,1440,1482
59350,45997,5375,22240,3694,40622,2922,1440,1482
59355,46001,5375,22244,3694,40625,2922,1440,1482
59360,46004,5376,22245,3695,40628,2922,1440,1482
59365,46005,5376,22245,3695,40629,2922,1440,1482
59370,46010,5376,22247,3695,40634,2922,1440,1482
59375,46012,5376,22248,3695,40636,2923,1440,1483
59380,46020,5376,22251,3695,40644,2923,1440,1483
59385,46023,5376,22253,3695,40647,2923,1440,1483
59390,46028,5377,22257,3696,40651,2923,1440,1483
59395,46032,5377,22259,3696,40655,2923,1440,1483
59400,46035,5377,22260,3696,40658,2923,1440,1483
59405,46036,5377,22260,3696,40659,2923,1440,1483
59410,46041,5377,22261,3696,40664,2923,1440,1483
59415,46043,5377,22262,3696,40666,2924,1441,1483
59420,46051,5377,22266,3696,40674,2924,1441,1483
59425,46054,5377,22267,3696,40677,2924,1441,1483
59430,46059,5378,22269,3697,40681,2924,1441,1483
59435,46063,5378,22270,3697,40685,2924,1441,1483
59440,46066,5378,22271,3697,40688,2924,1441,1483
59445,46067,5378,22271,3697,40689,2924,1441,1483
59450,46072,5378,22274,3697,40694,2925,1441,1484
59455,46074,5378,22274,3697,40696,2926,1441,1485
59460,46082,5379,22276,3697,40703,2926,1441,1485
59465,46085,5379,22277,3697,40706,2926,1441,1485
59470,46090,5380,22280,3697,40710,2926,1441,1485
59475,46094,5380,22282,3697,40714,2926,1441,1485
59480,46097,5380,22283,3697,40717,2926,1441,1485
59485,46098,5380,22283,3697,40718,2926,1441,1485
59490,46103,5380,22287,3697,40723,2927,1442,1485
59495,46105,5380,22288,3697,40725,2928,1443,1485
59500,46113,5382,22294,3698,40731,2928,1443,1485
59505,46116,5382,22296,3698,40734,2928,1443,1485
59510,46121,5383,22298,3698,40738,2928,1443,1485
59515,46125,5383,22299,3698,40741,2928,1443,1485
59520,46128,5384,22300,3699,40744,2928,1443,1485
59525,46129,5384,22300,3699,40745,2928,1443,1485
59530,46134,5384,22304,3699,40750,2928,1443,1485
59535,46136,5384,22305,3699,40752,2929,1443,1486
59540,46144,5386,22308,3700,40758,2929,1443,1486
59545,46147,5387,22310,3701,40760,2929,1443,1486
59550,46152,5388,22312,3701,40764,2929,1443,1486
59555,46156,5388,22314,3701,40767,2929,1443,1486
59560,46159,5389,22316,3702,40770,2929,1443,1486
59565,46160,5389,22316,3702,40771,2929,1443,1486
59570,46165,5389,22318,3702,40776,2929,1443,1486
59575,46167,5389,22320,3702,40778,2930,1444,1486
59580,46175,5391,22321,3703,40784,2930,1444,1486
59585,46178,5391,22323,3703,40787,2930,1444,1486
59590,46183,5392,22327,3703,40791,2930,1444,1486
59595,46187,5392,22328,3703,40794,2930,1444,1486
59600,46190,5393,22331,3704,40797,2930,1444,1486
59605,46191,5393,22332,3704,40798,2930,1444,1486
59610,46196,5393,22335,3704,40803,2930,1444,1486
59615,46198,5393,22337,3704,40805,2931,1445,1486
59620,46206,5394,22343,3705,40812,2931,1445,1486
59625,46209,5394,22344,3705,40815,2931,1445,1486
59630,46214,5395,22347,3706,40819,2931,1445,1486
59635,46218,5395,22349,3706,40822,2931,1445,1486
59640,46221,5396,22349,3707,40825,2931,1445,1486
59645,46222,5396,22349,3707,40826,2931,1445,1486
59650,46227,5396,22351,3707,40831,2932,1445,1487
59655,46229,5396,22353,3707,40833,2933,1446,1487
59660,46237,5397,22357,3708,40840,2933,1446,1487
59665,46240,5397,22360,3708,40843,2933,1446,1487
59670,46245,5398,22363,3708,40847,2933,1446,1487
59675,46249,5398,22365,3708,40850,2933,1446,1487
59680,46252,5399,22366,3709,40853,2933,1446,1487
59685,46253,5399,22367,3709,40854,2933,1446,1487
59690,46258,5399,22369,3709,40859,2934,1447,1487
59695,46260,5399,22370,3709,40861,2935,1447,1488
59700,46268,5401,22374,3710,40867,2935,1447,1488
59705,46271,5402,22376,3711,40869,2935,1447,1488
59710,46276,5403,22378,3712,40873,2935,1447,1488
59715,46280,5403,22379,3712,40877,2935,1447,1488
59720,46283,5403,22382,3712,40880,2935,1447,1488
59725,46284,5403,22382,3712,40881,2935,1447,1488
59730,46289,5403,22385,3712,40886,2936,1447,1489
59735,46291,5403,22387,3712,40888,2937,1448,1489
59740,46299,5405,22391,3714,40894,2937,1448,1489
59745,46302,5405,22392,3714,40897,2937,1448,1489
59750,46307,5406,22395,3714,40901,2937,1448,1489
59755,46311,5406,22398,3714,40904,2937,1448,1489
59760,46314,5407,22399,3715,40907,2937,1448,1489
59765,46315,5407,22400,3715,40908,2937,1448,1489
59770,46320,5407,22401,3715,40913,2938,1448,1490
59775,46322,5407,22402,3715,40915,2939,1449,1490
59780,46330,5408,22408,3716,40922,2939,1449,1490
59785,46333,5408,22410,3716,40925,2939,1449,1490
59790,46338,5409,22412,3717,40929,2939,1449,1490
59795,46342,5409,22416,3717,40932,2939,1449,1490
59800,46345,5410,22417,3718,40935,2939,1449,1490
59805,46346,5410,22418,3718,40936,2939,1449,1490
59810,46351,5410,22419,3718,40941,2940,1449,1491
59815,46353,5410,22420,3718,40943,2941,1450,1491
59820,46361,5412,22424,3720,40949,2941,1450,1491
59825,46364,5413,22426,3721,40951,2941,1450,1491
59830,46369,5414,22428,3721,40955,2941,1450,1491
59835,46373,5414,22430,3721,40958,2941,1450,1491
59840,46376,5415,22430,3722,40961,2941,1450,1491
59845,46377,5415,22431,3722,40962,2941,1450,1491
59850,46382,5415,22434,3722,40967,2941,1450,1491
59855,46384,5415,22434,3722,40969,2942,1450,1492
59860,46392,5416,22437,3723,40976,2942,1450,1492
59865,46395,5416,22439,3723,40979,2942,1450,1492
59870,46400,5417,22443,3724,40983,2942,1450,1492
59875,46404,5417,22444,3724,40987,2942,1450,1492
59880,46407,5417,22445,3724,40990,2942,1450,1492
59885,46408,5417,22446,3724,40991,2942,1450,1492
59890,46413,5417,22446,3724,40996,2943,1450,1493
59895,46415,5417,22447,3724,40998,2944,1450,1494
59900,46423,5419,22451,3726,41004,2944,1450,1494
59905,46426,5419,22452,3726,41007,2944,1450,1494
59910,46431,5420,22457,3727,41011,2944,1450,1494
59915,46435,5420,22458,3727,41015,2944,1450,1494
59920,46438,5420,22460,3727,41018,2944,1450,1494
59925,46439,5420,22461,3727,41019,2944,1450,1494
59930,46444,5420,22464,3727,41024,2945,1450,1495
59935,46446,5420,22466,3727,41026,2946,1451,1495
59940,46454,5421,22472,3728,41033,2946,1451,1495
59945,46457,5421,22472,3728,41036,2946,1451,1495
59950,46462,5422,22474,3728,41040,2946,1451,1495
59955,46466,5422,22476,3728,41043,2946,1451,1495
59960,46469,5423,22476,3729,41046,2946,1451,1495
59965,46470,5423,22476,3729,41047,2946,1451,1495
59970,46475,5423,22479,3729,41052,2946,1451,1495
59975,46477,5423,22479,3729,41054,2947,1451,1496
59980,46485,5424,22480,3729,41061,2947,1451,1496
59985,46488,5424,22482,3729,41064,2947,1451,1496
59990,46493,5425,22486,3730,41068,2947,1451,1496
59995,46497,5425,22488,3730,41071,2947,1451,1496
60000,46500,5426,22489,3731,41074,2947,1451,1496
60005,46501,5426,22489,3731,41075,2947,1451,1496
60010,46506,5426,22491,3731,41080,2947,1451,1496
60015,46508,5426,22492,3731,41082,2948,1452,1496
60020,46516,5428,22496,3732,41088,2948,1452,1496
60025,46519,5428,22497,3732,41091,2948,1452,1496
60030,46524,5429,22501,3733,41095,2948,1452,1496
60035,46528,5429,22503,3733,41098,2948,1452,1496
60040,46531,5430,22503,3734,41101,2948,1452,1496
60045,46532,5430,22504,3734,41102,2948,1452,1496
60050,46537,5430,22505,3734,41107,2948,1452,1496
60055,46539,5430,22506,3734,41109,2949,1452,1497
60060,46547,5432,22509,3736,41115,2949,1452,1497
60065,46550,5432,22510,3736,41118,2949,1452,1497
60070,46555,5433,22511,3737,41122,2949,1452,1497
60075,46559,5433,22515,3737,41125,2949,1452,1497
60080,46562,5434,22517,3738,41128,2949,1452,1497
60085,46563,5434,22517,3738,41129,2949,1452,1497
60090,46568,5434,22520,3738,41134,2949,1452,1497
60095,46570,5434,22520,3738,41136,2950,1452,1498
60100,46578,5435,22524,3739,41143,2950,1452,1498
60105,46581,5435,22525,3739,41146,2950,1452,1498
60110,46586,5436,22528,3740,41150,2950,1452,1498
60115,46590,5436,22532,3740,41153,2950,1452,1498
60120,46593,5437,22533,3741,41156,2950,1452,1498
60125,46594,5437,22534,3741,41157,2950,1452,1498
60130,46599,5437,22537,3741,41162,2951,1453,1498
60135,46601,5437,22538,3741,41164,2952,1453,1499
60140,46609,5438,22540,3742,41171,2952,1453,1499
60145,46612,5439,22542,3743,41173,2952,1453,1499
60150,46617,5440,22544,3743,41177,2952,1453,1499
60155,46621,5440,22545,3743,41181,2952,1453,1499
60160,46624,5440,22546,3743,41184,2952,1453,1499
60165,46625,5440,22546,3743,41185,2952,1453,1499
60170,46630,5440,22549,3743,41190,2953,1454,1499
60175,46632,5440,22551,3743,41192,2954,1455,1499
60180,46640,5442,22553,3744,41198,2954,1455,1499
60185,46643,5442,22554,3744,41201,2954,1455,1499
60190,46648,5443,22558,3745,41205,2954,1455,1499
60195,46652,5443,22560,3745,41209,2954,1455,1499
60200,46655,5443,22561,3745,41212,2954,1455,1499
60205,46656,5443,22561,3745,41213,2954,1455,1499
60210,46661,5443,22564,3745,41218,2955,1456,1499
60215,46663,5443,22565,3745,41220,2956,1456,1500
60220,46671,5445,22571,3747,41226,2956,1456,1500
60225,46674,5445,22571,3747,41229,2956,1456,1500
60230,46679,5446,22573,3747,41233,2956,1456,1500
60235,46683,5446,22575,3747,41237,2956,1456,1500
60240,46686,5446,22577,3747,41240,2956,1456,1500
60245,46687,5446,22577,3747,41241,2956,1456,1500
60250,46692,5446,22581,3747,41246,2956,1456,1500
60255,46694,5446,22582,3747,41248,2957,1456,1501
60260,46702,5447,22587,3748,41255,2957,1456,1501
60265,46705,5447,22588,3748,41258,2957,1456,1501
60270,46710,5448,22590,3748,41262,2957,1456,1501
60275,46714,5448,22593,3748,41265,2957,1456,1501
60280,46717,5449,22595,3749,41268,2957,1456,1501
60285,46718,5449,22595,3749,41269,2957,1456,1501
60290,46723,5449,22597,3749,41274,2957,1456,1501
60295,46725,5449,22598,3749,41276,2958,1456,1502
60300,46733,5450,22602,3750,41283,2958,1456,1502
60305,46736,5451,22605,3751,41285,2958,1456,1502
60310,46741,5452,22606,3751,41289,2958,1456,1502
60315,46745,5452,22608,3751,41293,2958,1456,1502
60320,46748,5452,22610,3751,41296,2958,1456,1502
60325,46749,5452,22610,3751,41297,2958,1456,1502
60330,46754,5452,22612,3751,41302,2959,1456,1503
60335,46756,5452,22614,3751,41304,2960,1457,1503
60340,46764,5454,22617,3752,41310,2960,1457,1503
60345,46767,5455,22618,3753,41312,2960,1457,1503
60350,46772,5456,22623,3754,41316,2960,1457,1503
60355,46776,5456,22627,3754,41319,2960,1457,1503
60360,46779,5457,22629,3755,41322,2960,1457,1503
60365,46780,5457,22629,3755,41323,2960,1457,1503
60370,46785,5457,22630,3755,41328,2961,1457,1504
60375,46787,5457,22631,3755,41330,2962,1458,1504
60380,46795,5458,22636,3756,41337,2962,1458,1504
60385,46798,5458,22637,3756,41340,2962,1458,1504
60390,46803,5459,22639,3757,41344,2962,1458,1504
60395,46807,5459,22639,3757,41348,2962,1458,1504
60400,46810,5459,22640,3757,41351,2962,1458,1504
60405,46811,5459,22641,3757,41352,2962,1458,1504
60410,46816,5459,22641,3757,41357,2963,1458,1505
60415,46818,5459,22641,3757,41359,2964,1458,1506
60420,46826,5460,22644,3757,41366,2964,1458,1506
60425,46829,5460,22645,3757,41369,2964,1458,1506
60430,46834,5461,22647,3757,41373,2964,1458,1506
60435,46838,5461,22649,3757,41376,2964,1458,1506
60440,46841,5462,22651,3758,41379,2964,1458,1506
60445,46842,5462,22651,3758,41380,2964,1458,1506
60450,46847,5462,22653,3758,41385,2964,1458,1506
60455,46849,5462,22654,3758,41387,2965,1458,1507
60460,46857,5464,22659,3760,41393,2965,1458,1507
60465,46860,5464,22661,3760,41396,2965,1458,1507
60470,46865,5465,22664,3761,41400,2965,1458,1507
60475,46869,5465,22665,3761,41403,2965,1458,1507
60480,46872,5466,22666,3762,41406,2965,1458,1507
60485,46873,5466,22666,3762,41407,2965,1458,1507
60490,46878,5466,22668,3762,41412,2965,1458,1507
60495,46880,5466,22669,3762,41414,2966,1459,1507
60500,46888,5467,22673,3762,41421,2966,1459,1507
60505,46891,5467,22674,3762,41424,2966,1459,1507
60510,46896,5468,22677,3763,41428,2966,1459,1507
60515,46900,5468,22678,3763,41431,2966,1459,1507
60520,46903,5469,22680,3764,41434,2966,1459,1507
60525,46904,5469,22681,3764,41435,2966,1459,1507
60530,46909,5469,22685,3764,41440,2967,1459,1508
60535,46911,5469,22685,3764,41442,2968,1459,1509
60540,46919,5470,22688,3765,41449,2968,1459,1509
60545,46922,5471,22690,3766,41451,2968,1459,1509
60550,46927,5472,22693,3766,41455,2968,1459,1509
60555,46931,5472,22696,3766,41458,2968,1459,1509
60560,46934,5473,22698,3767,41461,2968,1459,1509
60565,46935,5473,22699,3767,41462,2968,1459,1509
60570,46940,5473,22703,3767,41467,2969,1460,1509
60575,46942,5473,22703,3767,41469,2970,1460,1510
60580,46950,5474,22706,3768,41476,2970,1460,1510
60585,46953,5475,22709,3769,41478,2970,1460,1510
60590,46958,5476,22711,3769,41482,2970,1460,1510
60595,46962,5476,22713,3769,41486,2970,1460,1510
60600,46965,5476,22716,3769,41489,2970,1460,1510
60605,46966,5476,22717,3769,41490,2970,1460,1510
60610,46971,5476,22720,3769,41495,2971,1461,1510
60615,46973,5476,22722,3769,41497,2972,1462,1510
60620,46981,5477,22725,3769,41504,2972,1462,1510
60625,46984,5477,22728,3769,41507,2972,1462,1510
60630,46989,5478,22729,3769,41511,2972,1462,1510
60635,46993,5478,22732,3769,41514,2972,1462,1510
60640,46996,5479,22733,3770,41517,2972,1462,1510
60645,46997,5479,22733,3770,41518,2972,1462,1510
60650,47002,5479,22737,3770,41523,2973,1462,1511
60655,47004,5479,22738,3770,41525,2974,1462,1512
60660,47012,5480,22742,3771,41532,2974,1462,1512
60665,47015,5480,22742,3771,41535,2974,1462,1512
60670,47020,5481,22743,3771,41539,2974,1462,1512
60675,47024,5481,22745,3771,41542,2974,1462,1512
60680,47027,5482,22747,3771,41545,2974,1462,1512
60685,47028,5482,22747,3771,41546,2974,1462,1512
60690,47033,5482,22749,3771,41551,2974,1462,1512
60695,47035,5482,22749,3771,41553,2975,1462,1513
60700,47043,5483,22751,3771,41560,2975,1462,1513
60705,47046,5483,22751,3771,41563,2975,1462,1513
60710,47051,5484,22755,3771,41567,2975,1462,1513
60715,47055,5484,22756,3771,41570,2975,1462,1513
60720,47058,5485,22758,3771,41573,2975,1462,1513
60725,47059,5485,22759,3771,41574,2975,1462,1513
60730,47064,5485,22762,3771,41579,2975,1462,1513
60735,47066,5485,22763,3771,41581,2976,1462,1514
60740,47074,5486,22767,3772,41588,2976,1462,1514
60745,47077,5487,22768,3773,41590,2976,1462,1514
60750,47082,5488,22769,3773,41594,2976,1462,1514
60755,47086,5488,22772,3773,41597,2976,1462,1514
60760,47089,5489,22774,3774,41600,2976,1462,1514
60765,47090,5489,22775,3774,41601,2976,1462,1514
60770,47095,5489,22777,3774,41606,2976,1462,1514
60775,47097,5489,22778,3774,41608,2977,1463,1514
60780,47105,5491,22781,3776,41614,2977,1463,1514
60785,47108,5492,22784,3777,41616,2977,1463,1514
60790,47113,5493,22787,3777,41620,2977,1463,1514
60795,47117,5493,22788,3777,41623,2977,1463,1514
60800,47120,5494,22790,3778,41626,2977,1463,1514
60805,47121,5494,22790,3778,41627,2977,1463,1514
60810,47126,5494,22792,3778,41632,2977,1463,1514
60815,47128,5494,22794,3778,41634,2978,1464,1514
60820,47136,5495,22797,3778,41641,2978,1464,1514
60825,47139,5495,22797,3778,41644,2978,1464,1514
60830,47144,5496,22799,3779,41648,2978,1464,1514
60835,47148,5496,22801,3779,41651,2978,1464,1514
60840,47151,5497,22802,3780,41654,2978,1464,1514
60845,47152,5497,22803,3780,41655,2978,1464,1514
60850,47157,5497,22805,3780,41660,2978,1464,1514
60855,47159,5497,22805,3780,41662,2979,1464,1515
60860,47167,5498,22807,3780,41669,2979,1464,1515
60865,47170,5499,22808,3781,41671,2979,1464,1515
60870,47175,5500,22811,3781,41675,2979,1464,1515
60875,47179,5500,22812,3781,41678,2979,1464,1515
60880,47182,5501,22813,3781,41681,2979,1464,1515
60885,47183,5501,22813,3781,41682,2979,1464,1515
60890,47188,5501,22814,3781,41687,2980,1465,1515
60895,47190,5501,22816,3781,41689,2981,1466,1515
60900,47198,5503,22820,3782,41695,2981,1466,1515
60905,47201,5503,22821,3782,41698,2981,1466,1515
60910,47206,5504,22825,3783,41702,2981,1466,1515
60915,47210,5504,22828,3783,41705,2981,1466,1515
60920,47213,5505,22829,3784,41708,2981,1466,1515
60925,47214,5505,22830,3784,41709,2981,1466,1515
60930,47219,5505,22834,3784,41714,2982,1467,1515
60935,47221,5505,22835,3784,41716,2983,1467,1516
60940,47229,5507,22839,3785,41722,2983,1467,1516
60945,47232,5507,22841,3785,41725,2983,1467,1516
60950,47237,5508,22843,3786,41729,2983,1467,1516
60955,47241,5508,22847,3786,41732,2983,1467,1516
60960,47244,5509,22849,3787,41735,2983,1467,1516
60965,47245,5509,22849,3787,41736,2983,1467,1516
60970,47250,5509,22850,3787,41741,2984,1467,1517
60975,47252,5509,22851,3787,41743,2985,1467,1518
60980,47260,5511,22855,3788,41749,2985,1467,1518
60985,47263,5511,22855,3788,41752,2985,1467,1518
60990,47268,5512,22857,3788,41756,2985,1467,1518
60995,47272,5512,22858,3788,41759,2985,1467,1518
61000,47275,5513,22859,3789,41762,2985,1467,1518
61005,47276,5513,22859,3789,41763,2985,1467,1518
61010,47281,5513,22860,3789,41768,2986,1467,1519
61015,47283,5513,22862,3789,41770,2987,1468,1519
61020,47291,5515,22866,3790,41776,2987,1468,1519
61025,47294,5515,22867,3790,41779,2987,1468,1519
61030,47299,5516,22870,3791,41783,2987,1468,1519
61035,47303,5516,22871,3791,41786,2987,1468,1519
61040,47306,5517,22872,3791,41789,2987,1468,1519
61045,47307,5517,22872,3791,41790,2987,1468,1519
61050,47312,5517,22874,3791,41795,2987,1468,1519
61055,47314,5517,22876,3791,41797,2988,1469,1519
61060,47322,5518,22879,3791,41804,2988,1469,1519
61065,47325,5518,22881,3791,41807,2988,1469,1519
61070,47330,5519,22882,3791,41811,2988,1469,1519
61075,47334,5519,22884,3791,41814,2988,1469,1519
61080,47337,5520,22887,3791,41817,2988,1469,1519
61085,47338,5520,22888,3791,41818,2988,1469,1519
61090,47343,5520,22889,3791,41823,2988,1469,1519
61095,47345,5520,22890,3791,41825,2989,1470,1519
61100,47353,5522,22894,3792,41831,2989,1470,1519
61105,47356,5523,22895,3793,41833,2989,1470,1519
61110,47361,5524,22897,3794,41837,2989,1470,1519
61115,47365,5524,22900,3794,41840,2989,1470,1519
61120,47368,5525,22901,3795,41843,2989,1470,1519
61125,47369,5525,22901,3795,41844,2989,1470,1519
61130,47374,5525,22903,3795,41849,2989,1470,1519
61135,47376,5525,22904,3795,41851,2990,1470,1520
61140,47384,5527,22907,3796,41857,2990,1470,1520
61145,47387,5528,22908,3797,41859,2990,1470,1520
61150,47392,5529,22911,3798,41863,2990,1470,1520
61155,47396,5529,22914,3798,41866,2990,1470,1520
61160,47399,5530,22915,3799,41869,2990,1470,1520
61165,47400,5530,22915,3799,41870,2990,1470,1520
61170,47405,5530,22916,3799,41875,2991,1471,1520
61175,47407,5530,22917,3799,41877,2992,1472,1520
61180,47415,5532,22920,3800,41883,2992,1472,1520
61185,47418,5532,22921,3800,41886,2992,1472,1520
61190,47423,5533,22923,3801,41890,2992,1472,1520
61195,47427,5533,22925,3801,41893,2992,1472,1520
61200,47430,5534,22925,3802,41896,2992,1472,1520
61205,47431,5534,22925,3802,41897,2992,1472,1520
61210,47436,5534,22925,3802,41902,2993,1472,1521
61215,47438,5534,22926,3802,41904,2994,1473,1521
61220,47446,5536,22929,3804,41910,2994,1473,1521
61225,47449,5536,22929,3804,41913,2994,1473,1521
61230,47454,5537,22931,3804,41917,2994,1473,1521
61235,47458,5537,22933,3804,41920,2994,1473,1521
61240,47461,5538,22935,3805,41923,2994,1473,1521
61245,47462,5538,22936,3805,41924,2994,1473,1521
61250,47467,5538,22939,3805,41929,2995,1473,1522
61255,47469,5538,22940,3805,41931,2996,1473,1523
61260,47477,5540,22942,3806,41937,2996,1473,1523
61265,47480,5540,22943,3806,41940,2996,1473,1523
61270,47485,5541,22946,3807,41944,2996,1473,1523
61275,47489,5541,22947,3807,41947,2996,1473,1523
61280,47492,5542,22950,3807,41950,2996,1473,1523
61285,47493,5542,22951,3807,41951,2996,1473,1523
61290,47498,5542,22955,3807,41956,2996,1473,1523
61295,47500,5542,22956,3807,41958,2997,1474,1523
61300,47508,5544,22959,3808,41964,2997,1474,1523
61305,47511,5544,22960,3808,41967,2997,1474,1523
61310,47516,5545,22961,3808,41971,2997,1474,1523
61315,47520,5545,22961,3808,41974,2997,1474,1523
61320,47523,5546,22961,3808,41977,2997,1474,1523
61325,47524,5546,22962,3808,41978,2997,1474,1523
61330,47529,5546,22963,3808,41983,2997,1474,1523
61335,47531,5546,22964,3808,41985,2998,1474,1524
61340,47539,5547,22965,3809,41992,2998,1474,1524
61345,47542,5548,22968,3810,41994,2998,1474,1524
61350,47547,5549,22968,3810,41998,2998,1474,1524
61355,47551,5549,22970,3810,42001,2998,1474,1524
61360,47554,5550,22971,3811,42004,2998,1474,1524
61365,47555,5550,22972,3811,42005,2998,1474,1524
61370,47560,5550,22974,3811,42010,2999,1474,1525
61375,47562,5550,22974,3811,42012,3000,1474,1526
61380,47570,5551,22976,3812,42019,3000,1474,1526
61385,47573,5552,22978,3813,42021,3000,1474,1526
61390,47578,5553,22982,3814,42025,3000,1474,1526
61395,47582,5553,22983,3814,42028,3000,1474,1526
61400,47585,5554,22985,3814,42031,3000,1474,1526
61405,47586,5554,22986,3814,42032,3000,1474,1526
61410,47591,5554,22988,3814,42037,3001,1474,1527
61415,47593,5554,22989,3814,42039,3002,1474,1528
61420,47601,5556,22994,3816,42045,3002,1474,1528
61425,47604,5557,22997,3817,42047,3002,1474,1528
61430,47609,5558,22999,3818,42051,3002,1474,1528
61435,47613,5558,23001,3818,42054,3002,1474,1528
61440,47616,5559,23004,3818,42057,3002,1474,1528
61445,47617,5559,23004,3818,42058,3002,1474,1528
61450,47622,5559,23005,3818,42063,3002,1474,1528
61455,47624,5559,23007,3818,42065,3003,1475,1528
61460,47632,5559,23011,3818,42073,3003,1475,1528
61465,47635,5559,23014,3818,42076,3003,1475,1528
61470,47640,5560,23017,3819,42080,3003,1475,1528
61475,47644,5560,23018,3819,42083,3003,1475,1528
61480,47647,5561,23019,3820,42086,3003,1475,1528
61485,47648,5561,23019,3820,42087,3003,1475,1528
61490,47653,5561,23022,3820,42092,3003,1475,1528
61495,47655,5561,23023,3820,42094,3004,1476,1528
61500,47663,5561,23026,3820,42102,3004,1476,1528
61505,47666,5561,23028,3820,42105,3004,1476,1528
61510,47671,5562,23029,3820,42109,3004,1476,1528
61515,47675,5562,23032,3820,42112,3004,1476,1528
61520,47678,5563,23035,3821,42115,3004,1476,1528
61525,47679,5563,23036,3821,42116,3004,1476,1528
61530,47684,5563,23039,3821,42121,3004,1476,1528
61535,47686,5563,23040,3821,42123,3005,1476,1529
61540,47694,5563,23044,3821,42131,3005,1476,1529
61545,47697,5563,23045,3821,42134,3005,1476,1529
61550,47702,5564,23048,3821,42138,3005,1476,1529
61555,47706,5564,23051,3821,42141,3005,1476,1529
61560,47709,5565,23052,3822,42144,3005,1476,1529
61565,47710,5565,23053,3822,42145,3005,1476,1529
61570,47715,5565,23057,3822,42150,3005,1476,1529
61575,47717,5565,23058,3822,42152,3006,1476,1530
61580,47725,5565,23062,3822,42160,3006,1476,1530
61585,47728,5565,23065,3822,42163,3006,1476,1530
61590,47733,5566,23068,3822,42167,3006,1476,1530
61595,47737,5566,23070,3822,42170,3006,1476,1530
61600,47740,5567,23071,3822,42173,3006,1476,1530
61605,47741,5567,23072,3822,42174,3006,1476,1530
61610,47746,5567,23076,3822,42179,3006,1476,1530
61615,47748,5567,23077,3822,42181,3007,1477,1530
61620,47756,5567,23081,3822,42189,3007,1477,1530
61625,47759,5567,23083,3822,42192,3007,1477,1530
61630,47764,5568,23086,3822,42196,3007,1477,1530
61635,47768,5568,23087,3822,42199,3007,1477,1530
61640,47771,5569,23089,3822,42202,3007,1477,1530
61645,47772,5569,23089,3822,42203,3007,1477,1530
61650,47777,5569,23092,3822,42208,3008,1478,1530
61655,47779,5569,23093,3822,42210,3009,1479,1530
61660,47787,5569,23096,3822,42218,3009,1479,1530
61665,47790,5569,23097,3822,42221,3009,1479,1530
61670,47795,5570,23101,3823,42225,3009,1479,1530
61675,47799,5570,23104,3823,42228,3009,1479,1530
61680,47802,5571,23105,3824,42231,3009,1479,1530
61685,47803,5571,23106,3824,42232,3009,1479,1530
61690,47808,5571,23108,3824,42237,3009,1479,1530
61695,47810,5571,23109,3824,42239,3010,1480,1530
61700,47818,5571,23112,3824,42247,3010,1480,1530
61705,47821,5571,23114,3824,42250,3010,1480,1530
61710,47826,5572,23117,3825,42254,3010,1480,1530
61715,47830,5572,23120,3825,42258,3010,1480,1530
61720,47833,5572,23122,3825,42261,3010,1480,1530
61725,47834,5572,23123,3825,42262,3010,1480,1530
61730,47839,5572,23125,3825,42267,3010,1480,1530
61735,47841,5572,23126,3825,42269,3011,1481,1530
61740,47849,5572,23130,3825,42277,3011,1481,1530
61745,47852,5572,23131,3825,42280,3011,1481,1530
61750,47857,5573,23133,3825,42284,3011,1481,1530
61755,47861,5573,23135,3825,42288,3011,1481,1530
61760,47864,5573,23137,3825,42291,3011,1481,1530
61765,47865,5573,23138,3825,42292,3011,1481,1530
61770,47870,5573,23139,3825,42297,3011,1481,1530
61775,47872,5573,23140,3825,42299,3012,1481,1531
61780,47880,5573,23143,3825,42307,3012,1481,1531
61785,47883,5573,23143,3825,42310,3012,1481,1531
61790,47888,5574,23144,3826,42314,3012,1481,1531
61795,47892,5574,23145,3826,42318,3012,1481,1531
61800,47895,5574,23146,3826,42321,3012,1481,1531
61805,47896,5574,23146,3826,42322,3012,1481,1531
61810,47901,5574,23148,3826,42327,3013,1481,1532
61815,47903,5574,23149,3826,42329,3014,1482,1532
61820,47911,5574,23149,3826,42337,3014,1482,1532
61825,47914,5574,23150,3826,42340,3014,1482,1532
61830,47919,5575,23153,3827,42344,3014,1482,1532
61835,47923,5575,23156,3827,42348,3014,1482,1532
61840,47926,5575,23157,3827,42351,3014,1482,1532
61845,47927,5575,23157,3827,42352,3014,1482,1532
61850,47932,5575,23159,3827,42357,3015,1482,1533
61855,47934,5575,23160,3827,42359,3016,1482,1534
61860,47942,5575,23166,3827,42367,3016,1482,1534
61865,47945,5575,23167,3827,42370,3016,1482,1534
61870,47950,5576,23170,3828,42374,3016,1482,1534
61875,47954,5576,23172,3828,42378,3016,1482,1534
61880,47957,5576,23174,3828,42381,3016,1482,1534
61885,47958,5576,23174,3828,42382,3016,1482,1534
61890,47963,5576,23177,3828,42387,3016,1482,1534
61895,47965,5576,23178,3828,42389,3017,1482,1535
61900,47973,5576,23180,3828,42397,3017,1482,1535
61905,47976,5576,23181,3828,42400,3017,1482,1535
61910,47981,5577,23184,3828,42404,3017,1482,1535
61915,47985,5577,23186,3828,42408,3017,1482,1535
61920,47988,5577,23188,3828,42411,3017,1482,1535
61925,47989,5577,23189,3828,42412,3017,1482,1535
61930,47994,5577,23192,3828,42417,3017,1482,1535
61935,47996,5577,23192,3828,42419,3018,1482,1536
61940,48004,5577,23195,3828,42427,3018,1482,1536
61945,48007,5577,23196,3828,42430,3018,1482,1536
61950,48012,5578,23200,3828,42434,3018,1482,1536
61955,48016,5578,23202,3828,42438,3018,1482,1536
61960,48019,5578,23203,3828,42441,3018,1482,1536
61965,48020,5578,23204,3828,42442,3018,1482,1536
61970,48025,5578,23206,3828,42447,3019,1483,1536
61975,48027,5578,23206,3828,42449,3020,1483,1537
61980,48035,5578,23209,3828,42457,3020,1483,1537
61985,48038,5578,23212,3828,42460,3020,1483,1537
61990,48043,5579,23216,3829,42464,3020,1483,1537
61995,48047,5579,23217,3829,42468,3020,1483,1537
62000,48050,5579,23219,3829,42471,3020,1483,1537
62005,48051,5579,23219,3829,42472,3020,1483,1537
62010,48056,5579,23222,3829,42477,3021,1483,1538
62015,48058,5579,23224,3829,42479,3022,1484,1538
62020,48066,5579,23226,3829,42487,3022,1484,1538
62025,48069,5579,23228,3829,42490,3022,1484,1538
62030,48074,5580,23231,3829,42494,3022,1484,1538
62035,48078,5580,23232,3829,42498,3022,1484,1538
62040,48081,5580,23234,3829,42501,3022,1484,1538
62045,48082,5580,23235,3829,42502,3022,1484,1538
62050,48087,5580,23235,3829,42507,3022,1484,1538
62055,48089,5580,23235,3829,42509,3023,1484,1539
62060,48097,5580,23241,3829,42517,3023,1484,1539
62065,48100,5580,23243,3829,42520,3023,1484,1539
62070,48105,5581,23246,3830,42524,3023,1484,1539
62075,48109,5581,23246,3830,42528,3023,1484,1539
62080,48112,5581,23249,3830,42531,3023,1484,1539
62085,48113,5581,23249,3830,42532,3023,1484,1539
62090,48118,5581,23252,3830,42537,3023,1484,1539
62095,48120,5581,23253,3830,42539,3024,1485,1539
62100,48128,5581,23256,3830,42547,3024,1485,1539
62105,48131,5581,23259,3830,42550,3024,1485,1539
62110,48136,5582,23262,3831,42554,3024,1485,1539
62115,48140,5582,23265,3831,42558,3024,1485,1539
62120,48143,5582,23266,3831,42561,3024,1485,1539
62125,48144,5582,23267,3831,42562,3024,1485,1539
62130,48149,5582,23271,3831,42567,3025,1485,1540
62135,48151,5582,23272,3831,42569,3026,1485,1541
62140,48159,5582,23277,3831,42577,3026,1485,1541
62145,48162,5582,23277,3831,42580,3026,1485,1541
62150,48167,5583,23281,3832,42584,3026,1485,1541
62155,48171,5583,23285,3832,42588,3026,1485,1541
62160,48174,5583,23286,3832,42591,3026,1485,1541
62165,48175,5583,23287,3832,42592,3026,1485,1541
62170,48180,5583,23289,3832,42597,3027,1486,1541
62175,48182,5583,23290,3832,42599,3028,1487,1541
62180,48190,5583,23291,3832,42607,3028,1487,1541
62185,48193,5583,23293,3832,42610,3028,1487,1541
62190,48198,5584,23295,3833,42614,3028,1487,1541
62195,48202,5584,23296,3833,42618,3028,1487,1541
62200,48205,5584,23296,3833,42621,3028,1487,1541
62205,48206,5584,23297,3833,42622,3028,1487,1541
62210,48211,5584,23297,3833,42627,3029,1487,1542
62215,48213,5584,23299,3833,42629,3030,1488,1542
62220,48221,5584,23302,3833,42637,3030,1488,1542
62225,48224,5584,23302,3833,42640,3030,1488,1542
62230,48229,5585,23304,3834,42644,3030,1488,1542
62235,48233,5585,23306,3834,42648,3030,1488,1542
62240,48236,5585,23307,3834,42651,3030,1488,1542
62245,48237,5585,23308,3834,42652,3030,1488,1542
62250,48242,5585,23313,3834,42657,3030,1488,1542
62255,48244,5585,23314,3834,42659,3031,1489,1542
62260,48252,5585,23317,3834,42667,3031,1489,1542
62265,48255,5585,23318,3834,42670,3031,1489,1542
62270,48260,5586,23322,3835,42674,3031,1489,1542
62275,48264,5586,23323,3835,42678,3031,1489,1542
62280,48267,5586,23324,3835,42681,3031,1489,1542
62285,48268,5586,23325,3835,42682,3031,1489,1542
62290,48273,5586,23329,3835,42687,3031,1489,1542
62295,48275,5586,23330,3835,42689,3032,1489,1543
62300,48283,5586,23333,3835,42697,3032,1489,1543
62305,48286,5586,23335,3835,42700,3032,1489,1543
62310,48291,5587,23337,3836,42704,3032,1489,1543
62315,48295,5587,23338,3836,42708,3032,1489,1543
62320,48298,5587,23340,3836,42711,3032,1489,1543
62325,48299,5587,23341,3836,42712,3032,1489,1543
62330,48304,5587,23342,3836,42717,3033,1489,1544
62335,48306,5587,23343,3836,42719,3034,1490,1544
62340,48314,5587,23348,3836,42727,3034,1490,1544
62345,48317,5587,23350,3836,42730,3034,1490,1544
62350,48322,5588,23352,3837,42734,3034,1490,1544
62355,48326,5588,23353,3837,42738,3034,1490,1544
62360,48329,5588,23355,3837,42741,3034,1490,1544
62365,48330,5588,23356,3837,42742,3034,1490,1544
62370,48335,5588,23357,3837,42747,3035,1490,1545
62375,48337,5588,23358,3837,42749,3036,1490,1546
62380,48345,5588,23364,3837,42757,3036,1490,1546
62385,48348,5588,23365,3837,42760,3036,1490,1546
62390,48353,5589,23369,3838,42764,3036,1490,1546
62395,48357,5589,23371,3838,42768,3036,1490,1546
62400,48360,5589,23372,3838,42771,3036,1490,1546
62405,48361,5589,23373,3838,42772,3036,1490,1546
62410,48366,5589,23374,3838,42777,3036,1490,1546
62415,48368,5589,23374,3838,42779,3037,1490,1547
62420,48376,5589,23376,3838,42787,3037,1490,1547
62425,48379,5589,23377,3838,42790,3037,1490,1547
62430,48384,5590,23380,3839,42794,3037,1490,1547
62435,48388,5590,23381,3839,42798,3037,1490,1547
62440,48391,5590,23382,3839,42801,3037,1490,1547
62445,48392,5590,23382,3839,42802,3037,1490,1547
62450,48397,5590,23385,3839,42807,3037,1490,1547
62455,48399,5590,23385,3839,42809,3038,1490,1548
62460,48407,5590,23389,3839,42817,3038,1490,1548
62465,48410,5590,23389,3839,42820,3038,1490,1548
62470,48415,5591,23390,3839,42824,3038,1490,1548
62475,48419,5591,23394,3839,42828,3038,1490,1548
62480,48422,5591,23396,3839,42831,3038,1490,1548
62485,48423,5591,23397,3839,42832,3038,1490,1548
62490,48428,5591,23399,3839,42837,3039,1491,1548
62495,48430,5591,23399,3839,42839,3040,1491,1549
62500,48438,5591,23404,3839,42847,3040,1491,1549
62505,48441,5591,23405,3839,42850,3040,1491,1549
62510,48446,5592,23408,3840,42854,3040,1491,1549
62515,48450,5592,23411,3840,42858,3040,1491,1549
62520,48453,5592,23411,3840,42861,3040,1491,1549
62525,48454,5592,23412,3840,42862,3040,1491,1549
62530,48459,5592,23415,3840,42867,3041,1492,1549
62535,48461,5592,23416,3840,42869,3042,1493,1549
62540,48469,5592,23420,3840,42877,3042,1493,1549
62545,48472,5592,23422,3840,42880,3042,1493,1549
62550,48477,5593,23424,3841,42884,3042,1493,1549
62555,48481,5593,23426,3841,42888,3042,1493,1549
62560,48484,5593,23428,3841,42891,3042,1493,1549
62565,48485,5593,23428,3841,42892,3042,1493,1549
62570,48490,5593,23431,3841,42897,3043,1494,1549
62575,48492,5593,23432,3841,42899,3044,1495,1549
62580,48500,5593,23436,3841,42907,3044,1495,1549
62585,48503,5593,23437,3841,42910,3044,1495,1549
62590,48508,5594,23439,3841,42914,3044,1495,1549
62595,48512,5594,23442,3841,42918,3044,1495,1549
62600,48515,5594,23443,3841,42921,3044,1495,1549
62605,48516,5594,23443,3841,42922,3044,1495,1549
62610,48521,5594,23446,3841,42927,3044,1495,1549
62615,48523,5594,23447,3841,42929,3045,1496,1549
62620,48531,5594,23451,3841,42937,3045,1496,1549
62625,48534,5594,23453,3841,42940,3045,1496,1549
62630,48539,5595,23456,3841,42944,3045,1496,1549
62635,48543,5595,23458,3841,42948,3045,1496,1549
62640,48546,5595,23460,3841,42951,3045,1496,1549
62645,48547,5595,23460,3841,42952,3045,1496,1549
62650,48552,5595,23462,3841,42957,3045,1496,1549
62655,48554,5595,23464,3841,42959,3046,1497,1549
62660,48562,5595,23467,3841,42967,3046,1497,1549
62665,48565,5595,23470,3841,42970,3046,1497,1549
62670,48570,5596,23471,3842,42974,3046,1497,1549
62675,48574,5596,23471,3842,42978,3046,1497,1549
62680,48577,5596,23472,3842,42981,3046,1497,1549
62685,48578,5596,23473,3842,42982,3046,1497,1549
62690,48583,5596,23473,3842,42987,3047,1497,1550
62695,48585,5596,23474,3842,42989,3048,1497,1551
62700,48593,5596,23477,3842,42997,3048,1497,1551
62705,48596,5596,23479,3842,43000,3048,1497,1551
62710,48601,5597,23482,3842,43004,3048,1497,1551
62715,48605,5597,23482,3842,43008,3048,1497,1551
62720,48608,5597,23483,3842,43011,3048,1497,1551
62725,48609,5597,23483,3842,43012,3048,1497,1551
62730,48614,5597,23487,3842,43017,3048,1497,1551
62735,48616,5597,23489,3842,43019,3049,1498,1551
62740,48624,5597,23493,3842,43027,3049,1498,1551
62745,48627,5597,23494,3842,43030,3049,1498,1551
62750,48632,5598,23496,3842,43034,3049,1498,1551
62755,48636,5598,23500,3842,43038,3049,1498,1551
62760,48639,5598,23501,3842,43041,3049,1498,1551
62765,48640,5598,23501,3842,43042,3049,1498,1551
62770,48645,5598,23505,3842,43047,3049,1498,1551
62775,48647,5598,23505,3842,43049,3050,1498,1552
62780,48655,5598,23509,3842,43057,3050,1498,1552
62785,48658,5598,23511,3842,43060,3050,1498,1552
62790,48663,5599,23513,3842,43064,3050,1498,1552
62795,48667,5599,23514,3842,43068,3050,1498,1552
62800,48670,5599,23516,3842,43071,3050,1498,1552
62805,48671,5599,23516,3842,43072,3050,1498,1552
62810,48676,5599,23520,3842,43077,3050,1498,1552
62815,48678,5599,23522,3842,43079,3051,1499,1552
62820,48686,5599,23527,3842,43087,3051,1499,1552
62825,48689,5599,23527,3842,43090,3051,1499,1552
62830,48694,5600,23530,3842,43094,3051,1499,1552
62835,48698,5600,23531,3842,43098,3051,1499,1552
62840,48701,5600,23534,3842,43101,3051,1499,1552
62845,48702,5600,23534,3842,43102,3051,1499,1552
62850,48707,5600,23536,3842,43107,3052,1500,1552
62855,48709,5600,23537,3842,43109,3053,1501,1552
62860,48717,5600,23541,3842,43117,3053,1501,1552
62865,48720,5600,23542,3842,43120,3053,1501,1552
62870,48725,5601,23545,3843,43124,3053,1501,1552
62875,48729,5601,23547,3843,43128,3053,1501,1552
62880,48732,5601,23550,3843,43131,3053,1501,1552
62885,48733,5601,23551,3843,43132,3053,1501,1552
62890,48738,5601,23554,3843,43137,3053,1501,1552
62895,48740,5601,23555,3843,43139,3054,1502,1552
62900,48748,5601,23560,3843,43147,3054,1502,1552
62905,48751,5601,23561,3843,43150,3054,1502,1552
62910,48756,5602,23563,3844,43154,3054,1502,1552
62915,48760,5602,23564,3844,43158,3054,1502,1552
62920,48763,5602,23566,3844,43161,3054,1502,1552
62925,48764,5602,23566,3844,43162,3054,1502,1552
62930,48769,5602,23570,3844,43167,3054,1502,1552
62935,48771,5602,23570,3844,43169,3055,1502,1553
62940,48779,5602,23574,3844,43177,3055,1502,1553
62945,48782,5602,23576,3844,43180,3055,1502,1553
62950,48787,5603,23577,3844,43184,3055,1502,1553
62955,48791,5603,23579,3844,43188,3055,1502,1553
62960,48794,5603,23579,3844,43191,3055,1502,1553
62965,48795,5603,23580,3844,43192,3055,1502,1553
62970,48800,5603,23580,3844,43197,3056,1502,1554
62975,48802,5603,23581,3844,43199,3057,1502,1555
62980,48810,5603,23584,3844,43207,3057,1502,1555
62985,48813,5603,23586,3844,43210,3057,1502,1555
62990,48818,5604,23589,3844,43214,3057,1502,1555
62995,48822,5604,23591,3844,43218,3057,1502,1555
63000,48825,5604,23594,3844,43221,3057,1502,1555
63005,48826,5604,23594,3844,43222,3057,1502,1555
63010,48831,5604,23598,3844,43227,3058,1503,1555
63015,48833,5604,23599,3844,43229,3059,1503,1556
63020,48841,5604,23602,3844,43237,3059,1503,1556
63025,48844,5604,23604,3844,43240,3059,1503,1556
63030,48849,5605,23605,3844,43244,3059,1503,1556
63035,48853,5605,23607,3844,43248,3059,1503,1556
63040,48856,5605,23607,3844,43251,3059,1503,1556
63045,48857,5605,23607,3844,43252,3059,1503,1556
63050,48862,5605,23608,3844,43257,3060,1504,1556
63055,48864,5605,23608,3844,43259,3061,1504,1557
63060,48872,5605,23610,3844,43267,3061,1504,1557
63065,48875,5605,23611,3844,43270,3061,1504,1557
63070,48880,5606,23613,3844,43274,3061,1504,1557
63075,48884,5606,23616,3844,43278,3061,1504,1557
63080,48887,5606,23617,3844,43281,3061,1504,1557
63085,48888,5606,23617,3844,43282,3061,1504,1557
63090,48893,5606,23619,3844,43287,3061,1504,1557
63095,48895,5606,23619,3844,43289,3062,1504,1558
63100,48903,5606,23623,3844,43297,3062,1504,1558
63105,48906,5606,23623,3844,43300,3062,1504,1558
63110,48911,5607,23624,3844,43304,3062,1504,1558
63115,48915,5607,23627,3844,43308,3062,1504,1558
63120,48918,5607,23628,3844,43311,3062,1504,1558
63125,48919,5607,23628,3844,43312,3062,1504,1558
63130,48924,5607,23630,3844,43317,3063,1504,1559
63135,48926,5607,23631,3844,43319,3064,1505,1559
63140,48934,5607,23638,3844,43327,3064,1505,1559
63145,48937,5607,23640,3844,43330,3064,1505,1559
63150,48942,5608,23641,3844,43334,3064,1505,1559
63155,48946,5608,23642,3844,43338,3064,1505,1559
63160,48949,5608,23642,3844,43341,3064,1505,1559
63165,48950,5608,23643,3844,43342,3064,1505,1559
63170,48955,5608,23647,3844,43347,3064,1505,1559
63175,48957,5608,23649,3844,43349,3064,1505,1559
63180,48965,5608,23651,3844,43357,3064,1505,1559
63185,48968,5608,23653,3844,43360,3064,1505,1559
63190,48973,5609,23654,3845,43364,3064,1505,1559
63195,48977,5609,23656,3845,43368,3064,1505,1559
63200,48980,5609,23656,3845,43371,3064,1505,1559
63205,48981,5609,23656,3845,43372,3064,1505,1559
63210,48986,5609,23657,3845,43377,3064,1505,1559
63215,48988,5609,23657,3845,43379,3064,1505,1559
63220,48996,5609,23661,3845,43387,3064,1505,1559
63225,48999,5609,23662,3845,43390,3064,1505,1559
63230,49004,5610,23665,3846,43394,3064,1505,1559
63235,49008,5610,23669,3846,43398,3064,1505,1559
63240,49011,5610,23672,3846,43401,3064,1505,1559
63245,49012,5610,23673,3846,43402,3064,1505,1559
63250,49017,5610,23677,3846,43407,3065,1506,1559
63255,49019,5610,23679,3846,43409,3065,1506,1559
63260,49027,5610,23681,3846,43417,3065,1506,1559
63265,49030,5610,23683,3846,43420,3065,1506,1559
63270,49035,5611,23685,3846,43424,3065,1506,1559
63275,49039,5611,23686,3846,43428,3065,1506,1559
63280,49042,5611,23688,3846,43431,3065,1506,1559
63285,49043,5611,23688,3846,43432,3065,1506,1559
63290,49048,5611,23693,3846,43437,3065,1506,1559
63295,49050,5611,23694,3846,43439,3065,1506,1559
63300,49058,5611,23700,3846,43447,3065,1506,1559
63305,49061,5611,23702,3846,43450,3065,1506,1559
63310,49066,5612,23704,3846,43454,3065,1506,1559
63315,49070,5612,23705,3846,43458,3065,1506,1559
63320,49073,5612,23706,3846,43461,3065,1506,1559
63325,49074,5612,23706,3846,43462,3065,1506,1559
63330,49079,5612,23709,3846,43467,3065,1506,1559
63335,49081,5612,23710,3846,43469,3065,1506,1559
63340,49089,5612,23715,3846,43477,3065,1506,1559
63345,49092,5612,23716,3846,43480,3065,1506,1559
63350,49097,5613,23720,3846,43484,3065,1506,1559
63355,49101,5613,23723,3846,43488,3065,1506,1559
63360,49104,5613,23725,3846,43491,3065,1506,1559
63365,49105,5613,23725,3846,43492,3065,1506,1559
63370,49110,5613,23727,3846,43497,3066,1507,1559
63375,49112,5613,23729,3846,43499,3066,1507,1559
63380,49120,5613,23733,3846,43507,3066,1507,1559
63385,49123,5613,23734,3846,43510,3066,1507,1559
63390,49128,5614,23737,3846,43514,3066,1507,1559
63395,49132,5614,23739,3846,43518,3066,1507,1559
63400,49135,5614,23740,3846,43521,3066,1507,1559
63405,49136,5614,23741,3846,43522,3066,1507,1559
63410,49141,5614,23743,3846,43527,3066,1507,1559
63415,49143,5614,23743,3846,43529,3066,1507,1559
63420,49151,5614,23748,3846,43537,3066,1507,1559
63425,49154,5614,23749,3846,43540,3066,1507,1559
63430,49159,5615,23753,3847,43544,3066,1507,1559
63435,49163,5615,23757,3847,43548,3066,1507,1559
63440,49166,5615,23760,3847,43551,3066,1507,1559
63445,49167,5615,23761,3847,43552,3066,1507,1559
63450,49172,5615,23762,3847,43557,3066,1507,1559
63455,49174,5615,23762,3847,43559,3066,1507,1559
63460,49182,5615,23764,3847,43567,3066,1507,1559
63465,49185,5615,23766,3847,43570,3066,1507,1559
63470,49190,5616,23769,3847,43574,3066,1507,1559
63475,49194,5616,23770,3847,43578,3066,1507,1559
63480,49197,5616,23770,3847,43581,3066,1507,1559
63485,49198,5616,23770,3847,43582,3066,1507,1559
63490,49203,5616,23772,3847,43587,3067,1507,1560
63495,49205,5616,23774,3847,43589,3067,1507,1560
63500,49213,5616,23776,3847,43597,3067,1507,1560
63505,49216,5616,23777,3847,43600,3067,1507,1560
63510,49221,5617,23781,3848,43604,3067,1507,1560
63515,49225,5617,23784,3848,43608,3067,1507,1560
63520,49228,5617,23786,3848,43611,3067,1507,1560
63525,49229,5617,23786,3848,43612,3067,1507,1560
63530,49234,5617,23790,3848,43617,3067,1507,1560
63535,49236,5617,23792,3848,43619,3067,1507,1560
63540,49244,5617,23796,3848,43627,3067,1507,1560
63545,49247,5617,23796,3848,43630,3067,1507,1560
63550,49252,5618,23797,3848,43634,3067,1507,1560
63555,49256,5618,23799,3848,43638,3067,1507,1560
63560,49259,5618,23802,3848,43641,3067,1507,1560
63565,49260,5618,23803,3848,43642,3067,1507,1560
63570,49265,5618,23806,3848,43647,3068,1507,1561
63575,49267,5618,23806,3848,43649,3068,1507,1561
63580,49275,5618,23811,3848,43657,3068,1507,1561
63585,49278,5618,23812,3848,43660,3068,1507,1561
63590,49283,5619,23815,3848,43664,3068,1507,1561
63595,49287,5619,23816,3848,43668,3068,1507,1561
63600,49290,5619,23817,3848,43671,3068,1507,1561
63605,49291,5619,23817,3848,43672,3068,1507,1561
63610,49296,5619,23820,3848,43677,3068,1507,1561
63615,49298,5619,23820,3848,43679,3068,1507,1561
63620,49306,5619,23823,3848,43687,3068,1507,1561
63625,49309,5619,23825,3848,43690,3068,1507,1561
63630,49314,5620,23827,3848,43694,3068,1507,1561
63635,49318,5620,23828,3848,43698,3068,1507,1561
63640,49321,5620,23830,3848,43701,3068,1507,1561
63645,49322,5620,23831,3848,43702,3068,1507,1561
63650,49327,5620,23833,3848,43707,3068,1507,1561
63655,49329,5620,23833,3848,43709,3068,1507,1561
63660,49337,5620,23835,3848,43717,3068,1507,1561
63665,49340,5620,23837,3848,43720,3068,1507,1561
63670,49345,5621,23839,3848,43724,3068,1507,1561
63675,49349,5621,23840,3848,43728,3068,1507,1561
63680,49352,5621,23842,3848,43731,3068,1507,1561
63685,49353,5621,23842,3848,43732,3068,1507,1561
63690,49358,5621,23845,3848,43737,3068,1507,1561
63695,49360,5621,23847,3848,43739,3068,1507,1561
63700,49368,5621,23850,3848,43747,3068,1507,1561
63705,49371,5621,23852,3848,43750,3068,1507,1561
63710,49376,5622,23855,3848,43754,3068,1507,1561
63715,49380,5622,23858,3848,43758,3068,1507,1561
63720,49383,5622,23860,3848,43761,3068,1507,1561
63725,49384,5622,23860,3848,43762,3068,1507,1561
63730,49389,5622,23864,3848,43767,3069,1507,1562
63735,49391,5622,23864,3848,43769,3069,1507,1562
63740,49399,5622,23869,3848,43777,3069,1507,1562
63745,49402,5622,23869,3848,43780,3069,1507,1562
63750,49407,5623,23873,3849,43784,3069,1507,1562
63755,49411,5623,23876,3849,43788,3069,1507,1562
63760,49414,5623,23876,3849,43791,3069,1507,1562
63765,49415,5623,23877,3849,43792,3069,1507,1562
63770,49420,5623,23881,3849,43797,3070,1508,1562
63775,49422,5623,23883,3849,43799,3070,1508,1562
63780,49430,5623,23884,3849,43807,3070,1508,1562
63785,49433,5623,23886,3849,43810,3070,1508,1562
63790,49438,5624,23888,3850,43814,3070,1508,1562
63795,49442,5624,23890,3850,43818,3070,1508,1562
63800,49445,5624,23892,3850,43821,3070,1508,1562
63805,49446,5624,23893,3850,43822,3070,1508,1562
63810,49451,5624,23894,3850,43827,3070,1508,1562
63815,49453,5624,23895,3850,43829,3070,1508,1562
63820,49461,5624,23899,3850,43837,3070,1508,1562
63825,49464,5624,23901,3850,43840,3070,1508,1562
63830,49469,5625,23902,3850,43844,3070,1508,1562
63835,49473,5625,23903,3850,43848,3070,1508,1562
63840,49476,5625,23904,3850,43851,3070,1508,1562
63845,49477,5625,23904,3850,43852,3070,1508,1562
63850,49482,5625,23908,3850,43857,3070,1508,1562
63855,49484,5625,23909,3850,43859,3070,1508,1562
63860,49492,5625,23912,3850,43867,3070,1508,1562
63865,49495,5625,23913,3850,43870,3070,1508,1562
63870,49500,5626,23916,3851,43874,3070,1508,1562
63875,49504,5626,23918,3851,43878,3070,1508,1562
63880,49507,5626,23920,3851,43881,3070,1508,1562
63885,49508,5626,23921,3851,43882,3070,1508,1562
63890,49513,5626,23923,3851,43887,3071,1508,1563
63895,49515,5626,23923,3851,43889,3071,1508,1563
63900,49523,5626,23928,3851,43897,3071,1508,1563
63905,49526,5626,23930,3851,43900,3071,1508,1563
63910,49531,5627,23930,3851,43904,3071,1508,1563
63915,49535,5627,23931,3851,43908,3071,1508,1563
63920,49538,5627,23932,3851,43911,3071,1508,1563
63925,49539,5627,23933,3851,43912,3071,1508,1563
63930,49544,5627,23937,3851,43917,3072,1509,1563
63935,49546,5627,23939,3851,43919,3072,1509,1563
63940,49554,5627,23942,3851,43927,3072,1509,1563
63945,49557,5627,23944,3851,43930,3072,1509,1563
63950,49562,5628,23945,3851,43934,3072,1509,1563
63955,49566,5628,23947,3851,43938,3072,1509,1563
63960,49569,5628,23948,3851,43941,3072,1509,1563
63965,49570,5628,23948,3851,43942,3072,1509,1563
63970,49575,5628,23950,3851,43947,3072,1509,1563
63975,49577,5628,23950,3851,43949,3072,1509,1563
63980,49585,5628,23954,3851,43957,3072,1509,1563
63985,49588,5628,23955,3851,43960,3072,1509,1563
63990,49593,5629,23959,3852,43964,3072,1509,1563
63995,49597,5629,23963,3852,43968,3072,1509,1563
64000,49600,5629,23965,3852,43971,3072,1509,1563
64005,49601,5629,23965,3852,43972,3072,1509,1563
64010,49606,5629,23968,3852,43977,3072,1509,1563
64015,49608,5629,23969,3852,43979,3072,1509,1563
64020,49616,5629,23971,3852,43987,3072,1509,1563
64025,49619,5629,23972,3852,43990,3072,1509,1563
64030,49624,5630,23976,3853,43994,3072,1509,1563
64035,49628,5630,23977,3853,43998,3072,1509,1563
64040,49631,5630,23979,3853,44001,3072,1509,1563
64045,49632,5630,23980,3853,44002,3072,1509,1563
64050,49637,5630,23982,3853,44007,3073,1509,1564
64055,49639,5630,23982,3853,44009,3073,1509,1564
64060,49647,5630,23985,3853,44017,3073,1509,1564
64065,49650,5630,23987,3853,44020,3073,1509,1564
64070,49655,5631,23991,3854,44024,3073,1509,1564
64075,49659,5631,23992,3854,44028,3073,1509,1564
64080,49662,5631,23993,3854,44031,3073,1509,1564
64085,49663,5631,23994,3854,44032,3073,1509,1564
64090,49668,5631,23998,3854,44037,3074,1510,1564
64095,49670,5631,23999,3854,44039,3074,1510,1564
64100,49678,5631,24004,3854,44047,3074,1510,1564
64105,49681,5631,24006,3854,44050,3074,1510,1564
64110,49686,5632,24008,3854,44054,3074,1510,1564
64115,49690,5632,24010,3854,44058,3074,1510,1564
64120,49693,5632,24012,3854,44061,3074,1510,1564
64125,49694,5632,24013,3854,44062,3074,1510,1564
64130,49699,5632,24015,3854,44067,3074,1510,1564
64135,49701,5632,24017,3854,44069,3074,1510,1564
64140,49709,5632,24022,3854,44077,3074,1510,1564
64145,49712,5632,24023,3854,44080,3074,1510,1564
64150,49717,5633,24024,3854,44084,3074,1510,1564
64155,49721,5633,24026,3854,44088,3074,1510,1564
64160,49724,5633,24028,3854,44091,3074,1510,1564
64165,49725,5633,24028,3854,44092,3074,1510,1564
64170,49730,5633,24030,3854,44097,3074,1510,1564
64175,49732,5633,24031,3854,44099,3074,1510,1564
64180,49740,5633,24035,3854,44107,3074,1510,1564
64185,49743,5633,24036,3854,44110,3074,1510,1564
64190,49748,5634,24038,3854,44114,3074,1510,1564
64195,49752,5634,24040,3854,44118,3074,1510,1564
64200,49755,5634,24040,3854,44121,3074,1510,1564
64205,49756,5634,24040,3854,44122,3074,1510,1564
64210,49761,5634,24042,3854,44127,3074,1510,1564
64215,49763,5634,24044,3854,44129,3074,1510,1564
64220,49771,5634,24045,3854,44137,3074,1510,1564
64225,49774,5634,24048,3854,44140,3074,1510,1564
64230,49779,5635,24050,3854,44144,3074,1510,1564
64235,49783,5635,24053,3854,44148,3074,1510,1564
64240,49786,5635,24054,3854,44151,3074,1510,1564
64245,49787,5635,24055,3854,44152,3074,1510,1564
64250,49792,5635,24058,3854,44157,3074,1510,1564
64255,49794,5635,24059,3854,44159,3074,1510,1564
64260,49802,5635,24063,3854,44167,3074,1510,1564
64265,49805,5635,24065,3854,44170,3074,1510,1564
64270,49810,5636,24067,3854,44174,3074,1510,1564
64275,49814,5636,24067,3854,44178,3074,1510,1564
64280,49817,5636,24069,3854,44181,3074,1510,1564
64285,49818,5636,24069,3854,44182,3074,1510,1564
64290,49823,5636,24072,3854,44187,3074,1510,1564
64295,49825,5636,24074,3854,44189,3074,1510,1564
64300,49833,5636,24076,3854,44197,3074,1510,1564
64305,49836,5636,24078,3854,44200,3074,1510,1564
64310,49841,5637,24081,3854,44204,3074,1510,1564
64315,49845,5637,24082,3854,44208,3074,1510,1564
64320,49848,5637,24083,3854,44211,3074,1510,1564
64325,49849,5637,24083,3854,44212,3074,1510,1564
64330,49854,5637,24086,3854,44217,3074,1510,1564
64335,49856,5637,24086,3854,44219,3074,1510,1564
64340,49864,5637,24087,3854,44227,3074,1510,1564
64345,49867,5637,24088,3854,44230,3074,1510,1564
64350,49872,5638,24091,3855,44234,3074,1510,1564
64355,49876,5638,24092,3855,44238,3074,1510,1564
64360,49879,5638,24092,3855,44241,3074,1510,1564
64365,49880,5638,24092,3855,44242,3074,1510,1564
64370,49885,5638,24096,3855,44247,3074,1510,1564
64375,49887,5638,24097,3855,44249,3074,1510,1564
64380,49895,5638,24102,3855,44257,3074,1510,1564
64385,49898,5638,24103,3855,44260,3074,1510,1564
64390,49903,5639,24104,3855,44264,3074,1510,1564
64395,49907,5639,24107,3855,44268,3074,1510,1564
64400,49910,5639,24108,3855,44271,3074,1510,1564
64405,49911,5639,24108,3855,44272,3074,1510,1564
64410,49916,5639,24110,3855,44277,3074,1510,1564
64415,49918,5639,24112,3855,44279,3074,1510,1564
64420,49926,5639,24117,3855,44287,3074,1510,1564
64425,49929,5639,24118,3855,44290,3074,1510,1564
64430,49934,5640,24120,3855,44294,3074,1510,1564
64435,49938,5640,24123,3855,44298,3074,1510,1564
64440,49941,5640,24125,3855,44301,3074,1510,1564
64445,49942,5640,24125,3855,44302,3074,1510,1564
64450,49947,5640,24128,3855,44307,3074,1510,1564
64455,49949,5640,24129,3855,44309,3074,1510,1564
64460,49957,5640,24134,3855,44317,3074,1510,1564
64465,49960,5640,24137,3855,44320,3074,1510,1564
64470,49965,5641,24140,3856,44324,3074,1510,1564
64475,49969,5641,24141,3856,44328,3074,1510,1564
64480,49972,5641,24142,3856,44331,3074,1510,1564
64485,49973,5641,24142,3856,44332,3074,1510,1564
64490,49978,5641,24145,3856,44337,3074,1510,1564
64495,49980,5641,24147,3856,44339,3074,1510,1564
64500,49988,5641,24150,3856,44347,3074,1510,1564
64505,49991,5641,24151,3856,44350,3074,1510,1564
64510,49996,5642,24152,3856,44354,3074,1510,1564
64515,50000,5642,24152,3856,44358,3074,1510,1564
64520,50003,5642,24154,3856,44361,3074,1510,1564
64525,50004,5642,24155,3856,44362,3074,1510,1564
64530,50009,5642,24159,3856,44367,3074,1510,1564
64535,50011,5642,24159,3856,44369,3074,1510,1564
64540,50019,5642,24163,3856,44377,3074,1510,1564
64545,50022,5642,24164,3856,44380,3074,1510,1564
64550,50027,5643,24166,3856,44384,3074,1510,1564
64555,50031,5643,24168,3856,44388,3074,1510,1564
64560,50034,5643,24168,3856,44391,3074,1510,1564
64565,50035,5643,24169,3856,44392,3074,1510,1564
64570,50040,5643,24169,3856,44397,3074,1510,1564
64575,50042,5643,24169,3856,44399,3074,1510,1564
64580,50050,5643,24173,3856,44407,3074,1510,1564
64585,50053,5643,24174,3856,44410,3074,1510,1564
64590,50058,5644,24177,3857,44414,3074,1510,1564
64595,50062,5644,24179,3857,44418,3074,1510,1564
64600,50065,5644,24179,3857,44421,3074,1510,1564
64605,50066,5644,24180,3857,44422,3074,1510,1564
64610,50071,5644,24181,3857,44427,3074,1510,1564
64615,50073,5644,24183,3857,44429,3074,1510,1564
64620,50081,5644,24185,3857,44437,3074,1510,1564
64625,50084,5644,24187,3857,44440,3074,1510,1564
64630,50089,5645,24187,3857,44444,3074,1510,1564
64635,50093,5645,24190,3857,44448,3074,1510,1564
64640,50096,5645,24191,3857,44451,3074,1510,1564
64645,50097,5645,24191,3857,44452,3074,1510,1564
64650,50102,5645,24193,3857,44457,3074,1510,1564
64655,50104,5645,24194,3857,44459,3074,1510,1564
64660,50112,5645,24196,3857,44467,3074,1510,1564
64665,50115,5645,24197,3857,44470,3074,1510,1564
64670,50120,5646,24199,3857,44474,3074,1510,1564
64675,50124,5646,24201,3857,44478,3074,1510,1564
64680,50127,5646,24203,3857,44481,3074,1510,1564
64685,50128,5646,24204,3857,44482,3074,1510,1564
64690,50133,5646,24207,3857,44487,3074,1510,1564
64695,50135,5646,24208,3857,44489,3074,1510,1564
64700,50143,5646,24213,3857,44497,3074,1510,1564
64705,50146,5646,24215,3857,44500,3074,1510,1564
64710,50151,5647,24216,3857,44504,3074,1510,1564
64715,50155,5647,24218,3857,44508,3074,1510,1564
64720,50158,5647,24220,3857,44511,3074,1510,1564
64725,50159,5647,24221,3857,44512,3074,1510,1564
64730,50164,5647,24224,3857,44517,3074,1510,1564
64735,50166,5647,24225,3857,44519,3074,1510,1564
64740,50174,5647,24227,3857,44527,3074,1510,1564
64745,50177,5647,24228,3857,44530,3074,1510,1564
64750,50182,5648,24229,3857,44534,3074,1510,1564
64755,50186,5648,24231,3857,44538,3074,1510,1564
64760,50189,5648,24232,3857,44541,3074,1510,1564
64765,50190,5648,24232,3857,44542,3074,1510,1564
64770,50195,5648,24235,3857,44547,3074,1510,1564
64775,50197,5648,24236,3857,44549,3074,1510,1564
64780,50205,5648,24239,3857,44557,3074,1510,1564
64785,50208,5648,24241,3857,44560,3074,1510,1564
64790,50213,5649,24241,3857,44564,3074,1510,1564
64795,50217,5649,24242,3857,44568,3074,1510,1564
64800,50220,5649,24244,3857,44571,3074,1510,1564
64805,50221,5649,24245,3857,44572,3074,1510,1564
64810,50226,5649,24249,3857,44577,3074,1510,1564
64815,50228,5649,24250,3857,44579,3074,1510,1564
64820,50236,5649,24254,3857,44587,3074,1510,1564
64825,50239,5649,24256,3857,44590,3074,1510,1564
64830,50244,5650,24259,3858,44594,3074,1510,1564
64835,50248,5650,24262,3858,44598,3074,1510,1564
64840,50251,5650,24265,3858,44601,3074,1510,1564
64845,50252,5650,24265,3858,44602,3074,1510,1564
64850,50257,5650,24269,3858,44607,3074,1510,1564
64855,50259,5650,24270,3858,44609,3074,1510,1564
64860,50267,5650,24274,3858,44617,3074,1510,1564
64865,50270,5650,24275,3858,44620,3074,1510,1564
64870,50275,5650,24279,3858,44625,3074,1510,1564
64875,50279,5650,24281,3858,44629,3074,1510,1564
64880,50282,5650,24282,3858,44632,3074,1510,1564
64885,50283,5650,24283,3858,44633,3074,1510,1564
64890,50288,5650,24285,3858,44638,3074,1510,1564
64895,50290,5650,24287,3858,44640,3074,1510,1564
64900,50298,5650,24289,3858,44648,3074,1510,1564
64905,50301,5650,24290,3858,44651,3074,1510,1564
64910,50306,5650,24292,3858,44656,3074,1510,1564
64915,50310,5650,24296,3858,44660,3074,1510,1564
64920,50313,5650,24297,3858,44663,3074,1510,1564
64925,50314,5650,24298,3858,44664,3074,1510,1564
64930,50319,5650,24301,3858,44669,3074,1510,1564
64935,50321,5650,24302,3858,44671,3074,1510,1564
64940,50329,5650,24304,3858,44679,3074,1510,1564
64945,50332,5650,24306,3858,44682,3074,1510,1564
64950,50337,5650,24310,3858,44687,3074,1510,1564
64955,50341,5650,24311,3858,44691,3074,1510,1564
64960,50344,5650,24312,3858,44694,3074,1510,1564
64965,50345,5650,24312,3858,44695,3074,1510,1564
64970,50350,5650,24314,3858,44700,3074,1510,1564
64975,50352,5650,24316,3858,44702,3074,1510,1564
64980,50360,5650,24320,3858,44710,3074,1510,1564
64985,50363,5650,24322,3858,44713,3074,1510,1564
64990,50368,5650,24324,3858,44718,3074,1510,1564
64995,50372,5650,24327,3858,44722,3074,1510,1564
65000,50375,5650,24328,3858,44725,3074,1510,1564
65005,50376,5650,24329,3858,44726,3074,1510,1564
65010,50381,5650,24332,3858,44731,3074,1510,1564
65015,50383,5650,24333,3858,44733,3074,1510,1564
65020,50391,5650,24336,3858,44741,3074,1510,1564
65025,50394,5650,24338,3858,44744,3074,1510,1564
65030,50399,5650,24340,3858,44749,3074,1510,1564
65035,50403,5650,24342,3858,44753,3074,1510,1564
65040,50406,5650,24343,3858,44756,3074,1510,1564
65045,50407,5650,24343,3858,44757,3074,1510,1564
65050,50412,5650,24347,3858,44762,3074,1510,1564
65055,50414,5650,24349,3858,44764,3074,1510,1564
65060,50422,5650,24352,3858,44772,3074,1510,1564
65065,50425,5650,24353,3858,44775,3074,1510,1564
65070,50430,5650,24357,3858,44780,3074,1510,1564
65075,50434,5650,24358,3858,44784,3074,1510,1564
65080,50437,5650,24360,3858,44787,3074,1510,1564
65085,50438,5650,24361,3858,44788,3074,1510,1564
65090,50443,5650,24363,3858,44793,3074,1510,1564
65095,50445,5650,24364,3858,44795,3074,1510,1564
65100,50453,5650,24369,3858,44803,3074,1510,1564
65105,50456,5650,24370,3858,44806,3074,1510,1564
65110,50461,5650,24373,3858,44811,3074,1510,1564
65115,50465,5650,24375,3858,44815,3074,1510,1564
65120,50468,5650,24377,3858,44818,3074,1510,1564
65125,50469,5650,24378,3858,44819,3074,1510,1564
65130,50474,5650,24380,3858,44824,3074,1510,1564
65135,50476,5650,24381,3858,44826,3074,1510,1564
65140,50484,5650,24384,3858,44834,3074,1510,1564
65145,50487,5650,24386,3858,44837,3074,1510,1564
65150,50492,5650,24386,3858,44842,3074,1510,1564
65155,50496,5650,24389,3858,44846,3074,1510,1564
65160,50499,5650,24391,3858,44849,3074,1510,1564
65165,50500,5650,24391,3858,44850,3074,1510,1564
65170,50505,5650,24395,3858,44855,3074,1510,1564
65175,50507,5650,24395,3858,44857,3074,1510,1564
65180,50515,5650,24397,3858,44865,3074,1510,1564
65185,50518,5650,24397,3858,44868,3074,1510,1564
65190,50523,5650,24399,3858,44873,3074,1510,1564
65195,50527,5650,24400,3858,44877,3074,1510,1564
65200,50530,5650,24402,3858,44880,3074,1510,1564
65205,50531,5650,24402,3858,44881,3074,1510,1564
65210,50536,5650,24403,3858,44886,3074,1510,1564
65215,50538,5650,24404,3858,44888,3074,1510,1564
65220,50546,5650,24408,3858,44896,3074,1510,1564
65225,50549,5650,24409,3858,44899,3074,1510,1564
65230,50554,5650,24411,3858,44904,3074,1510,1564
65235,50558,5650,24412,3858,44908,3074,1510,1564
65240,50561,5650,24414,3858,44911,3074,1510,1564
65245,50562,5650,24414,3858,44912,3074,1510,1564
65250,50567,5650,24417,3858,44917,3074,1510,1564
65255,50569,5650,24418,3858,44919,3074,1510,1564
65260,50577,5650,24419,3858,44927,3074,1510,1564
65265,50580,5650,24421,3858,44930,3074,1510,1564
65270,50585,5650,24423,3858,44935,3074,1510,1564
65275,50589,5650,24425,3858,44939,3074,1510,1564
65280,50592,5650,24426,3858,44942,3074,1510,1564
65285,50593,5650,24427,3858,44943,3074,1510,1564
65290,50598,5650,24429,3858,44948,3074,1510,1564
65295,50600,5650,24430,3858,44950,3074,1510,1564
65300,50608,5650,24436,3858,44958,3074,1510,1564
65305,50611,5650,24439,3858,44961,3074,1510,1564
65310,50616,5650,24443,3858,44966,3074,1510,1564
65315,50620,5650,24444,3858,44970,3074,1510,1564
65320,50623,5650,24445,3858,44973,3074,1510,1564
65325,50624,5650,24446,3858,44974,3074,1510,1564
65330,50629,5650,24447,3858,44979,3074,1510,1564
65335,50631,5650,24447,3858,44981,3074,1510,1564
65340,50639,5650,24450,3858,44989,3074,1510,1564
65345,50642,5650,24451,3858,44992,3074,1510,1564
65350,50647,5650,24454,3858,44997,3074,1510,1564
65355,50651,5650,24456,3858,45001,3074,1510,1564
65360,50654,5650,24457,3858,45004,3074,1510,1564
65365,50655,5650,24457,3858,45005,3074,1510,1564
65370,50660,5650,24460,3858,45010,3074,1510,1564
65375,50662,5650,24462,3858,45012,3074,1510,1564
65380,50670,5650,24466,3858,45020,3074,1510,1564
65385,50673,5650,24467,3858,45023,3074,1510,1564
65390,50678,5650,24469,3858,45028,3074,1510,1564
65395,50682,5650,24473,3858,45032,3074,1510,1564
65400,50685,5650,24475,3858,45035,3074,1510,1564
65405,50686,5650,24476,3858,45036,3074,1510,1564
65410,50691,5650,24477,3858,45041,3074,1510,1564
65415,50693,5650,24477,3858,45043,3074,1510,1564
65420,50701,5650,24481,3858,45051,3074,1510,1564
65425,50704,5650,24483,3858,45054,3074,1510,1564
65430,50709,5650,24485,3858,45059,3074,1510,1564
65435,50713,5650,24488,3858,45063,3074,1510,1564
65440,50716,5650,24490,3858,45066,3074,1510,1564
65445,50717,5650,24490,3858,45067,3074,1510,1564
65450,50722,5650,24494,3858,45072,3074,1510,1564
65455,50724,5650,24495,3858,45074,3074,1510,1564
65460,50732,5650,24501,3858,45082,3074,1510,1564
65465,50735,5650,24502,3858,45085,3074,1510,1564
65470,50740,5650,24504,3858,45090,3074,1510,1564
65475,50744,5650,24508,3858,45094,3074,1510,1564
65480,50747,5650,24510,3858,45097,3074,1510,1564
65485,50748,5650,24510,3858,45098,3074,1510,1564
65490,50753,5650,24512,3858,45103,3074,1510,1564
65495,50755,5650,24512,3858,45105,3074,1510,1564
65500,50763,5650,24514,3858,45113,3074,1510,1564
65505,50766,5650,24514,3858,45116,3074,1510,1564
65510,50771,5650,24516,3858,45121,3074,1510,1564
65515,50775,5650,24518,3858,45125,3074,1510,1564
65520,50778,5650,24519,3858,45128,3074,1510,1564
65525,50779,5650,24519,3858,45129,3074,1510,1564
65530,50784,5650,24522,3858,45134,3074,1510,1564
65535,50786,5650,24522,3858,45136,3074,1510,1564
65540,50794,5650,24526,3858,45144,3074,1510,1564
65545,50797,5650,24528,3858,45147,3074,1510,1564
65550,50802,5650,24531,3858,45152,3074,1510,1564
65555,50806,5650,24533,3858,45156,3074,1510,1564
65560,50809,5650,24536,3858,45159,3074,1510,1564
65565,50810,5650,24537,3858,45160,3074,1510,1564
65570,50815,5650,24540,3858,45165,3074,1510,1564
65575,50817,5650,24542,3858,45167,3074,1510,1564
65580,50825,5650,24546,3858,45175,3074,1510,1564
65585,50828,5650,24548,3858,45178,3074,1510,1564
65590,50833,5650,24551,3858,45183,3074,1510,1564
65595,50837,5650,24553,3858,45187,3074,1510,1564
65600,50840,5650,24553,3858,45190,3074,1510,1564
65605,50841,5650,24554,3858,45191,3074,1510,1564
65610,50846,5650,24557,3858,45196,3074,1510,1564
65615,50848,5650,24558,3858,45198,3074,1510,1564
65620,50856,5650,24562,3858,45206,3074,1510,1564
65625,50859,5650,24564,3858,45209,3074,1510,1564
65630,50864,5650,24566,3858,45214,3074,1510,1564
65635,50868,5650,24568,3858,45218,3074,1510,1564
65640,50871,5650,24570,3858,45221,3074,1510,1564
65645,50872,5650,24571,3858,45222,3074,1510,1564
65650,50877,5650,24574,3858,45227,3074,1510,1564
65655,50879,5650,24575,3858,45229,3074,1510,1564
65660,50887,5650,24579,3858,45237,3074,1510,1564
65665,50890,5650,24581,3858,45240,3074,1510,1564
65670,50895,5650,24582,3858,45245,3074,1510,1564
65675,50899,5650,24585,3858,45249,3074,1510,1564
65680,50902,5650,24585,3858,45252,3074,1510,1564
65685,50903,5650,24585,3858,45253,3074,1510,1564
65690,50908,5650,24587,3858,45258,3074,1510,1564
65695,50910,5650,24588,3858,45260,3074,1510,1564
65700,50918,5650,24590,3858,45268,3074,1510,1564
65705,50921,5650,24590,3858,45271,3074,1510,1564
65710,50926,5650,24593,3858,45276,3074,1510,1564
65715,50930,5650,24596,3858,45280,3074,1510,1564
65720,50933,5650,24597,3858,45283,3074,1510,1564
65725,50934,5650,24597,3858,45284,3074,1510,1564
65730,50939,5650,24598,3858,45289,3074,1510,1564
65735,50941,5650,24600,3858,45291,3074,1510,1564
65740,50949,5650,24602,3858,45299,3074,1510,1564
65745,50952,5650,24604,3858,45302,3074,1510,1564
65750,50957,5650,24606,3858,45307,3074,1510,1564
65755,50961,5650,24606,3858,45311,3074,1510,1564
65760,50964,5650,24609,3858,45314,3074,1510,1564
65765,50965,5650,24609,3858,45315,3074,1510,1564
65770,50970,5650,24614,3858,45320,3074,1510,1564
65775,50972,5650,24615,3858,45322,3074,1510,1564
65780,50980,5650,24618,3858,45330,3074,1510,1564
65785,50983,5650,24620,3858,45333,3074,1510,1564
65790,50988,5650,24622,3858,45338,3074,1510,1564
65795,50992,5650,24625,3858,45342,3074,1510,1564
65800,50995,5650,24625,3858,45345,3074,1510,1564
65805,50996,5650,24626,3858,45346,3074,1510,1564
65810,51001,5650,24631,3858,45351,3074,1510,1564
65815,51003,5650,24631,3858,45353,3074,1510,1564
65820,51011,5650,24633,3858,45361,3074,1510,1564
65825,51014,5650,24633,3858,45364,3074,1510,1564
65830,51019,5650,24637,3858,45369,3074,1510,1564
65835,51023,5650,24639,3858,45373,3074,1510,1564
65840,51026,5650,24640,3858,45376,3074,1510,1564
65845,51027,5650,24641,3858,45377,3074,1510,1564
65850,51032,5650,24641,3858,45382,3074,1510,1564
65855,51034,5650,24642,3858,45384,3074,1510,1564
65860,51042,5650,24646,3858,45392,3074,1510,1564
65865,51045,5650,24648,3858,45395,3074,1510,1564
65870,51050,5650,24651,3858,45400,3074,1510,1564
65875,51054,5650,24653,3858,45404,3074,1510,1564
65880,51057,5650,24655,3858,45407,3074,1510,1564
65885,51058,5650,24656,3858,45408,3074,1510,1564
65890,51063,5650,24659,3858,45413,3074,1510,1564
65895,51065,5650,24661,3858,45415,3074,1510,1564
65900,51073,5650,24664,3858,45423,3074,1510,1564
65905,51076,5650,24666,3858,45426,3074,1510,1564
65910,51081,5650,24667,3858,45431,3074,1510,1564
65915,51085,5650,24671,3858,45435,3074,1510,1564
65920,51088,5650,24673,3858,45438,3074,1510,1564
65925,51089,5650,24673,3858,45439,3074,1510,1564
65930,51094,5650,24675,3858,45444,3074,1510,1564
65935,51096,5650,24676,3858,45446,3074,1510,1564
65940,51104,5650,24680,3858,45454,3074,1510,1564
65945,51107,5650,24681,3858,45457,3074,1510,1564
65950,51112,5650,24684,3858,45462,3074,1510,1564
65955,51116,5650,24686,3858,45466,3074,1510,1564
65960,51119,5650,24687,3858,45469,3074,1510,1564
65965,51120,5650,24687,3858,45470,3074,1510,1564
65970,51125,5650,24689,3858,45475,3074,1510,1564
65975,51127,5650,24689,3858,45477,3074,1510,1564
65980,51135,5650,24692,3858,45485,3074,1510,1564
65985,51138,5650,24692,3858,45488,3074,1510,1564
65990,51143,5650,24695,3858,45493,3074,1510,1564
65995,51147,5650,24697,3858,45497,3074,1510,1564
66000,51150,5650,24700,3858,45500,3074,1510,1564
66005,51151,5650,24700,3858,45501,3074,1510,1564
66010,51156,5650,24702,3858,45506,3074,1510,1564
66015,51158,5650,24703,3858,45508,3074,1510,1564
66020,51166,5650,24709,3858,45516,3074,1510,1564
66025,51169,5650,24712,3858,45519,3074,1510,1564
66030,51174,5650,24716,3858,45524,3074,1510,1564
66035,51178,5650,24717,3858,45528,3074,1510,1564
66040,51181,5650,24718,3858,45531,3074,1510,1564
66045,51182,5650,24718,3858,45532,3074,1510,1564
66050,51187,5650,24720,3858,45537,3074,1510,1564
66055,51189,5650,24722,3858,45539,3074,1510,1564
66060,51197,5650,24725,3858,45547,3074,1510,1564
66065,51200,5650,24726,3858,45550,3074,1510,1564
66070,51205,5650,24729,3858,45555,3074,1510,1564
66075,51209,5650,24732,3858,45559,3074,1510,1564
66080,51212,5650,24733,3858,45562,3074,1510,1564
66085,51213,5650,24734,3858,45563,3074,1510,1564
66090,51218,5650,24737,3858,45568,3074,1510,1564
66095,51220,5650,24737,3858,45570,3074,1510,1564
66100,51228,5650,24740,3858,45578,3074,1510,1564
66105,51231,5650,24740,3858,45581,3074,1510,1564
66110,51236,5650,24743,3858,45586,3074,1510,1564
66115,51240,5650,24745,3858,45590,3074,1510,1564
66120,51243,5650,24747,3858,45593,3074,1510,1564
66125,51244,5650,24747,3858,45594,3074,1510,1564
66130,51249,5650,24749,3858,45599,3074,1510,1564
66135,51251,5650,24749,3858,45601,3074,1510,1564
66140,51259,5650,24752,3858,45609,3074,1510,1564
66145,51262,5650,24755,3858,45612,3074,1510,1564
66150,51267,5650,24760,3858,45617,3074,1510,1564
66155,51271,5650,24760,3858,45621,3074,1510,1564
66160,51274,5650,24761,3858,45624,3074,1510,1564
66165,51275,5650,24762,3858,45625,3074,1510,1564
66170,51280,5650,24765,3858,45630,3074,1510,1564
66175,51282,5650,24766,3858,45632,3074,1510,1564
66180,51290,5650,24770,3858,45640,3074,1510,1564
66185,51293,5650,24770,3858,45643,3074,1510,1564
66190,51298,5650,24773,3858,45648,3074,1510,1564
66195,51302,5650,24776,3858,45652,3074,1510,1564
66200,51305,5650,24779,3858,45655,3074,1510,1564
66205,51306,5650,24780,3858,45656,3074,1510,1564
66210,51311,5650,24782,3858,45661,3074,1510,1564
66215,51313,5650,24782,3858,45663,3074,1510,1564
66220,51321,5650,24787,3858,45671,3074,1510,1564
66225,51324,5650,24790,3858,45674,3074,1510,1564
66230,51329,5650,24791,3858,45679,3074,1510,1564
66235,51333,5650,24793,3858,45683,3074,1510,1564
66240,51336,5650,24794,3858,45686,3074,1510,1564
66245,51337,5650,24795,3858,45687,3074,1510,1564
66250,51342,5650,24799,3858,45692,3074,1510,1564
66255,51344,5650,24799,3858,45694,3074,1510,1564
66260,51352,5650,24800,3858,45702,3074,1510,1564
66265,51355,5650,24803,3858,45705,3074,1510,1564
66270,51360,5650,24804,3858,45710,3074,1510,1564
66275,51364,5650,24807,3858,45714,3074,1510,1564
66280,51367,5650,24809,3858,45717,3074,1510,1564
66285,51368,5650,24809,3858,45718,3074,1510,1564
66290,51373,5650,24810,3858,45723,3074,1510,1564
66295,51375,5650,24811,3858,45725,3074,1510,1564
66300,51383,5650,24815,3858,45733,3074,1510,1564
66305,51386,5650,24816,3858,45736,3074,1510,1564
66310,51391,5650,24818,3858,45741,3074,1510,1564
66315,51395,5650,24820,3858,45745,3074,1510,1564
66320,51398,5650,24822,3858,45748,3074,1510,1564
66325,51399,5650,24822,3858,45749,3074,1510,1564
66330,51404,5650,24823,3858,45754,3074,1510,1564
66335,51406,5650,24823,3858,45756,3074,1510,1564
66340,51414,5650,24827,3858,45764,3074,1510,1564
66345,51417,5650,24828,3858,45767,3074,1510,1564
66350,51422,5650,24833,3858,45772,3074,1510,1564
66355,51426,5650,24836,3858,45776,3074,1510,1564
66360,51429,5650,24838,3858,45779,3074,1510,1564
66365,51430,5650,24839,3858,45780,3074,1510,1564
66370,51435,5650,24841,3858,45785,3074,1510,1564
66375,51437,5650,24842,3858,45787,3074,1510,1564
66380,51445,5650,24847,3858,45795,3074,1510,1564
66385,51448,5650,24848,3858,45798,3074,1510,1564
66390,51453,5650,24849,3858,45803,3074,1510,1564
66395,51457,5650,24851,3858,45807,3074,1510,1564
66400,51460,5650,24852,3858,45810,3074,1510,1564
66405,51461,5650,24853,3858,45811,3074,1510,1564
66410,51466,5650,24855,3858,45816,3074,1510,1564
66415,51468,5650,24855,3858,45818,3074,1510,1564
66420,51476,5650,24858,3858,45826,3074,1510,1564
66425,51479,5650,24859,3858,45829,3074,1510,1564
66430,51484,5650,24862,3858,45834,3074,1510,1564
66435,51488,5650,24864,3858,45838,3074,1510,1564
66440,51491,5650,24866,3858,45841,3074,1510,1564
66445,51492,5650,24867,3858,45842,3074,1510,1564
66450,51497,5650,24867,3858,45847,3074,1510,1564
66455,51499,5650,24869,3858,45849,3074,1510,1564
66460,51507,5650,24872,3858,45857,3074,1510,1564
66465,51510,5650,24872,3858,45860,3074,1510,1564
66470,51515,5650,24874,3858,45865,3074,1510,1564
66475,51519,5650,24875,3858,45869,3074,1510,1564
66480,51522,5650,24877,3858,45872,3074,1510,1564
66485,51523,5650,24877,3858,45873,3074,1510,1564
66490,51528,5650,24878,3858,45878,3074,1510,1564
66495,51530,5650,24880,3858,45880,3074,1510,1564
66500,51538,5650,24883,3858,45888,3074,1510,1564
66505,51541,5650,24885,3858,45891,3074,1510,1564
66510,51546,5650,24886,3858,45896,3074,1510,1564
66515,51550,5650,24888,3858,45900,3074,1510,1564
66520,51553,5650,24889,3858,45903,3074,1510,1564
66525,51554,5650,24890,3858,45904,3074,1510,1564
66530,51559,5650,24893,3858,45909,3074,1510,1564
66535,51561,5650,24893,3858,45911,3074,1510,1564
66540,51569,5650,24898,3858,45919,3074,1510,1564
66545,51572,5650,24899,3858,45922,3074,1510,1564
66550,51577,5650,24902,3858,45927,3074,1510,1564
66555,51581,5650,24903,3858,45931,3074,1510,1564
66560,51584,5650,24903,3858,45934,3074,1510,1564
66565,51585,5650,24904,3858,45935,3074,1510,1564
66570,51590,5650,24908,3858,45940,3074,1510,1564
66575,51592,5650,24909,3858,45942,3074,1510,1564
66580,51600,5650,24914,3858,45950,3074,1510,1564
66585,51603,5650,24916,3858,45953,3074,1510,1564
66590,51608,5650,24917,3858,45958,3074,1510,1564
66595,51612,5650,24919,3858,45962,3074,1510,1564
66600,51615,5650,24920,3858,45965,3074,1510,1564
66605,51616,5650,24920,3858,45966,3074,1510,1564
66610,51621,5650,24921,3858,45971,3074,1510,1564
66615,51623,5650,24922,3858,45973,3074,1510,1564
66620,51631,5650,24925,3858,45981,3074,1510,1564
66625,51634,5650,24926,3858,45984,3074,1510,1564
66630,51639,5650,24928,3858,45989,3074,1510,1564
66635,51643,5650,24930,3858,45993,3074,1510,1564
66640,51646,5650,24931,3858,45996,3074,1510,1564
66645,51647,5650,24932,3858,45997,3074,1510,1564
66650,51652,5650,24935,3858,46002,3074,1510,1564
66655,51654,5650,24935,3858,46004,3074,1510,1564
66660,51662,5650,24940,3858,46012,3074,1510,1564
66665,51665,5650,24941,3858,46015,3074,1510,1564
66670,51670,5650,24942,3858,46020,3074,1510,1564
66675,51674,5650,24945,3858,46024,3074,1510,1564
66680,51677,5650,24946,3858,46027,3074,1510,1564
66685,51678,5650,24946,3858,46028,3074,1510,1564
66690,51683,5650,24948,3858,46033,3074,1510,1564
66695,51685,5650,24950,3858,46035,3074,1510,1564
66700,51693,5650,24953,3858,46043,3074,1510,1564
66705,51696,5650,24955,3858,46046,3074,1510,1564
66710,51701,5650,24957,3858,46051,3074,1510,1564
66715,51705,5650,24958,3858,46055,3074,1510,1564
66720,51708,5650,24959,3858,46058,3074,1510,1564
66725,51709,5650,24960,3858,46059,3074,1510,1564
66730,51714,5650,24961,3858,46064,3074,1510,1564
66735,51716,5650,24962,3858,46066,3074,1510,1564
66740,51724,5650,24966,3858,46074,3074,1510,1564
66745,51727,5650,24968,3858,46077,3074,1510,1564
66750,51732,5650,24971,3858,46082,3074,1510,1564
66755,51736,5650,24973,3858,46086,3074,1510,1564
66760,51739,5650,24975,3858,46089,3074,1510,1564
66765,51740,5650,24975,3858,46090,3074,1510,1564
66770,51745,5650,24978,3858,46095,3074,1510,1564
66775,51747,5650,24979,3858,46097,3074,1510,1564
66780,51755,5650,24982,3858,46105,3074,1510,1564
66785,51758,5650,24984,3858,46108,3074,1510,1564
66790,51763,5650,24988,3858,46113,3074,1510,1564
66795,51767,5650,24990,3858,46117,3074,1510,1564
66800,51770,5650,24993,3858,46120,3074,1510,1564
66805,51771,5650,24994,3858,46121,3074,1510,1564
66810,51776,5650,24995,3858,46126,3074,1510,1564
66815,51778,5650,24995,3858,46128,3074,1510,1564
66820,51786,5650,25000,3858,46136,3074,1510,1564
66825,51789,5650,25001,3858,46139,3074,1510,1564
66830,51794,5650,25005,3858,46144,3074,1510,1564
66835,51798,5650,25006,3858,46148,3074,1510,1564
66840,51801,5650,25008,3858,46151,3074,1510,1564
66845,51802,5650,25008,3858,46152,3074,1510,1564
66850,51807,5650,25010,3858,46157,3074,1510,1564
66855,51809,5650,25010,3858,46159,3074,1510,1564
66860,51817,5650,25014,3858,46167,3074,1510,1564
66865,51820,5650,25015,3858,46170,3074,1510,1564
66870,51825,5650,25019,3858,46175,3074,1510,1564
66875,51829,5650,25023,3858,46179,3074,1510,1564
66880,51832,5650,25024,3858,46182,3074,1510,1564
66885,51833,5650,25025,3858,46183,3074,1510,1564
66890,51838,5650,25028,3858,46188,3074,1510,1564
66895,51840,5650,25030,3858,46190,3074,1510,1564
66900,51848,5650,25036,3858,46198,3074,1510,1564
66905,51851,5650,25037,3858,46201,3074,1510,1564
66910,51856,5650,25040,3858,46206,3074,1510,1564
66915,51860,5650,25042,3858,46210,3074,1510,1564
66920,51863,5650,25043,3858,46213,3074,1510,1564
66925,51864,5650,25043,3858,46214,3074,1510,1564
66930,51869,5650,25045,3858,46219,3074,1510,1564
66935,51871,5650,25046,3858,46221,3074,1510,1564
66940,51879,5650,25048,3858,46229,3074,1510,1564
66945,51882,5650,25050,3858,46232,3074,1510,1564
66950,51887,5650,25051,3858,46237,3074,1510,1564
66955,51891,5650,25053,3858,46241,3074,1510,1564
66960,51894,5650,25054,3858,46244,3074,1510,1564
66965,51895,5650,25055,3858,46245,3074,1510,1564
66970,51900,5650,25057,3858,46250,3074,1510,1564
66975,51902,5650,25057,3858,46252,3074,1510,1564
66980,51910,5650,25061,3858,46260,3074,1510,1564
66985,51913,5650,25063,3858,46263,3074,1510,1564
66990,51918,5650,25066,3858,46268,3074,1510,1564
66995,51922,5650,25067,3858,46272,3074,1510,1564
67000,51925,5650,25068,3858,46275,3074,1510,1564
67005,51926,5650,25069,3858,46276,3074,1510,1564
67010,51931,5650,25072,3858,46281,3074,1510,1564
67015,51933,5650,25072,3858,46283,3074,1510,1564
67020,51941,5650,25075,3858,46291,3074,1510,1564
67025,51944,5650,25077,3858,46294,3074,1510,1564
67030,51949,5650,25078,3858,46299,3074,1510,1564
67035,51953,5650,25081,3858,46303,3074,1510,1564
67040,51956,5650,25084,3858,46306,3074,1510,1564
67045,51957,5650,25084,3858,46307,3074,1510,1564
67050,51962,5650,25086,3858,46312,3074,1510,1564
67055,51964,5650,25088,3858,46314,3074,1510,1564
67060,51972,5650,25092,3858,46322,3074,1510,1564
67065,51975,5650,25093,3858,46325,3074,1510,1564
67070,51980,5650,25096,3858,46330,3074,1510,1564
67075,51984,5650,25099,3858,46334,3074,1510,1564
67080,51987,5650,25099,3858,46337,3074,1510,1564
67085,51988,5650,25099,3858,46338,3074,1510,1564
67090,51993,5650,25102,3858,46343,3074,1510,1564
67095,51995,5650,25103,3858,46345,3074,1510,1564
67100,52003,5650,25105,3858,46353,3074,1510,1564
67105,52006,5650,25106,3858,46356,3074,1510,1564
67110,52011,5650,25109,3858,46361,3074,1510,1564
67115,52015,5650,25112,3858,46365,3074,1510,1564
67120,52018,5650,25112,3858,46368,3074,1510,1564
67125,52019,5650,25112,3858,46369,3074,1510,1564
67130,52024,5650,25116,3858,46374,3074,1510,1564
67135,52026,5650,25117,3858,46376,3074,1510,1564
67140,52034,5650,25120,3858,46384,3074,1510,1564
67145,52037,5650,25122,3858,46387,3074,1510,1564
67150,52042,5650,25126,3858,46392,3074,1510,1564
67155,52046,5650,25127,3858,46396,3074,1510,1564
67160,52049,5650,25130,3858,46399,3074,1510,1564
67165,52050,5650,25131,3858,46400,3074,1510,1564
67170,52055,5650,25134,3858,46405,3074,1510,1564
67175,52057,5650,25134,3858,46407,3074,1510,1564
67180,52065,5650,25138,3858,46415,3074,1510,1564
67185,52068,5650,25140,3858,46418,3074,1510,1564
67190,52073,5650,25143,3858,46423,3074,1510,1564
67195,52077,5650,25146,3858,46427,3074,1510,1564
67200,52080,5650,25149,3858,46430,3074,1510,1564
67205,52081,5650,25150,3858,46431,3074,1510,1564
67210,52086,5650,25151,3858,46436,3074,1510,1564
67215,52088,5650,25152,3858,46438,3074,1510,1564
67220,52096,5650,25154,3858,46446,3074,1510,1564
67225,52099,5650,25155,3858,46449,3074,1510,1564
67230,52104,5650,25155,3858,46454,3074,1510,1564
67235,52108,5650,25158,3858,46458,3074,1510,1564
67240,52111,5650,25158,3858,46461,3074,1510,1564
67245,52112,5650,25158,3858,46462,3074,1510,1564
67250,52117,5650,25159,3858,46467,3074,1510,1564
67255,52119,5650,25160,3858,46469,3074,1510,1564
67260,52127,5650,25162,3858,46477,3074,1510,1564
67265,52130,5650,25163,3858,46480,3074,1510,1564
67270,52135,5650,25165,3858,46485,3074,1510,1564
67275,52139,5650,25165,3858,46489,3074,1510,1564
67280,52142,5650,25168,3858,46492,3074,1510,1564
67285,52143,5650,25169,3858,46493,3074,1510,1564
67290,52148,5650,25170,3858,46498,3074,1510,1564
67295,52150,5650,25172,3858,46500,3074,1510,1564
67300,52158,5650,25176,3858,46508,3074,1510,1564
67305,52161,5650,25177,3858,46511,3074,1510,1564
67310,52166,5650,25179,3858,46516,3074,1510,1564
67315,52170,5650,25180,3858,46520,3074,1510,1564
67320,52173,5650,25182,3858,46523,3074,1510,1564
67325,52174,5650,25183,3858,46524,3074,1510,1564
67330,52179,5650,25186,3858,46529,3074,1510,1564
67335,52181,5650,25188,3858,46531,3074,1510,1564
67340,52189,5650,25190,3858,46539,3074,1510,1564
67345,52192,5650,25192,3858,46542,3074,1510,1564
67350,52197,5650,25193,3858,46547,3074,1510,1564
67355,52201,5650,25196,3858,46551,3074,1510,1564
67360,52204,5650,25197,3858,46554,3074,1510,1564
67365,52205,5650,25197,3858,46555,3074,1510,1564
67370,52210,5650,25199,3858,46560,3074,1510,1564
67375,52212,5650,25200,3858,46562,3074,1510,1564
67380,52220,5650,25204,3858,46570,3074,1510,1564
67385,52223,5650,25207,3858,46573,3074,1510,1564
67390,52228,5650,25210,3858,46578,3074,1510,1564
67395,52232,5650,25214,3858,46582,3074,1510,1564
67400,52235,5650,25216,3858,46585,3074,1510,1564
67405,52236,5650,25217,3858,46586,3074,1510,1564
67410,52241,5650,25219,3858,46591,3074,1510,1564
67415,52243,5650,25219,3858,46593,3074,1510,1564
67420,52251,5650,25221,3858,46601,3074,1510,1564
67425,52254,5650,25223,3858,46604,3074,1510,1564
67430,52259,5650,25226,3858,46609,3074,1510,1564
67435,52263,5650,25230,3858,46613,3074,1510,1564
67440,52266,5650,25231,3858,46616,3074,1510,1564
67445,52267,5650,25232,3858,46617,3074,1510,1564
67450,52272,5650,25233,3858,46622,3074,1510,1564
67455,52274,5650,25234,3858,46624,3074,1510,1564
67460,52282,5650,25241,3858,46632,3074,1510,1564
67465,52285,5650,25242,3858,46635,3074,1510,1564
67468,52289,5650,25244,3858,46639,3074,1510,1564
