Time,  Packets Generated,  Packets Reached,High Priority Packets Generated, High Priority Packets reached, Packet Dropped, Packet Dropped due to Faulty Node, High Prio Packet Dropped due to Faulty Node, Low Prio Packet Dropped due to Faulty Node 
5,1,1,1,1,0,0,0,0
10,6,5,5,4,0,0,0,0
15,8,7,6,6,0,0,0,0
20,16,11,10,7,1,1,1,0
25,19,16,11,9,2,2,2,0
30,24,21,13,10,3,3,3,0
35,28,23,15,10,3,3,3,0
40,31,27,16,13,3,3,3,0
45,32,29,17,14,3,3,3,0
50,37,33,19,16,3,3,3,0
55,39,35,21,17,3,3,3,0
60,47,39,23,19,4,4,3,1
65,50,44,26,21,4,4,3,1
70,55,50,29,26,5,5,3,2
75,59,52,30,26,5,5,3,2
80,62,56,31,27,5,5,3,2
85,63,58,31,28,5,5,3,2
90,68,62,32,29,5,5,3,2
95,70,64,34,30,5,5,3,2
100,78,68,36,32,6,6,3,3
105,81,73,37,33,6,6,3,3
110,86,79,39,36,7,7,3,4
115,90,81,41,38,7,7,3,4
120,93,85,43,40,7,7,3,4
125,94,87,44,41,7,7,3,4
130,99,89,45,41,9,7,3,4
135,101,91,46,42,9,7,3,4
140,109,95,50,45,11,8,4,4
145,112,99,53,47,11,8,4,4
150,117,105,56,51,12,9,5,4
155,121,106,58,51,13,9,5,4
160,124,109,60,54,14,9,5,4
165,125,110,60,55,15,9,5,4
170,130,113,63,58,16,9,5,4
175,132,115,64,58,16,9,5,4
180,140,119,68,61,18,10,6,4
185,143,122,70,62,19,10,6,4
190,148,127,72,66,21,11,6,5
195,152,128,74,67,22,11,6,5
200,155,132,76,69,22,11,6,5
205,156,133,77,70,23,11,6,5
210,161,133,80,70,27,11,6,5
215,163,135,80,71,28,11,6,5
220,171,137,85,73,32,12,7,5
225,174,139,87,75,33,12,7,5
230,179,144,91,80,35,13,8,5
235,183,144,93,80,37,13,8,5
240,186,148,94,83,38,13,8,5
245,187,148,94,83,39,13,8,5
250,192,148,96,83,44,13,8,5
255,194,149,96,83,45,13,8,5
260,202,151,101,84,51,14,9,5
265,205,152,103,85,53,15,10,5
270,210,154,106,87,56,16,10,6
275,214,154,106,87,59,16,10,6
280,217,156,107,88,61,16,10,6
285,218,156,108,88,62,16,10,6
290,223,157,110,88,65,16,10,6
295,225,159,110,89,66,16,10,6
300,233,161,113,90,72,17,10,7
305,236,161,115,90,75,17,10,7
310,241,162,117,90,79,18,11,7
315,245,162,119,90,82,18,11,7
320,248,163,120,91,85,18,11,7
325,249,163,121,91,86,18,11,7
330,254,164,124,91,90,18,11,7
335,256,165,124,91,91,18,11,7
340,264,166,131,92,98,19,12,7
345,267,166,132,92,101,19,12,7
350,272,167,133,92,105,20,12,8
355,276,168,136,93,106,20,12,8
360,279,171,137,96,108,20,12,8
365,280,171,137,96,109,20,12,8
370,285,173,139,97,111,20,12,8
375,287,175,140,98,112,20,12,8
380,295,176,144,99,118,21,12,9
385,298,177,144,100,121,21,12,9
390,303,178,148,101,125,21,12,9
395,307,178,150,101,129,21,12,9
400,310,178,152,101,132,21,12,9
405,311,178,152,101,133,21,12,9
410,316,180,157,103,134,21,12,9
415,318,183,157,105,135,21,12,9
420,326,184,161,106,140,22,12,10
425,329,186,163,108,142,22,12,10
430,334,188,165,110,146,22,12,10
435,338,188,168,110,149,22,12,10
440,341,191,171,113,150,22,12,10
445,342,191,171,113,151,22,12,10
450,347,191,172,113,156,22,12,10
455,349,192,173,114,157,22,12,10
460,357,192,177,114,165,23,13,10
465,360,192,178,114,168,23,13,10
470,365,194,181,116,171,23,13,10
475,369,195,182,117,174,23,13,10
480,372,196,184,118,175,23,13,10
485,373,197,185,119,176,23,13,10
490,378,197,186,119,181,23,13,10
495,380,197,188,119,183,23,13,10
500,388,198,193,119,190,23,13,10
505,391,198,194,119,193,23,13,10
510,396,199,197,120,197,24,14,10
515,400,199,199,120,200,24,14,10
520,403,200,200,121,203,24,14,10
525,404,200,200,121,204,24,14,10
530,409,200,201,121,209,24,14,10
535,411,200,202,121,211,24,14,10
540,419,201,205,121,218,24,14,10
545,422,201,206,121,221,24,14,10
550,427,202,207,122,225,25,14,11
555,431,202,209,122,228,25,14,11
560,434,203,210,123,231,25,14,11
565,435,203,211,123,232,25,14,11
570,440,203,213,123,236,25,14,11
575,442,205,213,124,237,25,14,11
580,450,206,218,124,244,25,14,11
585,453,207,221,125,246,25,14,11
590,458,208,222,126,250,26,14,12
595,462,208,223,126,254,26,14,12
600,465,208,223,126,257,26,14,12
605,466,209,224,127,257,26,14,12
610,471,210,225,127,261,26,14,12
615,473,210,226,127,263,26,14,12
620,481,210,227,127,271,27,14,13
625,484,210,228,127,274,27,14,13
630,489,211,230,128,278,27,14,13
635,493,211,231,128,282,27,14,13
640,496,211,231,128,285,27,14,13
645,497,211,231,128,286,27,14,13
650,502,212,235,129,290,27,14,13
655,504,212,236,129,292,27,14,13
660,512,212,241,129,299,28,14,14
665,515,212,242,129,303,28,14,14
670,520,213,242,129,307,28,14,14
675,524,213,244,129,310,28,14,14
680,527,214,245,130,313,28,14,14
685,528,214,245,130,314,28,14,14
690,533,215,247,130,318,28,14,14
695,535,215,249,130,320,28,14,14
700,543,215,252,130,328,28,14,14
705,546,215,253,130,331,28,14,14
710,551,217,254,131,334,29,14,15
715,555,218,255,132,337,29,14,15
720,558,218,256,132,339,29,14,15
725,559,219,256,133,340,29,14,15
730,564,220,257,133,344,29,14,15
735,566,221,259,134,345,29,14,15
740,574,222,261,134,352,29,14,15
745,577,222,263,134,355,29,14,15
750,582,224,267,136,358,30,15,15
755,586,224,269,136,362,30,15,15
760,589,224,271,136,364,30,15,15
765,590,225,271,137,365,30,15,15
770,595,226,275,138,367,30,15,15
775,597,229,277,141,368,30,15,15
780,605,230,281,142,374,30,15,15
785,608,231,282,143,377,30,15,15
790,613,232,283,143,381,31,15,16
795,617,232,286,143,385,31,15,16
800,620,232,286,143,388,31,15,16
805,621,232,287,143,389,31,15,16
810,626,233,291,144,392,31,15,16
815,628,235,291,145,393,31,15,16
820,636,236,296,146,400,31,15,16
825,639,236,297,146,403,31,15,16
830,644,237,299,147,407,32,15,17
835,648,238,300,148,410,32,15,17
840,651,240,302,150,411,32,15,17
845,652,240,303,150,412,32,15,17
850,657,240,307,150,417,32,15,17
855,659,241,309,151,418,32,15,17
860,667,241,312,151,426,32,15,17
865,670,242,314,152,428,32,15,17
870,675,244,318,154,431,32,15,17
875,679,244,321,154,435,32,15,17
880,682,244,322,154,438,32,15,17
885,683,244,323,154,439,32,15,17
890,688,244,326,154,444,32,15,17
895,690,245,328,155,445,32,15,17
900,698,245,333,155,453,32,15,17
905,701,245,334,155,456,32,15,17
910,706,245,336,155,461,32,15,17
915,710,246,339,156,464,32,15,17
920,713,246,341,156,467,32,15,17
925,714,246,342,156,468,32,15,17
930,719,247,345,157,471,32,15,17
935,721,249,346,158,472,32,15,17
940,729,249,350,158,479,32,15,17
945,732,250,353,159,482,32,15,17
950,737,251,356,159,486,33,16,17
955,741,251,356,159,490,33,16,17
960,744,252,357,160,492,33,16,17
965,745,252,358,160,493,33,16,17
970,750,253,361,161,497,33,16,17
975,752,253,362,161,499,33,16,17
980,760,254,365,162,506,33,16,17
985,763,254,367,162,509,33,16,17
990,768,254,371,162,514,34,17,17
995,772,254,373,162,518,34,17,17
1000,775,254,374,162,521,34,17,17
1005,776,254,374,162,522,34,17,17
1010,781,255,376,162,526,34,17,17
1015,783,255,376,162,528,34,17,17
1020,791,256,380,163,535,34,17,17
1025,794,256,381,163,538,34,17,17
1030,799,257,382,164,542,35,17,18
1035,803,257,383,164,546,35,17,18
1040,806,257,384,164,549,35,17,18
1045,807,257,385,164,550,35,17,18
1050,812,258,385,164,554,35,17,18
1055,814,258,385,164,556,35,17,18
1060,822,260,389,165,561,35,17,18
1065,825,261,390,166,564,35,17,18
1070,830,262,391,167,568,36,17,19
1075,834,262,392,167,571,36,17,19
1080,837,263,393,168,573,36,17,19
1085,838,265,394,170,573,36,17,19
1090,843,265,396,170,578,36,17,19
1095,845,266,397,171,579,36,17,19
1100,853,267,401,172,586,37,17,20
1105,856,267,402,172,589,37,17,20
1110,861,268,406,173,593,38,18,20
1115,865,268,407,173,597,38,18,20
1120,868,268,407,173,600,38,18,20
1125,869,268,407,173,601,38,18,20
1130,874,268,411,173,605,38,18,20
1135,876,270,411,174,606,38,18,20
1140,884,271,417,175,613,39,19,20
1145,887,271,418,175,616,39,19,20
1150,892,272,419,176,620,40,19,21
1155,896,272,421,176,624,40,19,21
1160,899,273,422,177,626,40,19,21
1165,900,273,423,177,627,40,19,21
1170,905,273,425,177,632,40,19,21
1175,907,274,427,178,633,40,19,21
1180,915,275,431,178,640,40,19,21
1185,918,275,432,178,643,40,19,21
1190,923,278,435,180,645,41,19,22
1195,927,279,437,181,647,41,19,22
1200,930,280,438,182,649,41,19,22
1205,931,281,438,183,650,41,19,22
1210,936,282,441,184,654,41,19,22
1215,938,283,442,185,655,41,19,22
1220,946,284,446,185,662,41,19,22
1225,949,284,447,185,665,41,19,22
1230,954,285,450,185,669,41,19,22
1235,958,285,453,185,673,41,19,22
1240,961,285,455,185,676,41,19,22
1245,962,285,456,185,677,41,19,22
1250,967,286,458,186,681,41,19,22
1255,969,287,460,187,682,41,19,22
1260,977,288,461,187,689,41,19,22
1265,980,288,461,187,692,41,19,22
1270,985,289,464,187,696,41,19,22
1275,989,289,467,187,700,41,19,22
1280,992,289,468,187,703,41,19,22
1285,993,289,469,187,704,41,19,22
1290,998,290,471,187,708,41,19,22
1295,1000,291,472,188,709,41,19,22
1300,1008,292,478,189,716,41,19,22
1305,1011,292,478,189,719,41,19,22
1310,1016,293,481,189,723,42,20,22
1315,1020,293,482,189,726,42,20,22
1320,1023,295,484,191,727,42,20,22
1325,1024,296,484,192,728,42,20,22
1330,1029,296,486,192,733,42,20,22
1335,1031,296,488,192,735,42,20,22
1340,1039,297,492,192,742,42,20,22
1345,1042,297,493,192,745,42,20,22
1350,1047,298,495,193,749,42,20,22
1355,1051,298,497,193,753,42,20,22
1360,1054,298,498,193,756,42,20,22
1365,1055,298,498,193,757,42,20,22
1370,1060,298,502,193,762,42,20,22
1375,1062,298,504,193,764,42,20,22
1380,1070,299,509,194,771,42,20,22
1385,1073,299,510,194,774,42,20,22
1390,1078,300,512,195,778,42,20,22
1395,1082,300,515,195,782,42,20,22
1400,1085,300,515,195,785,42,20,22
1405,1086,300,515,195,786,42,20,22
1410,1091,300,516,195,791,42,20,22
1415,1093,300,517,195,793,42,20,22
1420,1101,301,520,196,800,42,20,22
1425,1104,301,523,196,803,42,20,22
1430,1109,303,524,197,806,43,20,23
1435,1113,303,526,197,808,43,20,23
1440,1116,305,528,199,809,43,20,23
1445,1117,306,529,200,811,43,20,23
1450,1122,307,533,201,815,43,20,23
1455,1124,308,535,202,816,43,20,23
1460,1132,308,539,202,824,43,20,23
1465,1135,308,542,202,827,43,20,23
1470,1140,309,545,203,831,44,20,24
1475,1144,309,548,203,835,44,20,24
1480,1147,309,549,203,838,44,20,24
1485,1148,309,549,203,839,44,20,24
1490,1153,310,551,203,843,44,20,24
1495,1155,311,551,203,844,44,20,24
1500,1163,311,556,203,852,45,21,24
1505,1166,311,559,203,855,45,21,24
1510,1171,313,562,205,858,46,21,25
1515,1175,313,565,205,862,46,21,25
1520,1178,313,565,205,865,46,21,25
1525,1179,313,566,205,866,46,21,25
1530,1184,314,568,206,870,46,21,25
1535,1186,315,569,206,871,46,21,25
1540,1194,315,571,206,879,46,21,25
1545,1197,315,573,206,882,46,21,25
1550,1202,317,575,207,885,47,22,25
1555,1206,318,578,208,886,47,22,25
1560,1209,321,579,211,888,47,22,25
1565,1210,321,579,211,889,47,22,25
1570,1215,322,582,211,893,47,22,25
1575,1217,322,583,211,895,47,22,25
1580,1225,323,585,211,902,47,22,25
1585,1228,324,587,212,904,47,22,25
1590,1233,325,591,213,908,47,22,25
1595,1237,325,591,213,912,47,22,25
1600,1240,325,593,213,915,47,22,25
1605,1241,325,593,213,916,47,22,25
1610,1246,326,594,213,920,47,22,25
1615,1248,326,595,213,922,47,22,25
1620,1256,327,598,214,929,47,22,25
1625,1259,328,600,215,931,47,22,25
1630,1264,329,604,216,935,47,22,25
1635,1268,329,606,216,939,47,22,25
1640,1271,329,607,216,942,47,22,25
1645,1272,329,607,216,943,47,22,25
1650,1277,330,610,217,947,47,22,25
1655,1279,330,611,217,949,47,22,25
1660,1287,331,615,218,956,47,22,25
1665,1290,331,615,218,959,47,22,25
1670,1295,332,617,219,962,48,22,26
1675,1299,333,618,220,965,48,22,26
1680,1302,335,619,222,967,48,22,26
1685,1303,335,619,222,968,48,22,26
1690,1308,336,623,223,971,48,22,26
1695,1310,338,624,225,972,48,22,26
1700,1318,338,627,225,980,48,22,26
1705,1321,338,628,225,983,48,22,26
1710,1326,339,629,225,987,49,22,27
1715,1330,339,630,225,991,49,22,27
1720,1333,339,631,225,994,49,22,27
1725,1334,339,632,225,995,49,22,27
1730,1339,340,634,226,999,49,22,27
1735,1341,341,635,227,1000,49,22,27
1740,1349,341,639,227,1008,49,22,27
1745,1352,341,639,227,1011,49,22,27
1750,1357,342,644,228,1015,50,23,27
1755,1361,342,646,228,1019,50,23,27
1760,1364,342,648,228,1022,50,23,27
1765,1365,342,649,228,1023,50,23,27
1770,1370,343,651,228,1026,50,23,27
1775,1372,345,653,230,1027,50,23,27
1780,1380,345,656,230,1035,50,23,27
1785,1383,345,658,230,1038,50,23,27
1790,1388,346,659,230,1042,51,23,28
1795,1392,348,661,232,1044,51,23,28
1800,1395,349,663,233,1045,51,23,28
1805,1396,350,664,234,1046,51,23,28
1810,1401,350,666,234,1051,51,23,28
1815,1403,350,667,234,1053,51,23,28
1820,1411,351,671,235,1060,51,23,28
1825,1414,351,673,235,1063,51,23,28
1830,1419,352,676,235,1067,51,23,28
1835,1423,352,677,235,1071,51,23,28
1840,1426,352,678,235,1074,51,23,28
1845,1427,352,679,235,1075,51,23,28
1850,1432,352,682,235,1080,51,23,28
1855,1434,352,683,235,1082,51,23,28
1860,1442,353,687,236,1089,51,23,28
1865,1445,353,688,236,1092,51,23,28
1870,1450,354,690,236,1096,51,23,28
1875,1454,354,691,236,1100,51,23,28
1880,1457,354,693,236,1103,51,23,28
1885,1458,354,694,236,1104,51,23,28
1890,1463,354,697,236,1109,51,23,28
1895,1465,354,698,236,1111,51,23,28
1900,1473,355,701,237,1118,51,23,28
1905,1476,355,701,237,1121,51,23,28
1910,1481,357,702,238,1124,51,23,28
1915,1485,358,705,239,1125,51,23,28
1920,1488,361,707,242,1126,51,23,28
1925,1489,362,707,243,1127,51,23,28
1930,1494,363,711,244,1131,51,23,28
1935,1496,364,713,245,1132,51,23,28
1940,1504,365,717,245,1139,51,23,28
1945,1507,365,720,245,1142,51,23,28
1950,1512,366,724,246,1146,52,24,28
1955,1516,366,726,246,1150,52,24,28
1960,1519,366,726,246,1153,52,24,28
1965,1520,366,726,246,1154,52,24,28
1970,1525,367,727,246,1158,52,24,28
1975,1527,368,729,247,1159,52,24,28
1980,1535,369,732,248,1166,52,24,28
1985,1538,369,735,248,1169,52,24,28
1990,1543,370,737,248,1173,53,24,29
1995,1547,370,739,248,1177,53,24,29
2000,1550,370,741,248,1180,53,24,29
2005,1551,370,742,248,1181,53,24,29
2010,1556,371,743,248,1185,53,24,29
2015,1558,372,743,248,1186,53,24,29
2020,1566,373,747,249,1193,53,24,29
2025,1569,373,750,249,1196,53,24,29
2030,1574,375,751,250,1199,54,24,30
2035,1578,375,752,250,1202,54,24,30
2040,1581,376,752,251,1205,54,24,30
2045,1582,376,752,251,1206,54,24,30
2050,1587,376,755,251,1211,54,24,30
2055,1589,376,756,251,1213,54,24,30
2060,1597,376,760,251,1221,54,24,30
2065,1600,376,762,251,1224,54,24,30
2070,1605,377,765,251,1228,54,24,30
2075,1609,377,766,251,1232,54,24,30
2080,1612,377,766,251,1235,54,24,30
2085,1613,377,766,251,1236,54,24,30
2090,1618,377,770,251,1241,54,24,30
2095,1620,377,771,251,1243,54,24,30
2100,1628,377,774,251,1251,54,24,30
2105,1631,377,777,251,1254,54,24,30
2110,1636,378,777,251,1258,54,24,30
2115,1640,378,780,251,1262,54,24,30
2120,1643,378,782,251,1265,54,24,30
2125,1644,378,783,251,1266,54,24,30
2130,1649,378,785,251,1271,54,24,30
2135,1651,378,786,251,1273,54,24,30
2140,1659,378,792,251,1281,54,24,30
2145,1662,378,793,251,1284,54,24,30
2150,1667,379,796,251,1287,55,25,30
2155,1671,381,797,253,1290,55,25,30
2160,1674,383,800,255,1290,55,25,30
2165,1675,384,801,256,1291,55,25,30
2170,1680,385,803,256,1295,55,25,30
2175,1682,386,805,257,1296,55,25,30
2180,1690,387,809,258,1303,55,25,30
2185,1693,387,809,258,1306,55,25,30
2190,1698,388,811,259,1310,55,25,30
2195,1702,388,813,259,1314,55,25,30
2200,1705,388,813,259,1317,55,25,30
2205,1706,388,813,259,1318,55,25,30
2210,1711,389,817,260,1322,55,25,30
2215,1713,390,818,260,1323,55,25,30
2220,1721,391,822,261,1330,55,25,30
2225,1724,391,824,261,1333,55,25,30
2230,1729,392,826,261,1337,55,25,30
2235,1733,392,827,261,1341,55,25,30
2240,1736,392,829,261,1344,55,25,30
2245,1737,392,830,261,1345,55,25,30
2250,1742,393,832,261,1349,55,25,30
2255,1744,394,833,261,1350,55,25,30
2260,1752,395,838,261,1357,55,25,30
2265,1755,395,838,261,1360,55,25,30
2270,1760,397,840,263,1363,56,25,31
2275,1764,399,843,265,1364,56,25,31
2280,1767,400,843,266,1367,56,25,31
2285,1768,400,843,266,1368,56,25,31
2290,1773,401,844,267,1372,56,25,31
2295,1775,402,844,267,1373,56,25,31
2300,1783,403,846,268,1380,56,25,31
2305,1786,403,846,268,1383,56,25,31
2310,1791,404,849,269,1387,57,25,32
2315,1795,404,853,269,1391,57,25,32
2320,1798,404,854,269,1394,57,25,32
2325,1799,404,854,269,1395,57,25,32
2330,1804,405,857,269,1399,57,25,32
2335,1806,406,858,269,1400,57,25,32
2340,1814,407,860,270,1407,57,25,32
2345,1817,407,863,270,1410,57,25,32
2350,1822,408,867,271,1414,57,25,32
2355,1826,408,870,271,1418,57,25,32
2360,1829,408,871,271,1421,57,25,32
2365,1830,408,872,271,1422,57,25,32
2370,1835,409,874,271,1426,57,25,32
2375,1837,410,875,272,1427,57,25,32
2380,1845,411,876,272,1434,57,25,32
2385,1848,411,878,272,1437,57,25,32
2390,1853,414,881,274,1439,57,25,32
2395,1857,416,884,276,1440,57,25,32
2400,1860,419,886,279,1441,57,25,32
2405,1861,419,886,279,1442,57,25,32
2410,1866,419,889,279,1446,57,25,32
2415,1868,421,890,281,1447,57,25,32
2420,1876,421,895,281,1455,57,25,32
2425,1879,421,895,281,1458,57,25,32
2430,1884,422,897,282,1462,57,25,32
2435,1888,422,899,282,1466,57,25,32
2440,1891,422,900,282,1469,57,25,32
2445,1892,422,900,282,1470,57,25,32
2450,1897,422,903,282,1474,57,25,32
2455,1899,424,904,283,1475,57,25,32
2460,1907,424,911,283,1483,57,25,32
2465,1910,424,913,283,1486,57,25,32
2470,1915,425,915,284,1490,57,25,32
2475,1919,425,918,284,1494,57,25,32
2480,1922,425,921,284,1497,57,25,32
2485,1923,425,922,284,1498,57,25,32
2490,1928,425,926,284,1502,57,25,32
2495,1930,427,926,285,1503,57,25,32
2500,1938,427,929,285,1511,57,25,32
2505,1941,427,931,285,1514,57,25,32
2510,1946,429,935,286,1517,58,26,32
2515,1950,430,936,287,1520,58,26,32
2520,1953,431,937,288,1522,58,26,32
2525,1954,431,937,288,1523,58,26,32
2530,1959,432,940,289,1527,58,26,32
2535,1961,433,941,290,1528,58,26,32
2540,1969,434,946,291,1535,58,26,32
2545,1972,434,947,291,1538,58,26,32
2550,1977,435,951,292,1542,58,26,32
2555,1981,435,951,292,1546,58,26,32
2560,1984,435,951,292,1549,58,26,32
2565,1985,435,951,292,1550,58,26,32
2570,1990,436,953,293,1554,58,26,32
2575,1992,437,953,293,1555,58,26,32
2580,2000,438,956,294,1562,58,26,32
2585,2003,438,957,294,1565,58,26,32
2590,2008,439,959,294,1569,58,26,32
2595,2012,439,959,294,1573,58,26,32
2600,2015,439,961,294,1576,58,26,32
2605,2016,439,962,294,1577,58,26,32
2610,2021,440,964,294,1581,58,26,32
2615,2023,441,966,295,1582,58,26,32
2620,2031,443,972,297,1588,58,26,32
2625,2034,443,972,297,1591,58,26,32
2630,2039,445,975,299,1594,59,27,32
2635,2043,446,978,300,1595,59,27,32
2640,2046,450,980,304,1596,59,27,32
2645,2047,450,981,304,1597,59,27,32
2650,2052,450,983,304,1602,59,27,32
2655,2054,450,985,304,1604,59,27,32
2660,2062,450,989,304,1612,59,27,32
2665,2065,450,991,304,1615,59,27,32
2670,2070,450,994,304,1620,60,27,33
2675,2074,450,994,304,1624,60,27,33
2680,2077,450,994,304,1627,60,27,33
2685,2078,450,995,304,1628,60,27,33
2690,2083,450,999,304,1633,60,27,33
2695,2085,450,1000,304,1635,60,27,33
2700,2093,450,1006,304,1643,60,27,33
2705,2096,450,1009,304,1646,60,27,33
2710,2101,450,1012,304,1651,61,28,33
2715,2105,450,1014,304,1655,61,28,33
2720,2108,450,1015,304,1658,61,28,33
2725,2109,450,1015,304,1659,61,28,33
2730,2114,450,1016,304,1664,61,28,33
2735,2116,450,1016,304,1666,61,28,33
2740,2124,450,1022,304,1674,61,28,33
2745,2127,450,1024,304,1677,61,28,33
2750,2132,451,1026,305,1681,62,29,33
2755,2136,451,1026,305,1685,62,29,33
2760,2139,451,1028,305,1686,62,29,33
2765,2140,453,1028,307,1687,62,29,33
2770,2145,454,1030,307,1691,62,29,33
2775,2147,455,1032,308,1692,62,29,33
2780,2155,455,1034,308,1700,63,30,33
2785,2158,455,1036,308,1703,63,30,33
2790,2163,456,1038,308,1707,63,30,33
2795,2167,456,1042,308,1711,63,30,33
2800,2170,456,1043,308,1714,63,30,33
2805,2171,456,1044,308,1715,63,30,33
2810,2176,457,1048,309,1719,63,30,33
2815,2178,458,1049,310,1720,63,30,33
2820,2186,458,1051,310,1728,64,31,33
2825,2189,458,1051,310,1731,64,31,33
2830,2194,459,1055,311,1735,64,31,33
2835,2198,459,1059,311,1739,64,31,33
2840,2201,459,1061,311,1742,64,31,33
2845,2202,459,1061,311,1743,64,31,33
2850,2207,460,1065,312,1747,64,31,33
2855,2209,461,1065,312,1748,64,31,33
2860,2217,461,1069,312,1756,64,31,33
2865,2220,461,1071,312,1759,64,31,33
2870,2225,462,1073,313,1763,65,31,34
2875,2229,462,1075,313,1765,65,31,34
2880,2232,466,1077,317,1766,65,31,34
2885,2233,466,1077,317,1767,65,31,34
2890,2238,467,1077,317,1771,65,31,34
2895,2240,467,1079,317,1773,65,31,34
2900,2248,467,1086,317,1781,65,31,34
2905,2251,467,1089,317,1784,65,31,34
2910,2256,468,1092,317,1788,65,31,34
2915,2260,468,1092,317,1792,65,31,34
2920,2263,469,1093,318,1794,65,31,34
2925,2264,469,1094,318,1795,65,31,34
2930,2269,470,1096,319,1799,65,31,34
2935,2271,470,1097,319,1801,65,31,34
2940,2279,470,1100,319,1809,65,31,34
2945,2282,470,1102,319,1812,65,31,34
2950,2287,471,1104,320,1816,65,31,34
2955,2291,471,1105,320,1820,65,31,34
2960,2294,472,1108,321,1822,65,31,34
2965,2295,472,1109,321,1823,65,31,34
2970,2300,473,1110,321,1827,65,31,34
2975,2302,473,1111,321,1829,65,31,34
2980,2310,473,1114,321,1837,65,31,34
2985,2313,473,1115,321,1840,65,31,34
2990,2318,474,1117,322,1844,66,32,34
2995,2322,474,1118,322,1847,66,32,34
3000,2325,475,1119,323,1849,66,32,34
3005,2326,476,1119,324,1850,66,32,34
3010,2331,477,1122,325,1854,66,32,34
3015,2333,478,1123,325,1855,66,32,34
3020,2341,478,1128,325,1863,66,32,34
3025,2344,478,1131,325,1866,66,32,34
3030,2349,478,1133,325,1871,67,33,34
3035,2353,478,1133,325,1875,67,33,34
3040,2356,478,1134,325,1878,67,33,34
3045,2357,478,1134,325,1879,67,33,34
3050,2362,479,1138,325,1883,67,33,34
3055,2364,480,1139,326,1884,67,33,34
3060,2372,480,1143,326,1892,67,33,34
3065,2375,480,1145,326,1895,67,33,34
3070,2380,481,1148,326,1899,68,33,35
3075,2384,481,1151,326,1902,68,33,35
3080,2387,483,1153,328,1904,68,33,35
3085,2388,483,1153,328,1905,68,33,35
3090,2393,484,1155,328,1909,68,33,35
3095,2395,485,1156,329,1910,68,33,35
3100,2403,485,1161,329,1918,68,33,35
3105,2406,485,1162,329,1921,68,33,35
3110,2411,487,1165,330,1924,69,33,36
3115,2415,489,1168,332,1925,69,33,36
3120,2418,491,1169,334,1927,69,33,36
3125,2419,491,1169,334,1928,69,33,36
3130,2424,491,1174,334,1933,69,33,36
3135,2426,492,1174,334,1934,69,33,36
3140,2434,492,1179,334,1942,69,33,36
3145,2437,492,1180,334,1945,69,33,36
3150,2442,492,1181,334,1950,69,33,36
3155,2446,492,1181,334,1954,69,33,36
3160,2449,492,1181,334,1957,69,33,36
3165,2450,492,1181,334,1958,69,33,36
3170,2455,492,1184,334,1963,69,33,36
3175,2457,493,1185,334,1964,69,33,36
3180,2465,493,1188,334,1972,69,33,36
3185,2468,493,1190,334,1975,69,33,36
3190,2473,493,1191,334,1980,69,33,36
3195,2477,493,1191,334,1984,69,33,36
3200,2480,493,1193,334,1987,69,33,36
3205,2481,493,1193,334,1988,69,33,36
3210,2486,493,1195,334,1993,69,33,36
3215,2488,494,1196,334,1994,69,33,36
3220,2496,494,1200,334,2002,69,33,36
3225,2499,494,1203,334,2005,69,33,36
3230,2504,496,1205,335,2008,70,34,36
3235,2508,497,1208,336,2009,70,34,36
3240,2511,501,1210,340,2010,70,34,36
3245,2512,501,1210,340,2011,70,34,36
3250,2517,502,1214,341,2015,70,34,36
3255,2519,502,1215,341,2017,70,34,36
3260,2527,502,1216,341,2025,70,34,36
3265,2530,502,1217,341,2028,70,34,36
3270,2535,502,1220,341,2033,71,34,37
3275,2539,502,1221,341,2037,71,34,37
3280,2542,502,1221,341,2040,71,34,37
3285,2543,502,1222,341,2041,71,34,37
3290,2548,503,1224,342,2045,71,34,37
3295,2550,503,1225,342,2047,71,34,37
3300,2558,503,1230,342,2055,71,34,37
3305,2561,503,1232,342,2058,71,34,37
3310,2566,503,1236,342,2063,72,35,37
3315,2570,503,1239,342,2067,72,35,37
3320,2573,503,1239,342,2070,72,35,37
3325,2574,503,1239,342,2071,72,35,37
3330,2579,504,1242,343,2075,72,35,37
3335,2581,504,1244,343,2077,72,35,37
3340,2589,504,1248,343,2085,72,35,37
3345,2592,504,1248,343,2088,72,35,37
3350,2597,505,1251,344,2092,73,35,38
3355,2601,505,1253,344,2094,73,35,38
3360,2604,507,1253,346,2097,73,35,38
3365,2605,507,1253,346,2098,73,35,38
3370,2610,508,1256,347,2102,73,35,38
3375,2612,509,1257,347,2103,73,35,38
3380,2620,510,1263,348,2110,73,35,38
3385,2623,510,1264,348,2113,73,35,38
3390,2628,511,1267,348,2117,73,35,38
3395,2632,511,1270,348,2121,73,35,38
3400,2635,512,1272,349,2123,73,35,38
3405,2636,512,1272,349,2124,73,35,38
3410,2641,513,1273,349,2128,73,35,38
3415,2643,514,1275,350,2129,73,35,38
3420,2651,515,1280,351,2136,74,35,39
3425,2654,515,1282,351,2139,74,35,39
3430,2659,516,1282,351,2143,74,35,39
3435,2663,516,1282,351,2147,74,35,39
3440,2666,517,1284,352,2149,74,35,39
3445,2667,517,1284,352,2150,74,35,39
3450,2672,518,1287,353,2154,74,35,39
3455,2674,519,1289,354,2155,74,35,39
3460,2682,520,1290,354,2162,75,35,40
3465,2685,520,1293,354,2165,75,35,40
3470,2690,521,1293,354,2169,76,35,41
3475,2694,522,1296,355,2171,76,35,41
3480,2697,524,1297,357,2173,76,35,41
3485,2698,524,1297,357,2174,76,35,41
3490,2703,524,1300,357,2179,76,35,41
3495,2705,524,1302,357,2181,76,35,41
3500,2713,524,1303,357,2189,76,35,41
3505,2716,524,1304,357,2192,76,35,41
3510,2721,525,1308,358,2196,77,36,41
3515,2725,525,1310,358,2199,77,36,41
3520,2728,526,1310,359,2202,77,36,41
3525,2729,526,1310,359,2203,77,36,41
3530,2734,526,1313,359,2208,77,36,41
3535,2736,526,1315,359,2210,77,36,41
3540,2744,526,1319,359,2218,77,36,41
3545,2747,526,1322,359,2221,77,36,41
3550,2752,527,1323,360,2225,78,36,42
3555,2756,527,1323,360,2229,78,36,42
3560,2759,527,1326,360,2232,78,36,42
3565,2760,527,1326,360,2233,78,36,42
3570,2765,527,1328,360,2238,78,36,42
3575,2767,527,1329,360,2240,78,36,42
3580,2775,527,1334,360,2247,78,36,42
3585,2778,528,1336,361,2250,78,36,42
3590,2783,529,1339,361,2254,79,36,43
3595,2787,531,1342,363,2255,79,36,43
3600,2790,533,1344,365,2256,79,36,43
3605,2791,534,1344,366,2257,79,36,43
3610,2796,535,1348,367,2261,79,36,43
3615,2798,536,1349,368,2262,79,36,43
3620,2806,538,1352,370,2268,80,37,43
3625,2809,538,1353,370,2271,80,37,43
3630,2814,538,1355,370,2276,80,37,43
3635,2818,538,1357,370,2280,80,37,43
3640,2821,538,1359,370,2283,80,37,43
3645,2822,538,1359,370,2284,80,37,43
3650,2827,539,1362,370,2288,80,37,43
3655,2829,540,1363,371,2289,80,37,43
3660,2837,542,1367,372,2294,81,37,44
3665,2840,544,1368,374,2296,81,37,44
3670,2845,545,1371,374,2300,81,37,44
3675,2849,545,1375,374,2304,81,37,44
3680,2852,545,1377,374,2307,81,37,44
3685,2853,545,1377,374,2308,81,37,44
3690,2858,546,1378,374,2312,81,37,44
3695,2860,547,1380,375,2313,81,37,44
3700,2868,548,1382,375,2320,82,37,45
3705,2871,548,1383,375,2323,82,37,45
3710,2876,550,1387,377,2326,83,38,45
3715,2880,552,1391,379,2327,83,38,45
3720,2883,553,1391,380,2330,83,38,45
3725,2884,553,1391,380,2331,83,38,45
3730,2889,554,1393,381,2335,83,38,45
3735,2891,554,1395,381,2337,83,38,45
3740,2899,555,1399,381,2344,83,38,45
3745,2902,555,1401,381,2347,83,38,45
3750,2907,555,1402,381,2352,84,38,46
3755,2911,555,1404,381,2356,84,38,46
3760,2914,555,1405,381,2359,84,38,46
3765,2915,555,1405,381,2360,84,38,46
3770,2920,556,1408,382,2364,84,38,46
3775,2922,556,1408,382,2366,84,38,46
3780,2930,557,1413,383,2372,85,39,46
3785,2933,558,1414,384,2375,85,39,46
3790,2938,558,1415,384,2380,86,39,47
3795,2942,558,1415,384,2384,86,39,47
3800,2945,558,1416,384,2387,86,39,47
3805,2946,558,1417,384,2388,86,39,47
3810,2951,559,1421,385,2392,86,39,47
3815,2953,559,1421,385,2394,86,39,47
3820,2961,561,1424,386,2399,87,39,48
3825,2964,562,1426,387,2402,87,39,48
3830,2969,563,1429,387,2405,88,39,49
3835,2973,564,1432,388,2406,88,39,49
3840,2976,569,1434,393,2407,88,39,49
3845,2977,569,1434,393,2408,88,39,49
3850,2982,570,1437,394,2412,88,39,49
3855,2984,571,1437,394,2413,88,39,49
3860,2992,572,1443,395,2420,89,39,50
3865,2995,572,1444,395,2423,89,39,50
3870,3000,572,1447,395,2428,89,39,50
3875,3004,572,1450,395,2432,89,39,50
3880,3007,572,1451,395,2435,89,39,50
3885,3008,572,1451,395,2436,89,39,50
3890,3013,573,1454,396,2440,89,39,50
3895,3015,574,1454,396,2441,89,39,50
3900,3023,575,1458,396,2448,90,39,51
3905,3026,575,1458,396,2451,90,39,51
3910,3031,575,1458,396,2456,90,39,51
3915,3035,575,1461,396,2460,90,39,51
3920,3038,575,1461,396,2463,90,39,51
3925,3039,575,1461,396,2464,90,39,51
3930,3044,576,1463,396,2468,90,39,51
3935,3046,577,1463,396,2469,90,39,51
3940,3054,578,1466,397,2476,91,39,52
3945,3057,578,1468,397,2479,91,39,52
3950,3062,579,1471,398,2483,92,40,52
3955,3066,580,1472,399,2486,92,40,52
3960,3069,580,1473,399,2488,92,40,52
3965,3070,581,1473,400,2489,92,40,52
3970,3075,581,1475,400,2494,92,40,52
3975,3077,582,1476,400,2495,92,40,52
3980,3085,583,1478,401,2502,92,40,52
3985,3088,583,1480,401,2505,92,40,52
3990,3093,584,1484,402,2509,93,41,52
3995,3097,584,1486,402,2513,93,41,52
4000,3100,584,1487,402,2516,93,41,52
4005,3101,584,1488,402,2517,93,41,52
4010,3106,584,1490,402,2522,93,41,52
4015,3108,585,1490,402,2523,93,41,52
4020,3116,586,1497,403,2530,93,41,52
4025,3119,586,1499,403,2533,93,41,52
4030,3124,587,1501,403,2537,94,42,52
4035,3128,587,1501,403,2541,94,42,52
4040,3131,587,1503,403,2544,94,42,52
4045,3132,587,1504,403,2545,94,42,52
4050,3137,587,1505,403,2550,94,42,52
4055,3139,588,1507,404,2551,94,42,52
4060,3147,589,1510,404,2558,94,42,52
4065,3150,589,1510,404,2561,94,42,52
4070,3155,590,1511,404,2565,95,42,53
4075,3159,590,1512,404,2569,95,42,53
4080,3162,591,1514,405,2570,95,42,53
4085,3163,592,1514,406,2571,95,42,53
4090,3168,593,1517,407,2575,95,42,53
4095,3170,594,1517,407,2576,95,42,53
4100,3178,595,1518,407,2583,95,42,53
4105,3181,596,1521,408,2585,95,42,53
4110,3186,596,1524,408,2590,95,42,53
4115,3190,596,1526,408,2594,95,42,53
4120,3193,596,1527,408,2597,95,42,53
4125,3194,596,1528,408,2598,95,42,53
4130,3199,597,1530,408,2602,95,42,53
4135,3201,598,1530,408,2603,95,42,53
4140,3209,599,1532,408,2610,95,42,53
4145,3212,600,1535,409,2612,95,42,53
4150,3217,601,1537,409,2616,95,42,53
4155,3221,601,1540,409,2620,95,42,53
4160,3224,601,1541,409,2623,95,42,53
4165,3225,601,1542,409,2624,95,42,53
4170,3230,602,1546,410,2628,95,42,53
4175,3232,603,1547,411,2629,95,42,53
4180,3240,605,1551,412,2634,95,42,53
4185,3243,607,1553,414,2636,95,42,53
4190,3248,609,1557,416,2639,96,43,53
4195,3252,610,1559,417,2641,96,43,53
4200,3255,612,1561,419,2642,96,43,53
4205,3256,613,1562,420,2643,96,43,53
4210,3261,614,1565,421,2647,96,43,53
4215,3263,614,1565,421,2649,96,43,53
4220,3271,614,1570,421,2657,96,43,53
4225,3274,614,1572,421,2660,96,43,53
4230,3279,614,1573,421,2665,97,43,54
4235,3283,614,1576,421,2669,97,43,54
4240,3286,614,1577,421,2672,97,43,54
4245,3287,614,1577,421,2673,97,43,54
4250,3292,615,1579,422,2677,97,43,54
4255,3294,615,1581,422,2679,97,43,54
4260,3302,615,1584,422,2687,97,43,54
4265,3305,615,1587,422,2690,97,43,54
4270,3310,616,1590,422,2694,98,43,55
4275,3314,616,1594,422,2697,98,43,55
4280,3317,617,1595,423,2700,98,43,55
4285,3318,617,1595,423,2701,98,43,55
4290,3323,618,1599,424,2705,98,43,55
4295,3325,618,1601,424,2707,98,43,55
4300,3333,618,1605,424,2715,98,43,55
4305,3336,618,1607,424,2718,98,43,55
4310,3341,619,1609,425,2722,99,43,56
4315,3345,619,1612,425,2723,99,43,56
4320,3348,623,1613,429,2725,99,43,56
4325,3349,623,1613,429,2726,99,43,56
4330,3354,623,1616,429,2731,99,43,56
4335,3356,624,1618,430,2732,99,43,56
4340,3364,625,1623,430,2739,99,43,56
4345,3367,626,1624,431,2741,99,43,56
4350,3372,626,1628,431,2746,99,43,56
4355,3376,627,1632,432,2749,99,43,56
4360,3379,628,1635,433,2751,99,43,56
4365,3380,628,1636,433,2752,99,43,56
4370,3385,628,1641,433,2757,99,43,56
4375,3387,629,1642,433,2758,99,43,56
4380,3395,630,1646,433,2765,99,43,56
4385,3398,631,1648,434,2767,99,43,56
4390,3403,631,1651,434,2772,100,43,57
4395,3407,632,1654,435,2774,100,43,57
4400,3410,633,1655,436,2776,100,43,57
4405,3411,634,1655,437,2777,100,43,57
4410,3416,634,1658,437,2781,100,43,57
4415,3418,636,1659,439,2782,100,43,57
4420,3426,637,1663,440,2788,100,43,57
4425,3429,638,1665,441,2790,100,43,57
4430,3434,639,1667,442,2795,101,44,57
4435,3438,639,1669,442,2798,101,44,57
4440,3441,640,1669,443,2801,101,44,57
4445,3442,640,1669,443,2802,101,44,57
4450,3447,641,1672,444,2806,101,44,57
4455,3449,641,1673,444,2808,101,44,57
4460,3457,641,1676,444,2816,102,44,58
4465,3460,641,1677,444,2819,102,44,58
4470,3465,643,1678,445,2822,102,44,58
4475,3469,643,1679,445,2826,102,44,58
4480,3472,643,1680,445,2829,102,44,58
4485,3473,644,1681,446,2829,102,44,58
4490,3478,645,1683,447,2833,102,44,58
4495,3480,645,1685,447,2835,102,44,58
4500,3488,645,1689,447,2842,103,44,59
4505,3491,646,1689,448,2845,103,44,59
4510,3496,647,1691,448,2849,103,44,59
4515,3500,647,1692,448,2853,103,44,59
4520,3503,647,1694,448,2856,103,44,59
4525,3504,648,1695,449,2856,103,44,59
4530,3509,649,1695,449,2860,103,44,59
4535,3511,649,1696,449,2862,103,44,59
4540,3519,649,1701,449,2870,104,45,59
4545,3522,649,1703,449,2872,104,45,59
4550,3527,650,1705,450,2877,105,46,59
4555,3531,650,1705,450,2881,105,46,59
4560,3534,650,1705,450,2884,105,46,59
4565,3535,650,1705,450,2885,105,46,59
4570,3540,650,1708,450,2890,105,46,59
4575,3542,651,1710,451,2891,105,46,59
4580,3550,652,1713,452,2898,105,46,59
4585,3553,652,1714,452,2901,105,46,59
4590,3558,653,1714,452,2905,106,46,60
4595,3562,653,1715,452,2909,106,46,60
4600,3565,654,1717,453,2911,106,46,60
4605,3566,654,1717,453,2912,106,46,60
4610,3571,654,1719,453,2917,106,46,60
4615,3573,655,1720,453,2918,106,46,60
4620,3581,656,1723,453,2925,106,46,60
4625,3584,656,1725,453,2928,106,46,60
4630,3589,657,1727,453,2932,106,46,60
4635,3593,657,1728,453,2936,106,46,60
4640,3596,657,1729,453,2939,106,46,60
4645,3597,657,1729,453,2940,106,46,60
4650,3602,657,1732,453,2945,106,46,60
4655,3604,658,1733,453,2946,106,46,60
4660,3612,659,1737,453,2953,106,46,60
4665,3615,659,1738,453,2956,106,46,60
4670,3620,660,1739,453,2960,106,46,60
4675,3624,660,1742,453,2961,106,46,60
4680,3627,664,1743,457,2963,106,46,60
4685,3628,664,1744,457,2964,106,46,60
4690,3633,665,1746,457,2968,106,46,60
4695,3635,665,1747,457,2970,106,46,60
4700,3643,666,1751,458,2976,106,46,60
4705,3646,667,1753,459,2979,106,46,60
4710,3651,667,1755,459,2984,106,46,60
4715,3655,667,1757,459,2988,106,46,60
4720,3658,667,1759,459,2991,106,46,60
4725,3659,667,1760,459,2992,106,46,60
4730,3664,668,1762,459,2996,106,46,60
4735,3666,668,1763,459,2998,106,46,60
4740,3674,670,1767,460,3004,106,46,60
4745,3677,670,1770,460,3007,106,46,60
4750,3682,670,1772,460,3012,106,46,60
4755,3686,670,1774,460,3016,106,46,60
4760,3689,670,1775,460,3019,106,46,60
4765,3690,670,1775,460,3020,106,46,60
4770,3695,671,1777,461,3024,106,46,60
4775,3697,671,1778,461,3026,106,46,60
4780,3705,673,1781,463,3031,106,46,60
4785,3708,674,1782,464,3034,106,46,60
4790,3713,676,1786,466,3037,107,47,60
4795,3717,676,1787,466,3040,107,47,60
4800,3720,678,1788,468,3042,107,47,60
4805,3721,678,1789,468,3043,107,47,60
4810,3726,679,1792,469,3047,107,47,60
4815,3728,680,1793,469,3048,107,47,60
4820,3736,680,1797,469,3056,107,47,60
4825,3739,681,1799,470,3058,107,47,60
4830,3744,682,1800,470,3062,107,47,60
4835,3748,682,1801,470,3066,107,47,60
4840,3751,682,1802,470,3069,107,47,60
4845,3752,682,1802,470,3070,107,47,60
4850,3757,683,1805,471,3074,107,47,60
4855,3759,684,1805,471,3075,107,47,60
4860,3767,684,1809,471,3083,107,47,60
4865,3770,684,1811,471,3086,107,47,60
4870,3775,685,1812,471,3090,107,47,60
4875,3779,685,1815,471,3094,107,47,60
4880,3782,685,1817,471,3097,107,47,60
4885,3783,685,1817,471,3098,107,47,60
4890,3788,686,1818,471,3102,107,47,60
4895,3790,687,1819,472,3103,107,47,60
4900,3798,687,1823,472,3111,107,47,60
4905,3801,687,1824,472,3114,107,47,60
4910,3806,689,1828,474,3117,108,47,61
4915,3810,691,1832,476,3117,108,47,61
4920,3813,693,1833,478,3119,108,47,61
4925,3814,694,1833,479,3120,108,47,61
4930,3819,694,1835,479,3125,108,47,61
4935,3821,694,1836,479,3127,108,47,61
4940,3829,695,1842,479,3134,108,47,61
4945,3832,695,1843,479,3137,108,47,61
4950,3837,696,1846,479,3141,109,47,62
4955,3841,696,1849,479,3145,109,47,62
4960,3844,696,1851,479,3148,109,47,62
4965,3845,696,1851,479,3149,109,47,62
4970,3850,696,1856,479,3154,109,47,62
4975,3852,696,1856,479,3156,109,47,62
4980,3860,697,1862,479,3163,109,47,62
4985,3863,697,1864,479,3166,109,47,62
4990,3868,698,1867,480,3170,110,48,62
4995,3872,698,1868,480,3174,110,48,62
5000,3875,698,1871,480,3177,110,48,62
5005,3876,698,1872,480,3178,110,48,62
5010,3881,698,1875,480,3183,110,48,62
5015,3883,698,1877,480,3185,110,48,62
5020,3891,699,1880,481,3192,110,48,62
5025,3894,699,1883,481,3195,110,48,62
5030,3899,700,1883,481,3199,111,48,63
5035,3903,701,1884,482,3202,111,48,63
5040,3906,702,1886,483,3203,111,48,63
5045,3907,703,1886,484,3204,111,48,63
5050,3912,704,1889,485,3208,111,48,63
5055,3914,705,1890,486,3209,111,48,63
5060,3922,706,1894,486,3216,111,48,63
5065,3925,706,1894,486,3219,111,48,63
5070,3930,707,1894,486,3223,111,48,63
5075,3934,707,1895,486,3227,111,48,63
5080,3937,707,1897,486,3230,111,48,63
5085,3938,707,1898,486,3231,111,48,63
5090,3943,708,1899,487,3235,111,48,63
5095,3945,709,1900,487,3236,111,48,63
5100,3953,710,1906,488,3243,111,48,63
5105,3956,710,1908,488,3246,111,48,63
5110,3961,711,1911,488,3250,111,48,63
5115,3965,711,1914,488,3254,111,48,63
5120,3968,711,1914,488,3257,111,48,63
5125,3969,711,1915,488,3258,111,48,63
5130,3974,712,1916,488,3262,111,48,63
5135,3976,713,1918,489,3263,111,48,63
5140,3984,714,1921,490,3270,111,48,63
5145,3987,714,1923,490,3273,111,48,63
5150,3992,715,1925,490,3277,112,48,64
5155,3996,716,1926,491,3280,112,48,64
5160,3999,718,1928,493,3281,112,48,64
5165,4000,718,1929,493,3282,112,48,64
5170,4005,719,1934,494,3286,112,48,64
5175,4007,720,1935,495,3287,112,48,64
5180,4015,720,1938,495,3295,112,48,64
5185,4018,720,1940,495,3298,112,48,64
5190,4023,720,1943,495,3303,113,48,65
5195,4027,720,1946,495,3307,113,48,65
5200,4030,721,1948,496,3309,113,48,65
5205,4031,721,1948,496,3310,113,48,65
5210,4036,722,1951,497,3314,113,48,65
5215,4038,723,1953,498,3315,113,48,65
5220,4046,723,1956,498,3323,113,48,65
5225,4049,723,1959,498,3326,113,48,65
5230,4054,723,1961,498,3331,114,49,65
5235,4058,723,1961,498,3335,114,49,65
5240,4061,724,1962,499,3337,114,49,65
5245,4062,724,1963,499,3338,114,49,65
5250,4067,725,1965,499,3342,114,49,65
5255,4069,726,1966,500,3343,114,49,65
5260,4077,726,1971,500,3351,114,49,65
5265,4080,726,1973,500,3354,114,49,65
5270,4085,729,1976,502,3356,115,49,66
5275,4089,729,1976,502,3360,115,49,66
5280,4092,729,1976,502,3363,115,49,66
5285,4093,729,1976,502,3364,115,49,66
5290,4098,730,1979,503,3368,115,49,66
5295,4100,730,1980,503,3370,115,49,66
5300,4108,731,1982,503,3377,116,49,67
5305,4111,731,1984,503,3380,116,49,67
5310,4116,732,1988,503,3384,116,49,67
5315,4120,732,1990,503,3388,116,49,67
5320,4123,732,1992,503,3391,116,49,67
5325,4124,732,1992,503,3392,116,49,67
5330,4129,733,1995,503,3396,116,49,67
5335,4131,733,1996,503,3398,116,49,67
5340,4139,734,2001,504,3405,117,50,67
5345,4142,734,2003,504,3408,117,50,67
5350,4147,735,2004,504,3412,117,50,67
5355,4151,735,2005,504,3416,117,50,67
5360,4154,735,2007,504,3419,117,50,67
5365,4155,735,2007,504,3420,117,50,67
5370,4160,736,2009,504,3424,117,50,67
5375,4162,736,2009,504,3426,117,50,67
5380,4170,737,2012,504,3433,118,50,68
5385,4173,737,2015,504,3436,118,50,68
5390,4178,739,2017,506,3439,119,50,69
5395,4182,739,2019,506,3441,119,50,69
5400,4185,742,2021,509,3442,119,50,69
5405,4186,742,2021,509,3444,119,50,69
5410,4191,743,2025,510,3447,119,50,69
5415,4193,745,2026,512,3448,119,50,69
5420,4201,745,2031,512,3456,119,50,69
5425,4204,745,2032,512,3459,119,50,69
5430,4209,746,2035,512,3463,120,50,70
5435,4213,746,2036,512,3467,120,50,70
5440,4216,746,2037,512,3470,120,50,70
5445,4217,746,2038,512,3471,120,50,70
5450,4222,747,2039,512,3474,120,50,70
5455,4224,749,2040,514,3475,120,50,70
5460,4232,749,2043,514,3483,120,50,70
5465,4235,749,2045,514,3486,120,50,70
5470,4240,750,2047,514,3490,121,50,71
5475,4244,750,2050,514,3494,121,50,71
5480,4247,750,2052,514,3497,121,50,71
5485,4248,750,2053,514,3498,121,50,71
5490,4253,751,2055,514,3502,121,50,71
5495,4255,752,2056,514,3503,121,50,71
5500,4263,752,2059,514,3511,121,50,71
5505,4266,752,2061,514,3514,121,50,71
5510,4271,753,2062,514,3518,122,51,71
5515,4275,754,2066,515,3518,122,51,71
5520,4278,758,2067,519,3520,122,51,71
5525,4279,758,2067,519,3521,122,51,71
5530,4284,759,2070,520,3524,122,51,71
5535,4286,761,2071,521,3525,122,51,71
5540,4294,761,2073,521,3533,122,51,71
5545,4297,761,2074,521,3536,122,51,71
5550,4302,762,2078,522,3540,122,51,71
5555,4306,762,2082,522,3544,122,51,71
5560,4309,762,2083,522,3547,122,51,71
5565,4310,762,2084,522,3548,122,51,71
5570,4315,763,2086,522,3552,122,51,71
5575,4317,764,2087,522,3553,122,51,71
5580,4325,764,2092,522,3561,122,51,71
5585,4328,765,2095,523,3563,122,51,71
5590,4333,766,2099,523,3567,122,51,71
5595,4337,766,2100,523,3571,122,51,71
5600,4340,766,2101,523,3574,122,51,71
5605,4341,766,2102,523,3575,122,51,71
5610,4346,767,2105,524,3578,122,51,71
5615,4348,769,2105,525,3579,122,51,71
5620,4356,769,2110,525,3587,122,51,71
5625,4359,769,2111,525,3590,122,51,71
5630,4364,771,2113,526,3593,122,51,71
5635,4368,772,2115,527,3595,122,51,71
5640,4371,774,2117,529,3596,122,51,71
5645,4372,774,2118,529,3598,122,51,71
5650,4377,775,2121,529,3602,122,51,71
5655,4379,775,2123,529,3604,122,51,71
5660,4387,776,2125,529,3611,122,51,71
5665,4390,776,2126,529,3614,122,51,71
5670,4395,776,2128,529,3619,123,52,71
5675,4399,776,2130,529,3623,123,52,71
5680,4402,776,2131,529,3626,123,52,71
5685,4403,776,2132,529,3627,123,52,71
5690,4408,777,2136,530,3631,123,52,71
5695,4410,777,2137,530,3633,123,52,71
5700,4418,778,2142,531,3640,123,52,71
5705,4421,778,2143,531,3643,123,52,71
5710,4426,778,2144,531,3648,124,52,72
5715,4430,778,2144,531,3652,124,52,72
5720,4433,778,2145,531,3655,124,52,72
5725,4434,778,2146,531,3656,124,52,72
5730,4439,779,2148,531,3660,124,52,72
5735,4441,779,2149,531,3662,124,52,72
5740,4449,780,2154,532,3668,124,52,72
5745,4452,781,2157,533,3671,124,52,72
5750,4457,783,2160,535,3674,125,53,72
5755,4461,784,2162,536,3676,125,53,72
5760,4464,785,2164,537,3678,125,53,72
5765,4465,785,2164,537,3680,125,53,72
5770,4470,785,2166,537,3685,125,53,72
5775,4472,786,2166,537,3686,125,53,72
5780,4480,786,2170,537,3694,125,53,72
5785,4483,786,2170,537,3697,125,53,72
5790,4488,787,2173,537,3701,125,53,72
5795,4492,787,2177,537,3705,125,53,72
5800,4495,787,2178,537,3708,125,53,72
5805,4496,787,2179,537,3709,125,53,72
5810,4501,787,2181,537,3714,125,53,72
5815,4503,788,2182,537,3715,125,53,72
5820,4511,788,2188,537,3723,125,53,72
5825,4514,788,2189,537,3726,125,53,72
5830,4519,789,2191,538,3730,125,53,72
5835,4523,789,2194,538,3734,125,53,72
5840,4526,789,2196,538,3737,125,53,72
5845,4527,789,2196,538,3738,125,53,72
5850,4532,789,2198,538,3743,125,53,72
5855,4534,790,2199,539,3744,125,53,72
5860,4542,790,2203,539,3752,125,53,72
5865,4545,790,2204,539,3755,125,53,72
5870,4550,791,2207,540,3759,126,54,72
5875,4554,792,2211,541,3759,126,54,72
5880,4557,796,2213,545,3760,126,54,72
5885,4558,796,2214,545,3762,126,54,72
5890,4563,796,2216,545,3767,126,54,72
5895,4565,797,2217,545,3768,126,54,72
5900,4573,797,2222,545,3776,126,54,72
5905,4576,797,2223,545,3779,126,54,72
5910,4581,798,2225,546,3783,127,54,73
5915,4585,798,2227,546,3787,127,54,73
5920,4588,798,2228,546,3790,127,54,73
5925,4589,798,2229,546,3791,127,54,73
5930,4594,798,2230,546,3796,127,54,73
5935,4596,799,2231,546,3797,127,54,73
5940,4604,799,2235,546,3805,127,54,73
5945,4607,799,2236,546,3808,127,54,73
5950,4612,800,2238,547,3812,128,54,74
5955,4616,800,2238,547,3816,128,54,74
5960,4619,801,2241,548,3818,128,54,74
5965,4620,801,2242,548,3819,128,54,74
5970,4625,801,2243,548,3824,128,54,74
5975,4627,802,2244,548,3824,128,54,74
5980,4635,802,2249,548,3833,128,54,74
5985,4638,802,2249,548,3836,128,54,74
5990,4643,804,2254,550,3839,129,55,74
5995,4647,804,2255,550,3843,129,55,74
6000,4650,805,2257,551,3845,129,55,74
6005,4651,805,2257,551,3846,129,55,74
6010,4656,806,2260,551,3850,129,55,74
6015,4658,806,2261,551,3852,129,55,74
6020,4666,806,2263,551,3860,129,55,74
6025,4669,806,2264,551,3863,129,55,74
6030,4674,807,2266,552,3867,129,55,74
6035,4678,807,2268,552,3871,129,55,74
6040,4681,807,2269,552,3874,129,55,74
6045,4682,807,2269,552,3875,129,55,74
6050,4687,808,2272,553,3879,129,55,74
6055,4689,808,2274,553,3881,129,55,74
6060,4697,808,2278,553,3888,129,55,74
6065,4700,809,2280,554,3891,129,55,74
6070,4705,810,2280,554,3895,129,55,74
6075,4709,810,2282,554,3898,129,55,74
6080,4712,811,2285,555,3901,129,55,74
6085,4713,811,2285,555,3902,129,55,74
6090,4718,814,2288,557,3904,129,55,74
6095,4720,814,2289,557,3906,129,55,74
6100,4728,814,2295,557,3913,130,55,75
6105,4731,815,2296,558,3916,130,55,75
6110,4736,816,2297,558,3920,130,55,75
6115,4740,817,2300,559,3922,130,55,75
6120,4743,820,2302,562,3923,130,55,75
6125,4744,820,2303,562,3924,130,55,75
6130,4749,820,2305,562,3929,130,55,75
6135,4751,821,2307,563,3930,130,55,75
6140,4759,823,2309,564,3935,130,55,75
6145,4762,824,2310,565,3938,130,55,75
6150,4767,825,2312,566,3942,131,55,76
6155,4771,825,2313,566,3946,131,55,76
6160,4774,826,2315,567,3948,131,55,76
6165,4775,826,2315,567,3949,131,55,76
6170,4780,826,2320,567,3953,131,55,76
6175,4782,828,2321,569,3954,131,55,76
6180,4790,830,2325,570,3959,131,55,76
6185,4793,831,2326,571,3962,131,55,76
6190,4798,832,2328,571,3966,132,55,77
6195,4802,832,2329,571,3970,132,55,77
6200,4805,832,2329,571,3973,132,55,77
6205,4806,832,2330,571,3974,132,55,77
6210,4811,832,2334,571,3978,132,55,77
6215,4813,834,2336,573,3979,132,55,77
6220,4821,834,2339,573,3987,132,55,77
6225,4824,834,2339,573,3990,132,55,77
6230,4829,835,2342,574,3994,133,56,77
6235,4833,835,2345,574,3997,133,56,77
6240,4836,837,2346,576,3999,133,56,77
6245,4837,837,2347,576,4000,133,56,77
6250,4842,838,2350,576,4003,133,56,77
6255,4844,840,2350,577,4004,133,56,77
6260,4852,840,2355,577,4012,133,56,77
6265,4855,840,2356,577,4015,133,56,77
6270,4860,840,2357,577,4020,133,56,77
6275,4864,840,2360,577,4024,133,56,77
6280,4867,840,2361,577,4027,133,56,77
6285,4868,840,2361,577,4028,133,56,77
6290,4873,841,2362,577,4032,133,56,77
6295,4875,842,2362,577,4033,133,56,77
6300,4883,842,2364,577,4041,133,56,77
6305,4886,842,2367,577,4044,133,56,77
6310,4891,842,2371,577,4049,134,57,77
6315,4895,842,2372,577,4052,134,57,77
6320,4898,844,2373,579,4054,134,57,77
6325,4899,844,2374,579,4055,134,57,77
6330,4904,845,2377,580,4058,134,57,77
6335,4906,846,2377,581,4060,134,57,77
6340,4914,846,2382,581,4068,134,57,77
6345,4917,846,2384,581,4071,134,57,77
6350,4922,848,2387,583,4074,135,57,78
6355,4926,848,2389,583,4077,135,57,78
6360,4929,850,2390,585,4079,135,57,78
6365,4930,850,2391,585,4080,135,57,78
6370,4935,850,2395,585,4085,135,57,78
6375,4937,850,2397,585,4087,135,57,78
6380,4945,853,2402,588,4091,136,57,79
6385,4948,854,2402,589,4094,136,57,79
6390,4953,855,2403,589,4098,137,58,79
6395,4957,855,2404,589,4102,137,58,79
6400,4960,855,2404,589,4105,137,58,79
6405,4961,855,2405,589,4106,137,58,79
6410,4966,855,2408,589,4110,137,58,79
6415,4968,857,2409,590,4111,137,58,79
6420,4976,860,2412,592,4116,138,58,80
6425,4979,860,2412,592,4119,138,58,80
6430,4984,861,2415,592,4123,139,59,80
6435,4988,861,2417,592,4126,139,59,80
6440,4991,862,2419,593,4129,139,59,80
6445,4992,863,2420,594,4129,139,59,80
6450,4997,866,2423,596,4131,139,59,80
6455,4999,867,2425,597,4131,139,59,80
6460,5007,869,2429,599,4138,140,59,81
6465,5010,870,2432,600,4139,140,59,81
6470,5015,872,2435,602,4143,141,60,81
6475,5019,873,2438,603,4145,141,60,81
6480,5022,876,2440,606,4146,141,60,81
6485,5023,876,2440,606,4147,141,60,81
6490,5028,876,2442,606,4152,141,60,81
6495,5030,876,2443,606,4154,141,60,81
6500,5038,876,2448,606,4162,141,60,81
6505,5041,876,2449,606,4165,141,60,81
6510,5046,877,2450,606,4169,141,60,81
6515,5050,877,2452,606,4173,141,60,81
6520,5053,877,2454,606,4176,141,60,81
6525,5054,877,2455,606,4177,141,60,81
6530,5059,877,2459,606,4181,141,60,81
6535,5061,878,2459,607,4183,141,60,81
6540,5069,879,2463,608,4189,142,60,82
6545,5072,880,2465,609,4192,142,60,82
6550,5077,881,2468,610,4196,142,60,82
6555,5081,881,2469,610,4200,142,60,82
6560,5084,881,2470,610,4203,142,60,82
6565,5085,882,2471,611,4203,142,60,82
6570,5090,883,2473,611,4207,142,60,82
6575,5092,884,2473,611,4208,142,60,82
6580,5100,885,2476,611,4215,143,61,82
6585,5103,885,2478,611,4218,143,61,82
6590,5108,887,2481,613,4221,143,61,82
6595,5112,887,2483,613,4224,143,61,82
6600,5115,888,2484,614,4227,143,61,82
6605,5116,888,2485,614,4228,143,61,82
6610,5121,888,2488,614,4232,143,61,82
6615,5123,890,2489,616,4233,143,61,82
6620,5131,891,2492,616,4240,143,61,82
6625,5134,891,2494,616,4243,143,61,82
6630,5139,891,2497,616,4248,143,61,82
6635,5143,891,2500,616,4252,143,61,82
6640,5146,891,2502,616,4255,143,61,82
6645,5147,891,2502,616,4256,143,61,82
6650,5152,891,2505,616,4261,143,61,82
6655,5154,892,2506,616,4262,143,61,82
6660,5162,893,2509,616,4268,143,61,82
6665,5165,894,2512,617,4271,143,61,82
6670,5170,894,2514,617,4276,143,61,82
6675,5174,894,2518,617,4280,143,61,82
6680,5177,894,2521,617,4283,143,61,82
6685,5178,894,2521,617,4284,143,61,82
6690,5183,894,2524,617,4289,143,61,82
6695,5185,894,2525,617,4291,143,61,82
6700,5193,895,2528,617,4298,143,61,82
6705,5196,895,2530,617,4301,143,61,82
6710,5201,895,2534,617,4306,143,61,82
6715,5205,895,2534,617,4310,143,61,82
6720,5208,895,2535,617,4313,143,61,82
6725,5209,896,2536,618,4313,143,61,82
6730,5214,898,2539,620,4316,143,61,82
6735,5216,898,2540,620,4317,143,61,82
6740,5224,901,2543,622,4323,144,61,83
6745,5227,901,2544,622,4325,144,61,83
6750,5232,902,2545,623,4330,145,61,84
6755,5236,903,2548,624,4333,145,61,84
6760,5239,903,2549,624,4336,145,61,84
6765,5240,903,2549,624,4337,145,61,84
6770,5245,905,2551,625,4339,145,61,84
6775,5247,907,2553,627,4339,145,61,84
6780,5255,910,2558,629,4342,146,62,84
6785,5258,912,2559,631,4346,146,62,84
6790,5263,913,2562,632,4350,146,62,84
6795,5267,913,2565,632,4354,146,62,84
6800,5270,914,2566,633,4356,146,62,84
6805,5271,914,2567,633,4357,146,62,84
6810,5276,914,2570,633,4361,146,62,84
6815,5278,916,2572,635,4362,146,62,84
6820,5286,917,2573,635,4369,146,62,84
6825,5289,917,2575,635,4372,146,62,84
6830,5294,918,2578,636,4376,146,62,84
6835,5298,918,2580,636,4380,146,62,84
6840,5301,919,2582,637,4382,146,62,84
6845,5302,919,2583,637,4383,146,62,84
6850,5307,919,2584,637,4388,146,62,84
6855,5309,919,2585,637,4390,146,62,84
6860,5317,920,2589,638,4397,146,62,84
6865,5320,921,2590,639,4399,146,62,84
6870,5325,923,2594,641,4402,146,62,84
6875,5329,923,2596,641,4406,146,62,84
6880,5332,923,2599,641,4409,146,62,84
6885,5333,923,2599,641,4410,146,62,84
6890,5338,924,2602,642,4414,146,62,84
6895,5340,924,2603,642,4415,146,62,84
6900,5348,925,2606,643,4421,147,62,85
6905,5351,927,2607,645,4424,147,62,85
6910,5356,928,2609,645,4428,147,62,85
6915,5360,928,2611,645,4432,147,62,85
6920,5363,928,2612,645,4435,147,62,85
6925,5364,928,2612,645,4436,147,62,85
6930,5369,929,2614,646,4440,147,62,85
6935,5371,929,2614,646,4442,147,62,85
6940,5379,929,2616,646,4450,147,62,85
6945,5382,929,2618,646,4453,147,62,85
6950,5387,930,2619,646,4457,147,62,85
6955,5391,930,2621,646,4461,147,62,85
6960,5394,930,2623,646,4464,147,62,85
6965,5395,930,2623,646,4465,147,62,85
6970,5400,931,2625,646,4469,147,62,85
6975,5402,932,2626,646,4470,147,62,85
6980,5410,933,2629,647,4477,147,62,85
6985,5413,933,2629,647,4480,147,62,85
6990,5418,935,2633,649,4483,147,62,85
6995,5422,935,2635,649,4487,147,62,85
7000,5425,936,2637,650,4489,147,62,85
7005,5426,936,2638,650,4490,147,62,85
7010,5431,937,2640,651,4494,147,62,85
7015,5433,938,2640,651,4495,147,62,85
7020,5441,939,2644,651,4501,148,63,85
7025,5444,940,2647,652,4504,148,63,85
7030,5449,941,2650,653,4508,149,64,85
7035,5453,941,2650,653,4512,149,64,85
7040,5456,942,2651,654,4514,149,64,85
7045,5457,942,2652,654,4515,149,64,85
7050,5462,942,2654,654,4520,149,64,85
7055,5464,943,2654,654,4521,149,64,85
7060,5472,944,2657,655,4528,149,64,85
7065,5475,944,2657,655,4531,149,64,85
7070,5480,945,2660,655,4535,150,65,85
7075,5484,945,2662,655,4538,150,65,85
7080,5487,947,2664,657,4540,150,65,85
7085,5488,947,2664,657,4541,150,65,85
7090,5493,948,2667,658,4545,150,65,85
7095,5495,949,2668,658,4546,150,65,85
7100,5503,951,2672,659,4551,151,66,85
7105,5506,952,2673,660,4554,151,66,85
7110,5511,953,2675,660,4558,152,66,86
7115,5515,953,2676,660,4562,152,66,86
7120,5518,953,2676,660,4565,152,66,86
7125,5519,954,2677,661,4565,152,66,86
7130,5524,955,2680,661,4567,152,66,86
7135,5526,958,2681,663,4567,152,66,86
7140,5534,960,2683,664,4572,153,66,87
7145,5537,962,2686,666,4575,153,66,87
7150,5542,963,2689,667,4579,153,66,87
7155,5546,963,2691,667,4583,153,66,87
7160,5549,963,2691,667,4586,153,66,87
7165,5550,963,2692,667,4587,153,66,87
7170,5555,963,2693,667,4591,153,66,87
7175,5557,965,2695,669,4592,153,66,87
7180,5565,965,2697,669,4600,153,66,87
7185,5568,966,2699,670,4602,153,66,87
7190,5573,967,2702,671,4606,153,66,87
7195,5577,967,2706,671,4609,153,66,87
7200,5580,968,2708,672,4612,153,66,87
7205,5581,968,2708,672,4613,153,66,87
7210,5586,969,2709,673,4617,153,66,87
7215,5588,969,2709,673,4619,153,66,87
7220,5596,970,2711,674,4626,154,67,87
7225,5599,971,2714,675,4628,154,67,87
7230,5604,971,2716,675,4633,154,67,87
7235,5608,971,2717,675,4637,154,67,87
7240,5611,971,2718,675,4640,154,67,87
7245,5612,971,2718,675,4641,154,67,87
7250,5617,972,2722,676,4643,154,67,87
7255,5619,974,2723,678,4645,154,67,87
7260,5627,977,2729,680,4647,155,68,87
7265,5630,979,2731,682,4651,155,68,87
7270,5635,979,2733,682,4656,155,68,87
7275,5639,979,2734,682,4660,155,68,87
7280,5642,979,2734,682,4663,155,68,87
7285,5643,979,2734,682,4664,155,68,87
7290,5648,979,2736,682,4669,155,68,87
7295,5650,979,2737,682,4671,155,68,87
7300,5658,979,2741,682,4679,155,68,87
7305,5661,979,2742,682,4682,155,68,87
7310,5666,980,2745,683,4686,155,68,87
7315,5670,980,2746,683,4690,155,68,87
7320,5673,981,2748,684,4692,155,68,87
7325,5674,981,2749,684,4693,155,68,87
7330,5679,981,2751,684,4698,155,68,87
7335,5681,982,2751,684,4699,155,68,87
7340,5689,984,2756,685,4704,155,68,87
7345,5692,985,2756,686,4707,155,68,87
7350,5697,986,2757,686,4711,155,68,87
7355,5701,986,2759,686,4714,155,68,87
7360,5704,987,2760,687,4717,155,68,87
7365,5705,987,2760,687,4718,155,68,87
7370,5710,988,2762,687,4720,155,68,87
7375,5712,989,2764,688,4722,155,68,87
7380,5720,993,2768,691,4725,156,68,88
7385,5723,993,2768,691,4730,156,68,88
7390,5728,993,2770,691,4735,156,68,88
7395,5732,993,2774,691,4739,156,68,88
7400,5735,993,2774,691,4742,156,68,88
7405,5736,993,2775,691,4743,156,68,88
7410,5741,993,2777,691,4747,156,68,88
7415,5743,995,2778,692,4748,156,68,88
7420,5751,995,2781,692,4756,156,68,88
7425,5754,995,2782,692,4759,156,68,88
7430,5759,995,2783,692,4764,156,68,88
7435,5763,995,2786,692,4768,156,68,88
7440,5766,995,2787,692,4771,156,68,88
7445,5767,995,2788,692,4772,156,68,88
7450,5772,995,2792,692,4776,156,68,88
7455,5774,997,2792,693,4777,156,68,88
7460,5782,997,2796,693,4785,156,68,88
7465,5785,998,2799,694,4787,156,68,88
7470,5790,998,2801,694,4792,156,68,88
7475,5794,998,2802,694,4796,156,68,88
7480,5797,998,2803,694,4799,156,68,88
7485,5798,998,2803,694,4800,156,68,88
7490,5803,999,2808,695,4803,156,68,88
7495,5805,1001,2808,696,4804,156,68,88
7500,5813,1004,2812,699,4808,157,68,89
7505,5816,1005,2814,700,4811,157,68,89
7510,5821,1006,2816,700,4815,157,68,89
7515,5825,1007,2819,701,4818,157,68,89
7520,5828,1008,2821,702,4820,157,68,89
7525,5829,1009,2822,703,4820,157,68,89
7530,5834,1010,2823,703,4824,157,68,89
7535,5836,1011,2824,704,4825,157,68,89
7540,5844,1012,2829,705,4832,158,69,89
7545,5847,1012,2831,705,4835,158,69,89
7550,5852,1013,2833,705,4839,158,69,89
7555,5856,1013,2836,705,4843,158,69,89
7560,5859,1013,2837,705,4846,158,69,89
7565,5860,1014,2838,706,4846,158,69,89
7570,5865,1015,2840,706,4849,158,69,89
7575,5867,1017,2842,708,4850,158,69,89
7580,5875,1018,2850,709,4857,159,70,89
7585,5878,1018,2851,709,4860,159,70,89
7590,5883,1019,2854,709,4864,159,70,89
7595,5887,1019,2856,709,4868,159,70,89
7600,5890,1019,2858,709,4871,159,70,89
7605,5891,1019,2858,709,4872,159,70,89
7610,5896,1020,2860,709,4876,159,70,89
7615,5898,1021,2860,709,4877,159,70,89
7620,5906,1023,2864,711,4881,160,70,90
7625,5909,1024,2867,712,4885,160,70,90
7630,5914,1025,2870,712,4889,160,70,90
7635,5918,1025,2870,712,4893,160,70,90
7640,5921,1025,2870,712,4896,160,70,90
7645,5922,1025,2870,712,4897,160,70,90
7650,5927,1026,2874,713,4901,160,70,90
7655,5929,1026,2874,713,4903,160,70,90
7660,5937,1026,2879,713,4911,160,70,90
7665,5940,1026,2879,713,4914,160,70,90
7670,5945,1027,2882,714,4918,160,70,90
7675,5949,1027,2885,714,4921,160,70,90
7680,5952,1028,2886,715,4924,160,70,90
7685,5953,1028,2886,715,4925,160,70,90
7690,5958,1029,2888,715,4929,160,70,90
7695,5960,1029,2890,715,4931,160,70,90
7700,5968,1029,2897,715,4939,160,70,90
7705,5971,1029,2897,715,4942,160,70,90
7710,5976,1030,2901,716,4946,160,70,90
7715,5980,1030,2901,716,4950,160,70,90
7720,5983,1030,2904,716,4953,160,70,90
7725,5984,1031,2905,717,4953,160,70,90
7730,5989,1033,2909,719,4954,160,70,90
7735,5991,1036,2910,721,4954,160,70,90
7740,5999,1040,2916,725,4957,161,71,90
7745,6002,1041,2917,726,4961,161,71,90
7750,6007,1042,2918,726,4965,162,72,90
7755,6011,1042,2920,726,4969,162,72,90
7760,6014,1042,2922,726,4972,162,72,90
7765,6015,1042,2923,726,4973,162,72,90
7770,6020,1042,2925,726,4977,162,72,90
7775,6022,1044,2926,727,4978,162,72,90
7780,6030,1045,2928,727,4985,162,72,90
7785,6033,1045,2930,727,4988,162,72,90
7790,6038,1046,2932,727,4992,163,73,90
7795,6042,1046,2933,727,4996,163,73,90
7800,6045,1047,2934,728,4998,163,73,90
7805,6046,1047,2935,728,4999,163,73,90
7810,6051,1047,2937,728,5003,163,73,90
7815,6053,1049,2939,730,5004,163,73,90
7820,6061,1050,2944,730,5011,163,73,90
7825,6064,1050,2944,730,5014,163,73,90
7830,6069,1051,2946,731,5018,164,73,91
7835,6073,1051,2949,731,5022,164,73,91
7840,6076,1051,2951,731,5025,164,73,91
7845,6077,1051,2952,731,5026,164,73,91
7850,6082,1052,2953,731,5030,164,73,91
7855,6084,1053,2953,731,5031,164,73,91
7860,6092,1054,2955,731,5037,165,74,91
7865,6095,1054,2957,731,5041,165,74,91
7870,6100,1055,2957,731,5045,165,74,91
7875,6104,1056,2959,732,5048,165,74,91
7880,6107,1056,2961,732,5051,165,74,91
7885,6108,1056,2961,732,5052,165,74,91
7890,6113,1057,2964,732,5056,165,74,91
7895,6115,1057,2965,732,5058,165,74,91
7900,6123,1058,2968,732,5065,165,74,91
7905,6126,1058,2970,732,5068,165,74,91
7910,6131,1059,2972,733,5072,165,74,91
7915,6135,1060,2976,734,5074,165,74,91
7920,6138,1062,2979,736,5076,165,74,91
7925,6139,1062,2979,736,5077,165,74,91
7930,6144,1063,2984,737,5081,165,74,91
7935,6146,1063,2985,737,5083,165,74,91
7940,6154,1064,2988,738,5090,165,74,91
7945,6157,1064,2989,738,5093,165,74,91
7950,6162,1066,2993,740,5096,165,74,91
7955,6166,1066,2995,740,5100,165,74,91
7960,6169,1066,2997,740,5103,165,74,91
7965,6170,1066,2997,740,5104,165,74,91
7970,6175,1068,2999,741,5107,165,74,91
7975,6177,1069,3001,742,5107,165,74,91
7980,6185,1071,3004,744,5113,166,75,91
7985,6188,1072,3004,745,5116,166,75,91
7990,6193,1073,3008,746,5120,166,75,91
7995,6197,1074,3011,747,5123,166,75,91
8000,6200,1075,3014,748,5125,166,75,91
8005,6201,1075,3014,748,5126,166,75,91
8010,6206,1076,3015,748,5130,166,75,91
8015,6208,1077,3017,749,5131,166,75,91
8020,6216,1077,3021,749,5138,167,76,91
8025,6219,1078,3023,750,5141,167,76,91
8030,6224,1079,3027,751,5145,167,76,91
8035,6228,1079,3028,751,5149,167,76,91
8040,6231,1080,3029,752,5151,167,76,91
8045,6232,1080,3029,752,5152,167,76,91
8050,6237,1081,3029,752,5156,167,76,91
8055,6239,1082,3031,753,5157,167,76,91
8060,6247,1084,3037,755,5163,167,76,91
8065,6250,1084,3038,755,5166,167,76,91
8070,6255,1085,3039,756,5170,167,76,91
8075,6259,1085,3040,756,5174,167,76,91
8080,6262,1085,3041,756,5177,167,76,91
8085,6263,1085,3042,756,5178,167,76,91
8090,6268,1088,3046,759,5180,167,76,91
8095,6270,1089,3046,759,5181,167,76,91
8100,6278,1090,3051,760,5187,168,77,91
8105,6281,1090,3053,760,5191,168,77,91
8110,6286,1091,3053,760,5195,168,77,91
8115,6290,1091,3054,760,5198,168,77,91
8120,6293,1092,3056,761,5201,168,77,91
8125,6294,1092,3057,761,5202,168,77,91
8130,6299,1092,3059,761,5207,168,77,91
8135,6301,1092,3060,761,5209,168,77,91
8140,6309,1093,3066,761,5216,168,77,91
8145,6312,1093,3068,761,5219,168,77,91
8150,6317,1094,3071,762,5223,168,77,91
8155,6321,1094,3074,762,5226,168,77,91
8160,6324,1095,3076,763,5229,168,77,91
8165,6325,1095,3076,763,5230,168,77,91
8170,6330,1096,3080,764,5234,168,77,91
8175,6332,1096,3080,764,5236,168,77,91
8180,6340,1097,3083,765,5243,169,77,92
8185,6343,1097,3085,765,5246,169,77,92
8190,6348,1098,3086,766,5250,169,77,92
8195,6352,1098,3089,766,5254,169,77,92
8200,6355,1098,3092,766,5257,169,77,92
8205,6356,1099,3093,767,5257,169,77,92
8210,6361,1102,3097,770,5259,169,77,92
8215,6363,1103,3099,771,5260,169,77,92
8220,6371,1104,3102,772,5265,170,77,93
8225,6374,1105,3103,773,5269,170,77,93
8230,6379,1106,3106,773,5273,170,77,93
8235,6383,1106,3107,773,5277,170,77,93
8240,6386,1106,3108,773,5280,170,77,93
8245,6387,1106,3108,773,5281,170,77,93
8250,6392,1106,3112,773,5286,170,77,93
8255,6394,1106,3114,773,5288,170,77,93
8260,6402,1106,3117,773,5296,170,77,93
8265,6405,1106,3119,773,5299,170,77,93
8270,6410,1107,3120,773,5303,170,77,93
8275,6414,1107,3122,773,5307,170,77,93
8280,6417,1107,3123,773,5310,170,77,93
8285,6418,1107,3124,773,5311,170,77,93
8290,6423,1109,3127,774,5314,170,77,93
8295,6425,1109,3128,774,5316,170,77,93
8300,6433,1111,3130,775,5322,171,77,94
8305,6436,1112,3132,776,5324,171,77,94
8310,6441,1113,3134,777,5328,171,77,94
8315,6445,1113,3136,777,5331,171,77,94
8320,6448,1114,3137,778,5334,171,77,94
8325,6449,1114,3137,778,5335,171,77,94
8330,6454,1116,3139,779,5337,171,77,94
8335,6456,1118,3139,780,5338,171,77,94
8340,6464,1119,3141,780,5344,172,78,94
8345,6467,1120,3142,781,5347,172,78,94
8350,6472,1121,3146,782,5351,173,78,95
8355,6476,1122,3147,783,5354,173,78,95
8360,6479,1123,3149,784,5356,173,78,95
8365,6480,1123,3149,784,5357,173,78,95
8370,6485,1123,3151,784,5362,173,78,95
8375,6487,1124,3151,784,5363,173,78,95
8380,6495,1124,3155,784,5371,173,78,95
8385,6498,1124,3158,784,5374,173,78,95
8390,6503,1125,3162,785,5378,174,79,95
8395,6507,1126,3165,786,5381,174,79,95
8400,6510,1126,3167,786,5384,174,79,95
8405,6511,1126,3167,786,5385,174,79,95
8410,6516,1126,3169,786,5390,174,79,95
8415,6518,1126,3170,786,5392,174,79,95
8420,6526,1127,3175,787,5399,174,79,95
8425,6529,1127,3176,787,5402,174,79,95
8430,6534,1128,3176,787,5406,174,79,95
8435,6538,1128,3178,787,5410,174,79,95
8440,6541,1128,3180,787,5413,174,79,95
8445,6542,1128,3180,787,5414,174,79,95
8450,6547,1129,3182,787,5418,174,79,95
8455,6549,1129,3182,787,5420,174,79,95
8460,6557,1132,3187,789,5425,175,80,95
8465,6560,1132,3189,789,5428,175,80,95
8470,6565,1133,3190,789,5432,175,80,95
8475,6569,1133,3191,789,5436,175,80,95
8480,6572,1133,3192,789,5439,175,80,95
8485,6573,1133,3193,789,5440,175,80,95
8490,6578,1133,3196,789,5445,175,80,95
8495,6580,1133,3198,789,5447,175,80,95
8500,6588,1134,3202,790,5454,175,80,95
8505,6591,1134,3203,790,5457,175,80,95
8510,6596,1136,3206,792,5460,176,81,95
8515,6600,1136,3207,792,5464,176,81,95
8520,6603,1136,3208,792,5467,176,81,95
8525,6604,1136,3208,792,5468,176,81,95
8530,6609,1136,3210,792,5473,176,81,95
8535,6611,1136,3211,792,5475,176,81,95
8540,6619,1137,3216,792,5482,176,81,95
8545,6622,1138,3219,793,5484,176,81,95
8550,6627,1139,3219,793,5488,177,81,96
8555,6631,1139,3220,793,5491,177,81,96
8560,6634,1140,3221,794,5494,177,81,96
8565,6635,1140,3222,794,5495,177,81,96
8570,6640,1141,3225,794,5499,177,81,96
8575,6642,1141,3226,794,5501,177,81,96
8580,6650,1142,3228,794,5508,177,81,96
8585,6653,1142,3229,794,5511,177,81,96
8590,6658,1143,3231,795,5515,178,81,97
8595,6662,1143,3232,795,5519,178,81,97
8600,6665,1144,3235,796,5521,178,81,97
8605,6666,1144,3235,796,5522,178,81,97
8610,6671,1145,3236,796,5526,178,81,97
8615,6673,1145,3236,796,5528,178,81,97
8620,6681,1146,3239,797,5535,178,81,97
8625,6684,1147,3241,798,5537,178,81,97
8630,6689,1149,3245,800,5540,179,82,97
8635,6693,1150,3248,801,5542,179,82,97
8640,6696,1152,3250,803,5544,179,82,97
8645,6697,1152,3250,803,5545,179,82,97
8650,6702,1153,3252,804,5549,179,82,97
8655,6704,1154,3254,805,5550,179,82,97
8660,6712,1156,3256,806,5556,179,82,97
8665,6715,1156,3257,806,5559,179,82,97
8670,6720,1156,3260,806,5564,179,82,97
8675,6724,1156,3260,806,5568,179,82,97
8680,6727,1156,3261,806,5571,179,82,97
8685,6728,1156,3262,806,5572,179,82,97
8690,6733,1157,3265,806,5575,179,82,97
8695,6735,1159,3265,807,5576,179,82,97
8700,6743,1162,3270,809,5580,179,82,97
8705,6746,1163,3271,810,5583,179,82,97
8710,6751,1163,3274,810,5588,179,82,97
8715,6755,1163,3277,810,5591,179,82,97
8720,6758,1164,3279,811,5594,179,82,97
8725,6759,1164,3279,811,5595,179,82,97
8730,6764,1165,3282,812,5598,179,82,97
8735,6766,1167,3282,813,5599,179,82,97
8740,6774,1167,3285,813,5607,179,82,97
8745,6777,1167,3287,813,5610,179,82,97
8750,6782,1167,3290,813,5615,179,82,97
8755,6786,1168,3293,814,5616,179,82,97
8760,6789,1170,3296,816,5619,179,82,97
8765,6790,1170,3297,816,5620,179,82,97
8770,6795,1170,3300,816,5624,179,82,97
8775,6797,1172,3301,818,5625,179,82,97
8780,6805,1172,3305,818,5633,179,82,97
8785,6808,1172,3305,818,5636,179,82,97
8790,6813,1173,3308,819,5640,179,82,97
8795,6817,1173,3310,819,5644,179,82,97
8800,6820,1173,3312,819,5647,179,82,97
8805,6821,1173,3312,819,5648,179,82,97
8810,6826,1173,3315,819,5652,179,82,97
8815,6828,1175,3317,821,5653,179,82,97
8820,6836,1175,3322,821,5661,179,82,97
8825,6839,1175,3323,821,5664,179,82,97
8830,6844,1176,3325,821,5668,179,82,97
8835,6848,1176,3326,821,5672,179,82,97
8840,6851,1176,3329,821,5675,179,82,97
8845,6852,1176,3330,821,5676,179,82,97
8850,6857,1176,3332,821,5680,179,82,97
8855,6859,1178,3332,822,5681,179,82,97
8860,6867,1178,3338,822,5689,179,82,97
8865,6870,1178,3339,822,5692,179,82,97
8870,6875,1180,3341,823,5695,180,82,98
8875,6879,1180,3343,823,5698,180,82,98
8880,6882,1181,3343,824,5701,180,82,98
8885,6883,1181,3343,824,5702,180,82,98
8890,6888,1182,3346,824,5706,180,82,98
8895,6890,1182,3346,824,5708,180,82,98
8900,6898,1183,3350,825,5715,180,82,98
8905,6901,1183,3352,825,5718,180,82,98
8910,6906,1184,3353,825,5722,180,82,98
8915,6910,1184,3355,825,5724,180,82,98
8920,6913,1185,3357,826,5728,180,82,98
8925,6914,1185,3357,826,5729,180,82,98
8930,6919,1186,3358,826,5733,180,82,98
8935,6921,1186,3358,826,5735,180,82,98
8940,6929,1187,3363,827,5742,180,82,98
8945,6932,1187,3366,827,5745,180,82,98
8950,6937,1188,3369,827,5749,180,82,98
8955,6941,1188,3370,827,5752,180,82,98
8960,6944,1189,3372,828,5755,180,82,98
8965,6945,1189,3372,828,5756,180,82,98
8970,6950,1190,3373,828,5760,180,82,98
8975,6952,1190,3375,828,5762,180,82,98
8980,6960,1191,3378,828,5769,180,82,98
8985,6963,1191,3379,828,5772,180,82,98
8990,6968,1192,3382,829,5776,180,82,98
8995,6972,1192,3384,829,5779,180,82,98
9000,6975,1193,3384,830,5782,180,82,98
9005,6976,1194,3385,831,5782,180,82,98
9010,6981,1195,3389,832,5785,180,82,98
9015,6983,1197,3389,833,5786,180,82,98
9020,6991,1198,3393,834,5793,180,82,98
9025,6994,1198,3395,834,5796,180,82,98
9030,6999,1199,3399,835,5800,181,83,98
9035,7003,1199,3401,835,5804,181,83,98
9040,7006,1199,3401,835,5807,181,83,98
9045,7007,1200,3402,836,5807,181,83,98
9050,7012,1201,3403,836,5810,181,83,98
9055,7014,1203,3403,837,5811,181,83,98
9060,7022,1204,3409,837,5817,181,83,98
9065,7025,1204,3410,837,5821,181,83,98
9070,7030,1205,3414,838,5825,182,84,98
9075,7034,1205,3415,838,5829,182,84,98
9080,7037,1205,3416,838,5832,182,84,98
9085,7038,1206,3417,839,5832,182,84,98
9090,7043,1207,3419,839,5836,182,84,98
9095,7045,1208,3419,839,5837,182,84,98
9100,7053,1209,3422,839,5844,182,84,98
9105,7056,1209,3424,839,5847,182,84,98
9110,7061,1211,3425,840,5850,183,84,99
9115,7065,1211,3426,840,5854,183,84,99
9120,7068,1212,3427,841,5856,183,84,99
9125,7069,1212,3428,841,5857,183,84,99
9130,7074,1212,3430,841,5862,183,84,99
9135,7076,1212,3430,841,5864,183,84,99
9140,7084,1213,3432,842,5871,183,84,99
9145,7087,1213,3433,842,5874,183,84,99
9150,7092,1213,3436,842,5879,183,84,99
9155,7096,1213,3438,842,5883,183,84,99
9160,7099,1213,3440,842,5886,183,84,99
9165,7100,1213,3441,842,5887,183,84,99
9170,7105,1213,3444,842,5892,183,84,99
9175,7107,1213,3444,842,5894,183,84,99
9180,7115,1215,3449,843,5900,183,84,99
9185,7118,1215,3450,843,5903,183,84,99
9190,7123,1215,3453,843,5908,183,84,99
9195,7127,1215,3455,843,5912,183,84,99
9200,7130,1215,3456,843,5915,183,84,99
9205,7131,1215,3457,843,5916,183,84,99
9210,7136,1215,3460,843,5921,183,84,99
9215,7138,1215,3461,843,5923,183,84,99
9220,7146,1216,3464,844,5930,183,84,99
9225,7149,1216,3466,844,5933,183,84,99
9230,7154,1217,3468,844,5936,183,84,99
9235,7158,1218,3471,845,5938,183,84,99
9240,7161,1221,3472,848,5940,183,84,99
9245,7162,1221,3473,848,5941,183,84,99
9250,7167,1222,3477,849,5945,183,84,99
9255,7169,1223,3477,849,5946,183,84,99
9260,7177,1223,3480,849,5954,183,84,99
9265,7180,1223,3482,849,5957,183,84,99
9270,7185,1224,3486,850,5961,184,85,99
9275,7189,1224,3487,850,5965,184,85,99
9280,7192,1225,3489,851,5967,184,85,99
9285,7193,1225,3490,851,5968,184,85,99
9290,7198,1226,3495,852,5971,184,85,99
9295,7200,1228,3497,854,5972,184,85,99
9300,7208,1228,3499,854,5980,184,85,99
9305,7211,1228,3500,854,5983,184,85,99
9310,7216,1229,3501,854,5987,185,85,100
9315,7220,1229,3503,854,5991,185,85,100
9320,7223,1229,3504,854,5994,185,85,100
9325,7224,1229,3504,854,5995,185,85,100
9330,7229,1230,3507,854,5998,185,85,100
9335,7231,1232,3508,856,5999,185,85,100
9340,7239,1232,3511,856,6007,185,85,100
9345,7242,1233,3513,857,6009,185,85,100
9350,7247,1235,3517,859,6012,186,86,100
9355,7251,1235,3519,859,6015,186,86,100
9360,7254,1236,3520,860,6018,186,86,100
9365,7255,1236,3520,860,6019,186,86,100
9370,7260,1236,3522,860,6024,186,86,100
9375,7262,1236,3522,860,6026,186,86,100
9380,7270,1237,3527,861,6033,186,86,100
9385,7273,1237,3528,861,6036,186,86,100
9390,7278,1237,3532,861,6041,187,87,100
9395,7282,1237,3535,861,6045,187,87,100
9400,7285,1237,3537,861,6048,187,87,100
9405,7286,1237,3538,861,6049,187,87,100
9410,7291,1237,3542,861,6054,187,87,100
9415,7293,1237,3543,861,6056,187,87,100
9420,7301,1238,3546,861,6063,187,87,100
9425,7304,1238,3546,861,6066,187,87,100
9430,7309,1238,3549,861,6071,187,87,100
9435,7313,1238,3552,861,6075,187,87,100
9440,7316,1238,3553,861,6078,187,87,100
9445,7317,1238,3553,861,6079,187,87,100
9450,7322,1238,3558,861,6084,187,87,100
9455,7324,1238,3558,861,6086,187,87,100
9460,7332,1239,3561,861,6093,187,87,100
9465,7335,1239,3564,861,6096,187,87,100
9470,7340,1240,3566,861,6099,187,87,100
9475,7344,1241,3568,862,6102,187,87,100
9480,7347,1243,3571,864,6104,187,87,100
9485,7348,1244,3572,865,6104,187,87,100
9490,7353,1245,3576,866,6108,187,87,100
9495,7355,1246,3577,867,6109,187,87,100
9500,7363,1248,3584,869,6115,187,87,100
9505,7366,1248,3586,869,6118,187,87,100
9510,7371,1249,3589,869,6122,187,87,100
9515,7375,1249,3592,869,6126,187,87,100
9520,7378,1249,3594,869,6129,187,87,100
9525,7379,1250,3595,870,6129,187,87,100
9530,7384,1251,3600,871,6132,187,87,100
9535,7386,1253,3602,873,6133,187,87,100
9540,7394,1254,3605,873,6140,187,87,100
9545,7397,1254,3606,873,6143,187,87,100
9550,7402,1256,3608,874,6146,188,87,101
9555,7406,1256,3611,874,6150,188,87,101
9560,7409,1257,3612,875,6152,188,87,101
9565,7410,1257,3612,875,6153,188,87,101
9570,7415,1258,3614,875,6156,188,87,101
9575,7417,1260,3615,876,6157,188,87,101
9580,7425,1262,3621,878,6163,188,87,101
9585,7428,1262,3622,878,6166,188,87,101
9590,7433,1264,3627,880,6169,189,88,101
9595,7437,1264,3630,880,6173,189,88,101
9600,7440,1264,3632,880,6176,189,88,101
9605,7441,1264,3632,880,6177,189,88,101
9610,7446,1264,3635,880,6181,189,88,101
9615,7448,1266,3636,881,6182,189,88,101
9620,7456,1268,3640,882,6188,189,88,101
9625,7459,1268,3642,882,6191,189,88,101
9630,7464,1268,3644,882,6196,189,88,101
9635,7468,1268,3646,882,6200,189,88,101
9640,7471,1268,3648,882,6203,189,88,101
9645,7472,1268,3649,882,6204,189,88,101
9650,7477,1268,3654,882,6208,189,88,101
9655,7479,1270,3655,884,6209,189,88,101
9660,7487,1272,3660,886,6215,189,88,101
9665,7490,1273,3661,887,6217,189,88,101
9670,7495,1273,3664,887,6222,189,88,101
9675,7499,1273,3665,887,6226,189,88,101
9680,7502,1273,3665,887,6229,189,88,101
9685,7503,1273,3666,887,6230,189,88,101
9690,7508,1273,3667,887,6235,189,88,101
9695,7510,1274,3668,887,6236,189,88,101
9700,7518,1275,3672,887,6243,189,88,101
9705,7521,1276,3674,888,6245,189,88,101
9710,7526,1277,3675,888,6249,190,88,102
9715,7530,1278,3677,889,6251,190,88,102
9720,7533,1279,3678,890,6254,190,88,102
9725,7534,1279,3678,890,6255,190,88,102
9730,7539,1280,3679,890,6259,190,88,102
9735,7541,1280,3679,890,6261,190,88,102
9740,7549,1280,3681,890,6269,190,88,102
9745,7552,1280,3681,890,6272,190,88,102
9750,7557,1281,3681,890,6276,191,88,103
9755,7561,1281,3682,890,6280,191,88,103
9760,7564,1281,3685,890,6283,191,88,103
9765,7565,1281,3686,890,6284,191,88,103
9770,7570,1282,3689,891,6288,191,88,103
9775,7572,1282,3690,891,6290,191,88,103
9780,7580,1282,3692,891,6298,191,88,103
9785,7583,1282,3694,891,6301,191,88,103
9790,7588,1283,3695,891,6305,192,88,104
9795,7592,1283,3696,891,6309,192,88,104
9800,7595,1283,3698,891,6312,192,88,104
9805,7596,1283,3699,891,6313,192,88,104
9810,7601,1284,3703,892,6317,192,88,104
9815,7603,1284,3704,892,6319,192,88,104
9820,7611,1284,3708,892,6327,192,88,104
9825,7614,1284,3710,892,6330,192,88,104
9830,7619,1285,3712,892,6334,193,88,105
9835,7623,1286,3715,893,6336,193,88,105
9840,7626,1287,3715,894,6339,193,88,105
9845,7627,1288,3716,895,6339,193,88,105
9850,7632,1289,3716,895,6343,193,88,105
9855,7634,1290,3718,896,6344,193,88,105
9860,7642,1292,3723,898,6350,193,88,105
9865,7645,1292,3725,898,6353,193,88,105
9870,7650,1292,3726,898,6358,193,88,105
9875,7654,1292,3727,898,6362,193,88,105
9880,7657,1292,3728,898,6365,193,88,105
9885,7658,1293,3729,899,6365,193,88,105
9890,7663,1294,3732,900,6368,193,88,105
9895,7665,1296,3732,901,6369,193,88,105
9900,7673,1297,3736,901,6376,193,88,105
9905,7676,1297,3739,901,6379,193,88,105
9910,7681,1297,3743,901,6384,193,88,105
9915,7685,1297,3744,901,6388,193,88,105
9920,7688,1297,3747,901,6391,193,88,105
9925,7689,1298,3748,902,6391,193,88,105
9930,7694,1299,3751,903,6394,193,88,105
9935,7696,1301,3753,905,6395,193,88,105
9940,7704,1303,3760,907,6401,193,88,105
9945,7707,1303,3762,907,6404,193,88,105
9950,7712,1305,3765,908,6407,194,89,105
9955,7716,1305,3768,908,6410,194,89,105
9960,7719,1307,3770,910,6412,194,89,105
9965,7720,1307,3770,910,6413,194,89,105
9970,7725,1307,3772,910,6418,194,89,105
9975,7727,1307,3774,910,6420,194,89,105
9980,7735,1308,3778,911,6427,194,89,105
9985,7738,1308,3778,911,6430,194,89,105
9990,7743,1309,3780,911,6434,194,89,105
9995,7747,1309,3784,911,6438,194,89,105
10000,7750,1309,3784,911,6441,194,89,105
10005,7751,1309,3785,911,6442,194,89,105
10010,7756,1309,3787,911,6447,194,89,105
10015,7758,1309,3788,911,6449,194,89,105
10020,7766,1310,3793,912,6456,194,89,105
10025,7769,1310,3793,912,6459,194,89,105
10030,7774,1311,3794,912,6463,194,89,105
10035,7778,1311,3797,912,6467,194,89,105
10040,7781,1312,3798,913,6469,194,89,105
10045,7782,1312,3798,913,6470,194,89,105
10050,7787,1312,3798,913,6475,194,89,105
10055,7789,1312,3799,913,6477,194,89,105
10060,7797,1313,3802,914,6484,194,89,105
10065,7800,1313,3802,914,6487,194,89,105
10070,7805,1314,3803,914,6491,195,89,106
10075,7809,1315,3807,915,6493,195,89,106
10080,7812,1316,3808,916,6496,195,89,106
10085,7813,1316,3808,916,6497,195,89,106
10090,7818,1317,3811,917,6500,195,89,106
10095,7820,1319,3813,919,6501,195,89,106
10100,7828,1319,3818,919,6509,195,89,106
10105,7831,1319,3820,919,6512,195,89,106
10110,7836,1319,3822,919,6517,195,89,106
10115,7840,1319,3824,919,6520,195,89,106
10120,7843,1320,3825,920,6523,195,89,106
10125,7844,1320,3826,920,6524,195,89,106
10130,7849,1321,3830,920,6527,195,89,106
10135,7851,1323,3832,922,6528,195,89,106
10140,7859,1323,3837,922,6536,195,89,106
10145,7862,1323,3839,922,6539,195,89,106
10150,7867,1323,3841,922,6544,195,89,106
10155,7871,1323,3841,922,6548,195,89,106
10160,7874,1323,3842,922,6551,195,89,106
10165,7875,1323,3843,922,6552,195,89,106
10170,7880,1324,3844,922,6556,195,89,106
10175,7882,1325,3844,922,6557,195,89,106
10180,7890,1325,3849,922,6565,195,89,106
10185,7893,1325,3852,922,6568,195,89,106
10190,7898,1327,3855,924,6571,196,89,107
10195,7902,1328,3856,925,6574,196,89,107
10200,7905,1328,3858,925,6577,196,89,107
10205,7906,1329,3859,926,6577,196,89,107
10210,7911,1330,3863,927,6581,196,89,107
10215,7913,1330,3864,927,6583,196,89,107
10220,7921,1331,3866,927,6590,196,89,107
10225,7924,1331,3867,927,6593,196,89,107
10230,7929,1332,3870,927,6597,196,89,107
10235,7933,1332,3871,927,6601,196,89,107
10240,7936,1333,3872,928,6603,196,89,107
10245,7937,1334,3873,929,6603,196,89,107
10250,7942,1335,3877,930,6607,196,89,107
10255,7944,1335,3879,930,6609,196,89,107
10260,7952,1336,3881,930,6616,196,89,107
10265,7955,1336,3883,930,6619,196,89,107
10270,7960,1337,3884,930,6623,196,89,107
10275,7964,1337,3886,930,6626,196,89,107
10280,7967,1338,3886,931,6629,196,89,107
10285,7968,1338,3887,931,6630,196,89,107
10290,7973,1338,3889,931,6635,196,89,107
10295,7975,1338,3891,931,6637,196,89,107
10300,7983,1339,3895,931,6644,196,89,107
10305,7986,1339,3895,931,6647,196,89,107
10310,7991,1340,3897,932,6651,196,89,107
10315,7995,1341,3900,933,6653,196,89,107
10320,7998,1342,3901,934,6656,196,89,107
10325,7999,1342,3902,934,6657,196,89,107
10330,8004,1342,3902,934,6662,196,89,107
10335,8006,1343,3902,934,6663,196,89,107
10340,8014,1343,3904,934,6671,196,89,107
10345,8017,1343,3906,934,6674,196,89,107
10350,8022,1343,3908,934,6679,196,89,107
10355,8026,1343,3909,934,6683,196,89,107
10360,8029,1343,3911,934,6686,196,89,107
10365,8030,1343,3912,934,6687,196,89,107
10370,8035,1343,3913,934,6692,196,89,107
10375,8037,1344,3914,935,6693,196,89,107
10380,8045,1344,3917,935,6701,196,89,107
10385,8048,1344,3919,935,6704,196,89,107
10390,8053,1344,3920,935,6709,196,89,107
10395,8057,1344,3920,935,6713,196,89,107
10400,8060,1344,3923,935,6716,196,89,107
10405,8061,1344,3923,935,6717,196,89,107
10410,8066,1344,3924,935,6722,196,89,107
10415,8068,1345,3925,935,6723,196,89,107
10420,8076,1345,3931,935,6731,196,89,107
10425,8079,1345,3932,935,6734,196,89,107
10430,8084,1346,3934,936,6738,197,89,108
10435,8088,1346,3935,936,6742,197,89,108
10440,8091,1346,3935,936,6745,197,89,108
10445,8092,1346,3935,936,6746,197,89,108
10450,8097,1347,3937,936,6750,197,89,108
10455,8099,1348,3938,936,6751,197,89,108
10460,8107,1349,3945,937,6758,197,89,108
10465,8110,1349,3946,937,6761,197,89,108
10470,8115,1350,3950,938,6765,198,90,108
10475,8119,1350,3953,938,6769,198,90,108
10480,8122,1350,3954,938,6772,198,90,108
10485,8123,1350,3955,938,6773,198,90,108
10490,8128,1351,3957,938,6777,198,90,108
10495,8130,1352,3958,939,6778,198,90,108
10500,8138,1353,3963,939,6785,198,90,108
10505,8141,1353,3963,939,6788,198,90,108
10510,8146,1354,3966,939,6792,199,91,108
10515,8150,1354,3969,939,6796,199,91,108
10520,8153,1355,3971,940,6798,199,91,108
10525,8154,1355,3972,940,6799,199,91,108
10530,8159,1356,3975,941,6803,199,91,108
10535,8161,1357,3976,942,6804,199,91,108
10540,8169,1358,3981,942,6811,199,91,108
10545,8172,1358,3982,942,6814,199,91,108
10550,8177,1360,3986,943,6817,200,92,108
10555,8181,1360,3987,943,6820,200,92,108
10560,8184,1362,3988,945,6822,200,92,108
10565,8185,1362,3988,945,6823,200,92,108
10570,8190,1363,3990,945,6827,200,92,108
10575,8192,1363,3991,945,6829,200,92,108
10580,8200,1363,3994,945,6837,200,92,108
10585,8203,1363,3996,945,6840,200,92,108
10590,8208,1363,4000,945,6845,200,92,108
10595,8212,1363,4003,945,6848,200,92,108
10600,8215,1364,4003,946,6851,200,92,108
10605,8216,1364,4003,946,6852,200,92,108
10610,8221,1365,4005,946,6856,200,92,108
10615,8223,1365,4007,946,6858,200,92,108
10620,8231,1365,4009,946,6866,200,92,108
10625,8234,1365,4010,946,6869,200,92,108
10630,8239,1365,4013,946,6874,200,92,108
10635,8243,1365,4013,946,6878,200,92,108
10640,8246,1365,4014,946,6881,200,92,108
10645,8247,1366,4015,947,6881,200,92,108
10650,8252,1367,4016,947,6885,200,92,108
10655,8254,1367,4017,947,6887,200,92,108
10660,8262,1367,4022,947,6895,200,92,108
10665,8265,1367,4023,947,6898,200,92,108
10670,8270,1368,4023,947,6902,201,92,109
10675,8274,1368,4026,947,6905,201,92,109
10680,8277,1370,4029,949,6907,201,92,109
10685,8278,1370,4030,949,6908,201,92,109
10690,8283,1370,4031,949,6913,201,92,109
10695,8285,1371,4032,950,6914,201,92,109
10700,8293,1372,4035,951,6921,201,92,109
10705,8296,1373,4037,952,6923,201,92,109
10710,8301,1374,4041,953,6927,202,93,109
10715,8305,1374,4043,953,6931,202,93,109
10720,8308,1375,4045,954,6933,202,93,109
10725,8309,1375,4046,954,6934,202,93,109
10730,8314,1375,4049,954,6938,202,93,109
10735,8316,1377,4051,956,6939,202,93,109
10740,8324,1378,4052,956,6946,202,93,109
10745,8327,1379,4053,957,6948,202,93,109
10750,8332,1380,4055,958,6952,203,93,110
10755,8336,1380,4055,958,6956,203,93,110
10760,8339,1380,4057,958,6959,203,93,110
10765,8340,1380,4057,958,6960,203,93,110
10770,8345,1380,4061,958,6964,203,93,110
10775,8347,1382,4062,959,6965,203,93,110
10780,8355,1383,4065,959,6972,203,93,110
10785,8358,1383,4067,959,6975,203,93,110
10790,8363,1384,4069,959,6979,204,93,111
10795,8367,1384,4069,959,6983,204,93,111
10800,8370,1385,4071,960,6985,204,93,111
10805,8371,1386,4072,961,6985,204,93,111
10810,8376,1387,4074,961,6989,204,93,111
10815,8378,1387,4075,961,6991,204,93,111
10820,8386,1389,4079,963,6997,204,93,111
10825,8389,1389,4082,963,7000,204,93,111
10830,8394,1389,4084,963,7005,204,93,111
10835,8398,1389,4086,963,7009,204,93,111
10840,8401,1389,4087,963,7012,204,93,111
10845,8402,1389,4087,963,7013,204,93,111
10850,8407,1390,4090,963,7017,204,93,111
10855,8409,1390,4091,963,7019,204,93,111
10860,8417,1392,4094,964,7025,204,93,111
10865,8420,1392,4097,964,7028,204,93,111
10870,8425,1392,4100,964,7033,204,93,111
10875,8429,1392,4102,964,7036,204,93,111
10880,8432,1393,4105,965,7039,204,93,111
10885,8433,1393,4105,965,7040,204,93,111
10890,8438,1394,4107,966,7044,204,93,111
10895,8440,1394,4107,966,7046,204,93,111
10900,8448,1396,4112,968,7052,204,93,111
10905,8451,1396,4113,968,7055,204,93,111
10910,8456,1397,4117,969,7059,205,94,111
10915,8460,1397,4118,969,7062,205,94,111
10920,8463,1399,4119,971,7064,205,94,111
10925,8464,1399,4119,971,7065,205,94,111
10930,8469,1399,4119,971,7070,205,94,111
10935,8471,1400,4120,971,7071,205,94,111
10940,8479,1400,4124,971,7079,206,95,111
10945,8482,1400,4127,971,7082,206,95,111
10950,8487,1401,4130,972,7086,207,96,111
10955,8491,1401,4133,972,7090,207,96,111
10960,8494,1401,4134,972,7093,207,96,111
10965,8495,1401,4135,972,7094,207,96,111
10970,8500,1401,4138,972,7099,207,96,111
10975,8502,1402,4139,973,7100,207,96,111
10980,8510,1403,4143,974,7107,208,97,111
10985,8513,1403,4146,974,7110,208,97,111
10990,8518,1404,4147,975,7114,209,97,112
10995,8522,1404,4149,975,7118,209,97,112
11000,8525,1404,4150,975,7121,209,97,112
11005,8526,1404,4151,975,7122,209,97,112
11010,8531,1404,4153,975,7127,209,97,112
11015,8533,1405,4154,975,7128,209,97,112
11020,8541,1405,4159,975,7136,210,97,113
11025,8544,1405,4160,975,7139,210,97,113
11030,8549,1406,4161,975,7143,211,97,114
11035,8553,1406,4163,975,7146,211,97,114
11040,8556,1408,4166,977,7148,211,97,114
11045,8557,1409,4167,978,7148,211,97,114
11050,8562,1410,4170,979,7152,211,97,114
11055,8564,1410,4171,979,7154,211,97,114
11060,8572,1411,4175,980,7161,211,97,114
11065,8575,1411,4176,980,7164,211,97,114
11070,8580,1412,4179,981,7168,211,97,114
11075,8584,1412,4181,981,7172,211,97,114
11080,8587,1412,4183,981,7175,211,97,114
11085,8588,1412,4183,981,7176,211,97,114
11090,8593,1413,4187,982,7180,211,97,114
11095,8595,1413,4188,982,7182,211,97,114
11100,8603,1414,4194,983,7189,211,97,114
11105,8606,1414,4196,983,7192,211,97,114
11110,8611,1415,4198,984,7196,211,97,114
11115,8615,1415,4200,984,7200,211,97,114
11120,8618,1415,4201,984,7203,211,97,114
11125,8619,1416,4202,985,7203,211,97,114
11130,8624,1417,4204,985,7207,211,97,114
11135,8626,1417,4205,985,7209,211,97,114
11140,8634,1418,4212,986,7216,211,97,114
11145,8637,1418,4214,986,7219,211,97,114
11150,8642,1420,4216,988,7222,211,97,114
11155,8646,1420,4217,988,7226,211,97,114
11160,8649,1420,4219,988,7229,211,97,114
11165,8650,1420,4219,988,7230,211,97,114
11170,8655,1420,4221,988,7235,211,97,114
11175,8657,1420,4222,988,7237,211,97,114
11180,8665,1421,4226,989,7244,211,97,114
11185,8668,1421,4227,989,7247,211,97,114
11190,8673,1422,4231,990,7251,211,97,114
11195,8677,1422,4233,990,7255,211,97,114
11200,8680,1422,4235,990,7258,211,97,114
11205,8681,1422,4235,990,7259,211,97,114
11210,8686,1422,4236,990,7264,211,97,114
11215,8688,1422,4238,990,7266,211,97,114
11220,8696,1423,4242,991,7273,211,97,114
11225,8699,1423,4244,991,7276,211,97,114
11230,8704,1424,4247,991,7280,211,97,114
11235,8708,1424,4249,991,7284,211,97,114
11240,8711,1424,4250,991,7287,211,97,114
11245,8712,1424,4250,991,7288,211,97,114
11250,8717,1424,4250,991,7293,211,97,114
11255,8719,1424,4251,991,7295,211,97,114
11260,8727,1425,4252,991,7302,211,97,114
11265,8730,1426,4253,992,7304,211,97,114
11270,8735,1428,4256,994,7307,212,98,114
11275,8739,1428,4257,994,7310,212,98,114
11280,8742,1429,4258,995,7313,212,98,114
11285,8743,1429,4258,995,7314,212,98,114
11290,8748,1430,4260,996,7317,212,98,114
11295,8750,1432,4261,997,7318,212,98,114
11300,8758,1434,4266,998,7324,212,98,114
11305,8761,1434,4267,998,7327,212,98,114
11310,8766,1434,4269,998,7332,213,99,114
11315,8770,1434,4270,998,7336,213,99,114
11320,8773,1434,4273,998,7339,213,99,114
11325,8774,1434,4273,998,7340,213,99,114
11330,8779,1435,4278,999,7343,213,99,114
11335,8781,1437,4280,1001,7344,213,99,114
11340,8789,1438,4282,1001,7351,213,99,114
11345,8792,1438,4283,1001,7354,213,99,114
11350,8797,1438,4286,1001,7359,213,99,114
11355,8801,1438,4288,1001,7362,213,99,114
11360,8804,1439,4288,1002,7365,213,99,114
11365,8805,1440,4289,1003,7365,213,99,114
11370,8810,1441,4292,1003,7368,213,99,114
11375,8812,1443,4294,1005,7369,213,99,114
11380,8820,1445,4298,1006,7375,213,99,114
11385,8823,1445,4299,1006,7378,213,99,114
11390,8828,1446,4302,1007,7382,213,99,114
11395,8832,1447,4304,1008,7384,213,99,114
11400,8835,1448,4305,1009,7387,213,99,114
11405,8836,1448,4305,1009,7388,213,99,114
11410,8841,1448,4305,1009,7393,213,99,114
11415,8843,1449,4306,1009,7394,213,99,114
11420,8851,1449,4311,1009,7402,213,99,114
11425,8854,1449,4312,1009,7405,213,99,114
11430,8859,1450,4313,1009,7409,213,99,114
11435,8863,1450,4313,1009,7413,213,99,114
11440,8866,1450,4314,1009,7416,213,99,114
11445,8867,1450,4314,1009,7417,213,99,114
11450,8872,1450,4316,1009,7422,213,99,114
11455,8874,1451,4317,1009,7423,213,99,114
11460,8882,1451,4322,1009,7431,213,99,114
11465,8885,1451,4323,1009,7434,213,99,114
11470,8890,1452,4326,1009,7438,213,99,114
11475,8894,1452,4326,1009,7442,213,99,114
11480,8897,1452,4327,1009,7445,213,99,114
11485,8898,1452,4328,1009,7446,213,99,114
11490,8903,1452,4331,1009,7450,213,99,114
11495,8905,1454,4331,1010,7451,213,99,114
11500,8913,1454,4335,1010,7459,213,99,114
11505,8916,1454,4338,1010,7462,213,99,114
11510,8921,1455,4342,1011,7466,214,100,114
11515,8925,1455,4344,1011,7470,214,100,114
11520,8928,1456,4346,1012,7472,214,100,114
11525,8929,1456,4347,1012,7473,214,100,114
11530,8934,1457,4350,1013,7477,214,100,114
11535,8936,1457,4351,1013,7479,214,100,114
11540,8944,1458,4353,1013,7486,214,100,114
11545,8947,1458,4353,1013,7489,214,100,114
11550,8952,1459,4356,1013,7493,215,100,115
11555,8956,1459,4359,1013,7496,215,100,115
11560,8959,1460,4360,1014,7499,215,100,115
11565,8960,1460,4360,1014,7500,215,100,115
11570,8965,1461,4361,1014,7504,215,100,115
11575,8967,1461,4362,1014,7506,215,100,115
11580,8975,1463,4365,1015,7512,215,100,115
11585,8978,1463,4365,1015,7515,215,100,115
11590,8983,1464,4367,1016,7519,215,100,115
11595,8987,1464,4368,1016,7523,215,100,115
11600,8990,1464,4369,1016,7526,215,100,115
11605,8991,1464,4369,1016,7527,215,100,115
11610,8996,1465,4371,1016,7531,215,100,115
11615,8998,1465,4372,1016,7533,215,100,115
11620,9006,1466,4377,1017,7540,215,100,115
11625,9009,1466,4378,1017,7543,215,100,115
11630,9014,1467,4379,1017,7547,215,100,115
11635,9018,1467,4381,1017,7550,215,100,115
11640,9021,1469,4384,1019,7552,215,100,115
11645,9022,1470,4385,1020,7552,215,100,115
11650,9027,1471,4388,1020,7556,215,100,115
11655,9029,1471,4388,1020,7558,215,100,115
11660,9037,1472,4391,1021,7565,215,100,115
11665,9040,1472,4394,1021,7568,215,100,115
11670,9045,1472,4397,1021,7573,215,100,115
11675,9049,1472,4399,1021,7577,215,100,115
11680,9052,1472,4401,1021,7580,215,100,115
11685,9053,1472,4402,1021,7581,215,100,115
11690,9058,1473,4405,1022,7585,215,100,115
11695,9060,1473,4406,1022,7587,215,100,115
11700,9068,1474,4410,1023,7594,215,100,115
11705,9071,1474,4412,1023,7597,215,100,115
11710,9076,1475,4415,1023,7601,215,100,115
11715,9080,1475,4418,1023,7605,215,100,115
11720,9083,1475,4421,1023,7608,215,100,115
11725,9084,1476,4422,1024,7608,215,100,115
11730,9089,1477,4427,1025,7612,215,100,115
11735,9091,1477,4427,1025,7614,215,100,115
11740,9099,1479,4430,1026,7620,215,100,115
11745,9102,1479,4432,1026,7623,215,100,115
11750,9107,1480,4435,1026,7627,215,100,115
11755,9111,1480,4437,1026,7630,215,100,115
11760,9114,1481,4439,1027,7633,215,100,115
11765,9115,1481,4440,1027,7634,215,100,115
11770,9120,1481,4443,1027,7638,215,100,115
11775,9122,1483,4445,1029,7639,215,100,115
11780,9130,1484,4450,1030,7645,215,100,115
11785,9133,1486,4453,1032,7647,215,100,115
11790,9138,1486,4453,1032,7652,216,100,116
11795,9142,1487,4455,1033,7655,216,100,116
11800,9145,1487,4456,1033,7658,216,100,116
11805,9146,1487,4456,1033,7659,216,100,116
11810,9151,1487,4457,1033,7664,216,100,116
11815,9153,1488,4458,1034,7665,216,100,116
11820,9161,1490,4463,1036,7671,216,100,116
11825,9164,1490,4464,1036,7674,216,100,116
11830,9169,1490,4465,1036,7679,217,101,116
11835,9173,1490,4467,1036,7683,217,101,116
11840,9176,1490,4469,1036,7686,217,101,116
11845,9177,1490,4470,1036,7687,217,101,116
11850,9182,1490,4473,1036,7692,217,101,116
11855,9184,1491,4474,1036,7693,217,101,116
11860,9192,1493,4477,1037,7699,217,101,116
11865,9195,1493,4479,1037,7702,217,101,116
11870,9200,1494,4481,1038,7706,218,101,117
11875,9204,1494,4481,1038,7710,218,101,117
11880,9207,1494,4484,1038,7713,218,101,117
11885,9208,1494,4484,1038,7714,218,101,117
11890,9213,1495,4488,1039,7717,218,101,117
11895,9215,1497,4489,1040,7718,218,101,117
11900,9223,1498,4491,1041,7725,218,101,117
11905,9226,1499,4494,1042,7727,218,101,117
11910,9231,1500,4497,1043,7731,219,102,117
11915,9235,1500,4498,1043,7735,219,102,117
11920,9238,1501,4501,1044,7737,219,102,117
11925,9239,1501,4502,1044,7738,219,102,117
11930,9244,1502,4505,1045,7741,219,102,117
11935,9246,1504,4506,1046,7742,219,102,117
11940,9254,1505,4511,1047,7748,219,102,117
11945,9257,1506,4513,1048,7751,219,102,117
11950,9262,1506,4515,1048,7756,219,102,117
11955,9266,1506,4516,1048,7760,219,102,117
11960,9269,1506,4518,1048,7763,219,102,117
11965,9270,1506,4518,1048,7764,219,102,117
11970,9275,1507,4520,1048,7768,219,102,117
11975,9277,1507,4522,1048,7770,219,102,117
11980,9285,1508,4525,1049,7776,220,102,118
11985,9288,1509,4525,1050,7779,220,102,118
11990,9293,1509,4525,1050,7784,220,102,118
11995,9297,1509,4527,1050,7788,220,102,118
12000,9300,1509,4529,1050,7791,220,102,118
12005,9301,1509,4530,1050,7792,220,102,118
12010,9306,1509,4532,1050,7796,220,102,118
12015,9308,1511,4532,1051,7797,220,102,118
12020,9316,1512,4537,1052,7804,220,102,118
12025,9319,1512,4537,1052,7807,220,102,118
12030,9324,1512,4541,1052,7812,220,102,118
12035,9328,1512,4542,1052,7816,220,102,118
12040,9331,1512,4543,1052,7819,220,102,118
12045,9332,1512,4543,1052,7820,220,102,118
12050,9337,1512,4545,1052,7825,220,102,118
12055,9339,1513,4545,1052,7826,220,102,118
12060,9347,1514,4550,1053,7833,220,102,118
12065,9350,1514,4551,1053,7836,220,102,118
12070,9355,1515,4553,1053,7840,221,102,119
12075,9359,1515,4555,1053,7843,221,102,119
12080,9362,1516,4556,1054,7846,221,102,119
12085,9363,1516,4557,1054,7847,221,102,119
12090,9368,1516,4559,1054,7852,221,102,119
12095,9370,1516,4559,1054,7854,221,102,119
12100,9378,1517,4562,1055,7861,221,102,119
12105,9381,1517,4564,1055,7864,221,102,119
12110,9386,1518,4568,1056,7868,222,103,119
12115,9390,1518,4569,1056,7871,222,103,119
12120,9393,1519,4570,1057,7874,222,103,119
12125,9394,1519,4570,1057,7875,222,103,119
12130,9399,1520,4574,1058,7879,222,103,119
12135,9401,1520,4574,1058,7881,222,103,119
12140,9409,1521,4578,1058,7888,222,103,119
12145,9412,1521,4580,1058,7891,222,103,119
12150,9417,1522,4581,1058,7895,222,103,119
12155,9421,1522,4582,1058,7898,222,103,119
12160,9424,1523,4585,1059,7901,222,103,119
12165,9425,1524,4586,1060,7901,222,103,119
12170,9430,1525,4588,1061,7905,222,103,119
12175,9432,1526,4588,1061,7906,222,103,119
12180,9440,1528,4595,1063,7912,222,103,119
12185,9443,1529,4597,1064,7914,222,103,119
12190,9448,1529,4600,1064,7919,223,103,120
12195,9452,1529,4604,1064,7923,223,103,120
12200,9455,1529,4605,1064,7926,223,103,120
12205,9456,1529,4605,1064,7927,223,103,120
12210,9461,1530,4609,1064,7930,223,103,120
12215,9463,1532,4611,1066,7931,223,103,120
12220,9471,1533,4615,1067,7938,223,103,120
12225,9474,1534,4616,1068,7940,223,103,120
12230,9479,1534,4621,1068,7945,224,104,120
12235,9483,1534,4622,1068,7949,224,104,120
12240,9486,1534,4623,1068,7952,224,104,120
12245,9487,1535,4624,1069,7952,224,104,120
12250,9492,1536,4628,1070,7956,224,104,120
12255,9494,1536,4629,1070,7958,224,104,120
12260,9502,1536,4634,1070,7966,224,104,120
12265,9505,1536,4635,1070,7969,224,104,120
12270,9510,1536,4637,1070,7974,224,104,120
12275,9514,1536,4639,1070,7978,224,104,120
12280,9517,1536,4641,1070,7981,224,104,120
12285,9518,1537,4642,1071,7981,224,104,120
12290,9523,1538,4646,1072,7985,224,104,120
12295,9525,1538,4647,1072,7987,224,104,120
12300,9533,1538,4652,1072,7995,224,104,120
12305,9536,1538,4653,1072,7998,224,104,120
12310,9541,1539,4654,1072,8002,224,104,120
12315,9545,1539,4656,1072,8006,224,104,120
12320,9548,1539,4657,1072,8009,224,104,120
12325,9549,1540,4658,1073,8009,224,104,120
12330,9554,1541,4660,1073,8013,224,104,120
12335,9556,1541,4661,1073,8015,224,104,120
12340,9564,1541,4666,1073,8023,224,104,120
12345,9567,1541,4667,1073,8026,224,104,120
12350,9572,1542,4669,1073,8030,224,104,120
12355,9576,1542,4670,1073,8034,224,104,120
12360,9579,1542,4672,1073,8037,224,104,120
12365,9580,1542,4672,1073,8038,224,104,120
12370,9585,1542,4676,1073,8042,224,104,120
12375,9587,1544,4678,1075,8043,224,104,120
12380,9595,1545,4684,1076,8049,224,104,120
12385,9598,1546,4685,1077,8052,224,104,120
12390,9603,1548,4690,1079,8055,225,105,120
12395,9607,1548,4691,1079,8058,225,105,120
12400,9610,1550,4694,1081,8060,225,105,120
12405,9611,1550,4695,1081,8061,225,105,120
12410,9616,1550,4697,1081,8066,225,105,120
12415,9618,1551,4698,1081,8067,225,105,120
12420,9626,1553,4702,1083,8072,225,105,120
12425,9629,1554,4704,1084,8075,225,105,120
12430,9634,1555,4708,1085,8079,225,105,120
12435,9638,1555,4710,1085,8082,225,105,120
12440,9641,1556,4710,1086,8085,225,105,120
12445,9642,1556,4711,1086,8086,225,105,120
12450,9647,1556,4714,1086,8091,225,105,120
12455,9649,1556,4714,1086,8093,225,105,120
12460,9657,1558,4721,1088,8098,225,105,120
12465,9660,1559,4723,1089,8101,225,105,120
12470,9665,1560,4726,1089,8105,225,105,120
12475,9669,1560,4728,1089,8108,225,105,120
12480,9672,1561,4730,1090,8111,225,105,120
12485,9673,1561,4730,1090,8112,225,105,120
12490,9678,1562,4732,1090,8116,225,105,120
12495,9680,1562,4733,1090,8118,225,105,120
12500,9688,1563,4736,1090,8125,225,105,120
12505,9691,1563,4737,1090,8128,225,105,120
12510,9696,1564,4740,1090,8132,225,105,120
12515,9700,1564,4742,1090,8136,225,105,120
12520,9703,1564,4743,1090,8139,225,105,120
12525,9704,1565,4744,1091,8139,225,105,120
12530,9709,1566,4745,1091,8142,225,105,120
12535,9711,1568,4746,1092,8143,225,105,120
12540,9719,1570,4751,1094,8149,225,105,120
12545,9722,1570,4752,1094,8152,225,105,120
12550,9727,1570,4754,1094,8157,225,105,120
12555,9731,1570,4756,1094,8161,225,105,120
12560,9734,1570,4759,1094,8164,225,105,120
12565,9735,1570,4759,1094,8165,225,105,120
12570,9740,1571,4762,1095,8169,225,105,120
12575,9742,1571,4762,1095,8171,225,105,120
12580,9750,1573,4769,1097,8177,225,105,120
12585,9753,1574,4771,1098,8179,225,105,120
12590,9758,1574,4772,1098,8184,225,105,120
12595,9762,1574,4774,1098,8188,225,105,120
12600,9765,1574,4776,1098,8191,225,105,120
12605,9766,1574,4777,1098,8192,225,105,120
12610,9771,1575,4779,1098,8196,225,105,120
12615,9773,1575,4780,1098,8198,225,105,120
12620,9781,1575,4783,1098,8206,225,105,120
12625,9784,1575,4784,1098,8209,225,105,120
12630,9789,1575,4787,1098,8214,225,105,120
12635,9793,1575,4789,1098,8218,225,105,120
12640,9796,1575,4790,1098,8221,225,105,120
12645,9797,1575,4791,1098,8222,225,105,120
12650,9802,1576,4793,1098,8226,225,105,120
12655,9804,1577,4793,1098,8227,225,105,120
12660,9812,1577,4795,1098,8235,225,105,120
12665,9815,1577,4796,1098,8238,225,105,120
12670,9820,1578,4796,1098,8242,225,105,120
12675,9824,1578,4798,1098,8246,225,105,120
12680,9827,1578,4799,1098,8249,225,105,120
12685,9828,1578,4800,1098,8250,225,105,120
12690,9833,1579,4804,1098,8253,225,105,120
12695,9835,1581,4805,1100,8254,225,105,120
12700,9843,1582,4809,1101,8261,225,105,120
12705,9846,1582,4810,1101,8264,225,105,120
12710,9851,1583,4811,1101,8268,225,105,120
12715,9855,1583,4814,1101,8271,225,105,120
12720,9858,1584,4816,1102,8274,225,105,120
12725,9859,1585,4817,1103,8274,225,105,120
12730,9864,1586,4819,1104,8277,225,105,120
12735,9866,1588,4821,1106,8278,225,105,120
12740,9874,1589,4825,1106,8285,225,105,120
12745,9877,1589,4827,1106,8288,225,105,120
12750,9882,1591,4830,1108,8291,225,105,120
12755,9886,1591,4833,1108,8294,225,105,120
12760,9889,1592,4834,1109,8297,225,105,120
12765,9890,1593,4835,1110,8297,225,105,120
12770,9895,1594,4837,1110,8301,225,105,120
12775,9897,1595,4838,1111,8302,225,105,120
12780,9905,1596,4843,1112,8309,225,105,120
12785,9908,1596,4845,1112,8312,225,105,120
12790,9913,1597,4848,1113,8316,226,105,121
12795,9917,1598,4850,1114,8319,226,105,121
12800,9920,1598,4852,1114,8322,226,105,121
12805,9921,1598,4852,1114,8323,226,105,121
12810,9926,1599,4854,1114,8327,226,105,121
12815,9928,1599,4855,1114,8329,226,105,121
12820,9936,1600,4859,1115,8336,226,105,121
12825,9939,1600,4861,1115,8339,226,105,121
12830,9944,1601,4862,1115,8343,227,106,121
12835,9948,1601,4863,1115,8347,227,106,121
12840,9951,1602,4865,1116,8349,227,106,121
12845,9952,1602,4865,1116,8350,227,106,121
12850,9957,1603,4867,1117,8354,227,106,121
12855,9959,1603,4868,1117,8356,227,106,121
12860,9967,1604,4871,1117,8363,227,106,121
12865,9970,1604,4872,1117,8366,227,106,121
12870,9975,1604,4873,1117,8371,227,106,121
12875,9979,1604,4874,1117,8375,227,106,121
12880,9982,1604,4876,1117,8378,227,106,121
12885,9983,1604,4876,1117,8379,227,106,121
12890,9988,1605,4878,1117,8382,227,106,121
12895,9990,1607,4878,1118,8383,227,106,121
12900,9998,1609,4879,1119,8389,227,106,121
12905,10001,1609,4880,1119,8392,227,106,121
12910,10006,1609,4882,1119,8397,227,106,121
12915,10010,1609,4884,1119,8401,227,106,121
12920,10013,1610,4885,1120,8403,227,106,121
12925,10014,1610,4886,1120,8404,227,106,121
12930,10019,1611,4889,1121,8408,227,106,121
12935,10021,1612,4891,1122,8409,227,106,121
12940,10029,1613,4896,1123,8416,227,106,121
12945,10032,1613,4898,1123,8419,227,106,121
12950,10037,1614,4900,1123,8423,228,107,121
12955,10041,1614,4901,1123,8426,228,107,121
12960,10044,1615,4901,1124,8429,228,107,121
12965,10045,1615,4901,1124,8430,228,107,121
12970,10050,1616,4904,1124,8433,228,107,121
12975,10052,1618,4906,1126,8434,228,107,121
12980,10060,1619,4909,1126,8441,228,107,121
12985,10063,1619,4911,1126,8444,228,107,121
12990,10068,1620,4915,1126,8448,229,108,121
12995,10072,1620,4916,1126,8452,229,108,121
13000,10075,1620,4916,1126,8455,229,108,121
13005,10076,1621,4917,1127,8455,229,108,121
13010,10081,1622,4920,1127,8458,229,108,121
13015,10083,1624,4922,1129,8459,229,108,121
13020,10091,1625,4926,1129,8466,229,108,121
13025,10094,1625,4926,1129,8469,229,108,121
13030,10099,1626,4927,1129,8473,230,108,122
13035,10103,1626,4928,1129,8477,230,108,122
13040,10106,1626,4929,1129,8480,230,108,122
13045,10107,1626,4929,1129,8481,230,108,122
13050,10112,1627,4932,1130,8484,230,108,122
13055,10114,1629,4934,1132,8485,230,108,122
13060,10122,1630,4940,1132,8491,230,108,122
13065,10125,1632,4942,1134,8493,230,108,122
13070,10130,1634,4946,1136,8496,231,109,122
13075,10134,1634,4948,1136,8500,231,109,122
13080,10137,1635,4951,1137,8502,231,109,122
13085,10138,1635,4951,1137,8503,231,109,122
13090,10143,1636,4952,1137,8507,231,109,122
13095,10145,1636,4953,1137,8509,231,109,122
13100,10153,1637,4957,1138,8516,231,109,122
13105,10156,1637,4959,1138,8519,231,109,122
13110,10161,1638,4960,1138,8523,231,109,122
13115,10165,1639,4962,1139,8526,231,109,122
13120,10168,1640,4964,1140,8528,231,109,122
13125,10169,1641,4965,1141,8528,231,109,122
13130,10174,1642,4969,1142,8532,231,109,122
13135,10176,1642,4970,1142,8534,231,109,122
13140,10184,1643,4971,1142,8541,231,109,122
13145,10187,1644,4973,1143,8543,231,109,122
13150,10192,1645,4976,1143,8547,231,109,122
13155,10196,1646,4978,1144,8550,231,109,122
13160,10199,1646,4979,1144,8553,231,109,122
13165,10200,1646,4979,1144,8554,231,109,122
13170,10205,1647,4981,1144,8558,231,109,122
13175,10207,1647,4981,1144,8560,231,109,122
13180,10215,1648,4985,1144,8567,231,109,122
13185,10218,1648,4986,1144,8570,231,109,122
13190,10223,1649,4989,1145,8574,232,110,122
13195,10227,1650,4990,1146,8577,232,110,122
13200,10230,1651,4992,1147,8579,232,110,122
13205,10231,1651,4992,1147,8580,232,110,122
13210,10236,1651,4994,1147,8584,232,110,122
13215,10238,1653,4995,1149,8585,232,110,122
13220,10246,1653,5001,1149,8593,232,110,122
13225,10249,1653,5003,1149,8596,232,110,122
13230,10254,1653,5005,1149,8601,232,110,122
13235,10258,1653,5006,1149,8605,232,110,122
13240,10261,1653,5007,1149,8608,232,110,122
13245,10262,1653,5007,1149,8609,232,110,122
13250,10267,1653,5008,1149,8613,232,110,122
13255,10269,1655,5010,1151,8614,232,110,122
13260,10277,1655,5013,1151,8622,232,110,122
13265,10280,1655,5013,1151,8625,232,110,122
13270,10285,1655,5015,1151,8630,232,110,122
13275,10289,1655,5018,1151,8634,232,110,122
13280,10292,1655,5019,1151,8637,232,110,122
13285,10293,1655,5020,1151,8638,232,110,122
13290,10298,1655,5021,1151,8643,232,110,122
13295,10300,1656,5022,1152,8644,232,110,122
13300,10308,1656,5026,1152,8652,232,110,122
13305,10311,1656,5027,1152,8655,232,110,122
13310,10316,1657,5032,1153,8659,233,111,122
13315,10320,1657,5035,1153,8662,233,111,122
13320,10323,1659,5038,1155,8664,233,111,122
13325,10324,1660,5039,1156,8664,233,111,122
13330,10329,1661,5041,1156,8668,233,111,122
13335,10331,1661,5043,1156,8670,233,111,122
13340,10339,1662,5045,1156,8677,233,111,122
13345,10342,1662,5047,1156,8680,233,111,122
13350,10347,1663,5051,1157,8684,234,112,122
13355,10351,1663,5053,1157,8688,234,112,122
13360,10354,1663,5054,1157,8691,234,112,122
13365,10355,1663,5054,1157,8692,234,112,122
13370,10360,1664,5056,1157,8696,234,112,122
13375,10362,1664,5057,1157,8698,234,112,122
13380,10370,1665,5060,1158,8705,234,112,122
13385,10373,1665,5062,1158,8708,234,112,122
13390,10378,1666,5067,1159,8712,235,113,122
13395,10382,1666,5070,1159,8716,235,113,122
13400,10385,1666,5073,1159,8719,235,113,122
13405,10386,1667,5074,1160,8719,235,113,122
13410,10391,1668,5078,1161,8723,235,113,122
13415,10393,1668,5079,1161,8725,235,113,122
13420,10401,1669,5085,1162,8732,235,113,122
13425,10404,1669,5085,1162,8735,235,113,122
13430,10409,1670,5089,1163,8739,236,114,122
13435,10413,1671,5091,1164,8742,236,114,122
13440,10416,1671,5092,1164,8745,236,114,122
13445,10417,1671,5093,1164,8746,236,114,122
13450,10422,1671,5096,1164,8750,236,114,122
13455,10424,1673,5098,1166,8751,236,114,122
13460,10432,1673,5102,1166,8759,236,114,122
13465,10435,1673,5103,1166,8762,236,114,122
13470,10440,1673,5105,1166,8767,236,114,122
13475,10444,1673,5105,1166,8771,236,114,122
13480,10447,1673,5106,1166,8774,236,114,122
13485,10448,1673,5107,1166,8775,236,114,122
13490,10453,1673,5108,1166,8779,236,114,122
13495,10455,1675,5109,1167,8780,236,114,122
13500,10463,1675,5113,1167,8788,236,114,122
13505,10466,1675,5114,1167,8791,236,114,122
13510,10471,1675,5115,1167,8796,236,114,122
13515,10475,1675,5118,1167,8800,236,114,122
13520,10478,1675,5120,1167,8803,236,114,122
13525,10479,1675,5121,1167,8804,236,114,122
13530,10484,1675,5121,1167,8809,236,114,122
13535,10486,1676,5123,1168,8810,236,114,122
13540,10494,1676,5126,1168,8818,236,114,122
13545,10497,1676,5127,1168,8821,236,114,122
13550,10502,1677,5129,1168,8825,237,115,122
13555,10506,1677,5131,1168,8828,237,115,122
13560,10509,1679,5134,1170,8830,237,115,122
13565,10510,1680,5135,1171,8830,237,115,122
13570,10515,1681,5137,1171,8834,237,115,122
13575,10517,1681,5137,1171,8836,237,115,122
13580,10525,1681,5140,1171,8844,237,115,122
13585,10528,1681,5143,1171,8847,237,115,122
13590,10533,1682,5145,1172,8851,237,115,122
13595,10537,1682,5148,1172,8855,237,115,122
13600,10540,1682,5150,1172,8858,237,115,122
13605,10541,1683,5151,1173,8858,237,115,122
13610,10546,1684,5155,1174,8862,237,115,122
13615,10548,1684,5156,1174,8864,237,115,122
13620,10556,1684,5161,1174,8872,237,115,122
13625,10559,1684,5164,1174,8875,237,115,122
13630,10564,1685,5166,1174,8879,237,115,122
13635,10568,1685,5168,1174,8883,237,115,122
13640,10571,1685,5168,1174,8886,237,115,122
13645,10572,1685,5168,1174,8887,237,115,122
13650,10577,1686,5172,1174,8891,237,115,122
13655,10579,1686,5173,1174,8893,237,115,122
13660,10587,1686,5176,1174,8901,237,115,122
13665,10590,1686,5176,1174,8904,237,115,122
13670,10595,1687,5177,1175,8908,238,115,123
13675,10599,1687,5177,1175,8912,238,115,123
13680,10602,1687,5179,1175,8915,238,115,123
13685,10603,1687,5180,1175,8916,238,115,123
13690,10608,1687,5182,1175,8921,238,115,123
13695,10610,1688,5184,1176,8922,238,115,123
13700,10618,1690,5188,1178,8928,238,115,123
13705,10621,1690,5191,1178,8931,238,115,123
13710,10626,1690,5194,1178,8936,239,116,123
13715,10630,1690,5197,1178,8940,239,116,123
13720,10633,1690,5200,1178,8943,239,116,123
13725,10634,1690,5200,1178,8944,239,116,123
13730,10639,1690,5202,1178,8949,239,116,123
13735,10641,1691,5202,1178,8950,239,116,123
13740,10649,1692,5204,1179,8957,239,116,123
13745,10652,1692,5205,1179,8960,239,116,123
13750,10657,1692,5206,1179,8965,239,116,123
13755,10661,1692,5208,1179,8969,239,116,123
13760,10664,1692,5210,1179,8972,239,116,123
13765,10665,1692,5210,1179,8973,239,116,123
13770,10670,1692,5213,1179,8978,239,116,123
13775,10672,1693,5215,1180,8979,239,116,123
13780,10680,1694,5218,1180,8986,239,116,123
13785,10683,1694,5219,1180,8989,239,116,123
13790,10688,1696,5222,1182,8992,239,116,123
13795,10692,1696,5223,1182,8996,239,116,123
13800,10695,1696,5224,1182,8999,239,116,123
13805,10696,1696,5225,1182,9000,239,116,123
13810,10701,1697,5228,1183,9004,239,116,123
13815,10703,1697,5230,1183,9006,239,116,123
13820,10711,1698,5234,1184,9013,239,116,123
13825,10714,1698,5234,1184,9016,239,116,123
13830,10719,1699,5236,1184,9020,239,116,123
13835,10723,1699,5238,1184,9024,239,116,123
13840,10726,1700,5241,1185,9026,239,116,123
13845,10727,1700,5242,1185,9027,239,116,123
13850,10732,1701,5245,1186,9031,239,116,123
13855,10734,1701,5246,1186,9033,239,116,123
13860,10742,1702,5250,1187,9040,239,116,123
13865,10745,1702,5252,1187,9043,239,116,123
13870,10750,1703,5253,1188,9047,239,116,123
13875,10754,1703,5254,1188,9051,239,116,123
13880,10757,1704,5256,1189,9053,239,116,123
13885,10758,1704,5256,1189,9054,239,116,123
13890,10763,1705,5259,1190,9058,239,116,123
13895,10765,1705,5260,1190,9060,239,116,123
13900,10773,1706,5264,1191,9067,239,116,123
13905,10776,1706,5265,1191,9070,239,116,123
13910,10781,1707,5267,1192,9074,239,116,123
13915,10785,1708,5271,1193,9076,239,116,123
13920,10788,1710,5273,1195,9078,239,116,123
13925,10789,1711,5274,1196,9078,239,116,123
13930,10794,1712,5276,1196,9081,239,116,123
13935,10796,1714,5278,1198,9082,239,116,123
13940,10804,1716,5282,1199,9088,239,116,123
13945,10807,1716,5284,1199,9091,239,116,123
13950,10812,1716,5287,1199,9096,239,116,123
13955,10816,1716,5290,1199,9100,239,116,123
13960,10819,1716,5291,1199,9103,239,116,123
13965,10820,1717,5292,1200,9103,239,116,123
13970,10825,1718,5294,1201,9107,239,116,123
13975,10827,1719,5295,1201,9108,239,116,123
13980,10835,1721,5300,1202,9114,239,116,123
13985,10838,1721,5301,1202,9117,239,116,123
13990,10843,1721,5303,1202,9122,239,116,123
13995,10847,1721,5303,1202,9126,239,116,123
14000,10850,1721,5303,1202,9129,239,116,123
14005,10851,1721,5303,1202,9130,239,116,123
14010,10856,1722,5304,1203,9134,239,116,123
14015,10858,1723,5305,1204,9135,239,116,123
14020,10866,1725,5311,1205,9141,239,116,123
14025,10869,1725,5312,1205,9144,239,116,123
14030,10874,1727,5315,1206,9147,240,117,123
14035,10878,1728,5317,1207,9150,240,117,123
14040,10881,1728,5318,1207,9153,240,117,123
14045,10882,1728,5319,1207,9154,240,117,123
14050,10887,1728,5322,1207,9159,240,117,123
14055,10889,1728,5323,1207,9161,240,117,123
14060,10897,1728,5328,1207,9169,240,117,123
14065,10900,1728,5331,1207,9172,240,117,123
14070,10905,1729,5334,1207,9176,241,117,124
14075,10909,1729,5336,1207,9179,241,117,124
14080,10912,1730,5336,1208,9182,241,117,124
14085,10913,1730,5337,1208,9183,241,117,124
14090,10918,1730,5340,1208,9188,241,117,124
14095,10920,1730,5341,1208,9190,241,117,124
14100,10928,1730,5346,1208,9198,241,117,124
14105,10931,1730,5347,1208,9201,241,117,124
14110,10936,1731,5351,1209,9205,241,117,124
14115,10940,1731,5352,1209,9208,241,117,124
14120,10943,1733,5354,1211,9210,241,117,124
14125,10944,1733,5355,1211,9211,241,117,124
14130,10949,1733,5359,1211,9216,241,117,124
14135,10951,1733,5361,1211,9218,241,117,124
14140,10959,1733,5367,1211,9226,241,117,124
14145,10962,1733,5368,1211,9229,241,117,124
14150,10967,1734,5369,1212,9233,241,117,124
14155,10971,1735,5372,1213,9235,241,117,124
14160,10974,1737,5373,1215,9237,241,117,124
14165,10975,1738,5374,1216,9237,241,117,124
14170,10980,1739,5377,1217,9240,241,117,124
14175,10982,1741,5378,1219,9241,241,117,124
14180,10990,1742,5381,1219,9248,241,117,124
14185,10993,1742,5384,1219,9251,241,117,124
14190,10998,1742,5387,1219,9256,241,117,124
14195,11002,1742,5390,1219,9260,241,117,124
14200,11005,1742,5393,1219,9263,241,117,124
14205,11006,1742,5393,1219,9264,241,117,124
14210,11011,1743,5396,1220,9267,241,117,124
14215,11013,1745,5397,1222,9268,241,117,124
14220,11021,1746,5401,1223,9275,241,117,124
14225,11024,1746,5402,1223,9278,241,117,124
14230,11029,1746,5405,1223,9283,241,117,124
14235,11033,1746,5409,1223,9287,241,117,124
14240,11036,1746,5409,1223,9290,241,117,124
14245,11037,1747,5410,1224,9290,241,117,124
14250,11042,1748,5410,1224,9294,241,117,124
14255,11044,1749,5411,1225,9295,241,117,124
14260,11052,1750,5415,1226,9302,241,117,124
14265,11055,1750,5416,1226,9305,241,117,124
14270,11060,1750,5419,1226,9310,241,117,124
14275,11064,1750,5421,1226,9314,241,117,124
14280,11067,1750,5422,1226,9317,241,117,124
14285,11068,1750,5422,1226,9318,241,117,124
14290,11073,1751,5425,1226,9322,241,117,124
14295,11075,1752,5426,1226,9323,241,117,124
14300,11083,1752,5429,1226,9331,241,117,124
14305,11086,1752,5431,1226,9334,241,117,124
14310,11091,1752,5432,1226,9339,241,117,124
14315,11095,1752,5434,1226,9343,241,117,124
14320,11098,1752,5437,1226,9346,241,117,124
14325,11099,1753,5438,1227,9346,241,117,124
14330,11104,1754,5440,1228,9349,241,117,124
14335,11106,1756,5440,1229,9350,241,117,124
14340,11114,1756,5444,1229,9358,241,117,124
14345,11117,1756,5446,1229,9361,241,117,124
14350,11122,1756,5449,1229,9366,241,117,124
14355,11126,1756,5450,1229,9369,241,117,124
14360,11129,1757,5453,1230,9372,241,117,124
14365,11130,1758,5454,1231,9372,241,117,124
14370,11135,1759,5456,1231,9375,241,117,124
14375,11137,1761,5456,1232,9376,241,117,124
14380,11145,1761,5461,1232,9384,241,117,124
14385,11148,1761,5462,1232,9387,241,117,124
14390,11153,1762,5466,1232,9391,242,118,124
14395,11157,1762,5466,1232,9395,242,118,124
14400,11160,1763,5468,1233,9397,242,118,124
14405,11161,1763,5469,1233,9398,242,118,124
14410,11166,1763,5471,1233,9403,242,118,124
14415,11168,1763,5472,1233,9405,242,118,124
14420,11176,1763,5474,1233,9413,242,118,124
14425,11179,1763,5475,1233,9416,242,118,124
14430,11184,1764,5477,1233,9420,242,118,124
14435,11188,1764,5479,1233,9424,242,118,124
14440,11191,1764,5480,1233,9427,242,118,124
14445,11192,1764,5481,1233,9428,242,118,124
14450,11197,1764,5485,1233,9433,242,118,124
14455,11199,1764,5486,1233,9435,242,118,124
14460,11207,1764,5489,1233,9443,242,118,124
14465,11210,1764,5492,1233,9446,242,118,124
14470,11215,1765,5494,1234,9450,242,118,124
14475,11219,1765,5497,1234,9454,242,118,124
14480,11222,1765,5499,1234,9457,242,118,124
14485,11223,1765,5499,1234,9458,242,118,124
14490,11228,1765,5503,1234,9463,242,118,124
14495,11230,1765,5503,1234,9465,242,118,124
14500,11238,1765,5509,1234,9473,242,118,124
14505,11241,1765,5511,1234,9476,242,118,124
14510,11246,1767,5513,1235,9479,242,118,124
14515,11250,1768,5515,1236,9482,242,118,124
14520,11253,1769,5518,1237,9484,242,118,124
14525,11254,1769,5519,1237,9485,242,118,124
14530,11259,1770,5523,1237,9489,242,118,124
14535,11261,1770,5524,1237,9491,242,118,124
14540,11269,1772,5529,1238,9497,242,118,124
14545,11272,1772,5530,1238,9500,242,118,124
14550,11277,1773,5532,1239,9504,243,118,125
14555,11281,1773,5533,1239,9508,243,118,125
14560,11284,1773,5536,1239,9511,243,118,125
14565,11285,1773,5537,1239,9512,243,118,125
14570,11290,1774,5538,1239,9516,243,118,125
14575,11292,1774,5539,1239,9518,243,118,125
14580,11300,1775,5542,1240,9525,243,118,125
14585,11303,1775,5543,1240,9528,243,118,125
14590,11308,1776,5544,1240,9532,244,118,126
14595,11312,1776,5547,1240,9535,244,118,126
14600,11315,1777,5550,1241,9538,244,118,126
14605,11316,1777,5551,1241,9539,244,118,126
14610,11321,1778,5553,1241,9543,244,118,126
14615,11323,1778,5553,1241,9545,244,118,126
14620,11331,1779,5557,1242,9552,244,118,126
14625,11334,1779,5559,1242,9555,244,118,126
14630,11339,1780,5561,1242,9559,245,119,126
14635,11343,1780,5563,1242,9562,245,119,126
14640,11346,1781,5563,1243,9565,245,119,126
14645,11347,1781,5563,1243,9566,245,119,126
14650,11352,1782,5565,1243,9569,245,119,126
14655,11354,1784,5566,1244,9570,245,119,126
14660,11362,1785,5567,1244,9577,245,119,126
14665,11365,1785,5569,1244,9580,245,119,126
14670,11370,1785,5571,1244,9585,245,119,126
14675,11374,1785,5573,1244,9589,245,119,126
14680,11377,1785,5574,1244,9592,245,119,126
14685,11378,1785,5574,1244,9593,245,119,126
14690,11383,1786,5576,1245,9597,245,119,126
14695,11385,1787,5577,1245,9598,245,119,126
14700,11393,1788,5581,1245,9605,245,119,126
14705,11396,1788,5583,1245,9608,245,119,126
14710,11401,1788,5584,1245,9613,245,119,126
14715,11405,1788,5585,1245,9617,245,119,126
14720,11408,1788,5587,1245,9620,245,119,126
14725,11409,1789,5588,1246,9620,245,119,126
14730,11414,1790,5590,1246,9623,245,119,126
14735,11416,1792,5591,1247,9624,245,119,126
14740,11424,1793,5593,1248,9631,245,119,126
14745,11427,1793,5594,1248,9634,245,119,126
14750,11432,1794,5596,1248,9638,246,119,127
14755,11436,1794,5597,1248,9641,246,119,127
14760,11439,1796,5599,1250,9643,246,119,127
14765,11440,1796,5600,1250,9644,246,119,127
14770,11445,1796,5604,1250,9649,246,119,127
14775,11447,1796,5605,1250,9651,246,119,127
14780,11455,1797,5607,1251,9658,246,119,127
14785,11458,1797,5608,1251,9661,246,119,127
14790,11463,1798,5611,1252,9665,247,120,127
14795,11467,1798,5614,1252,9669,247,120,127
14800,11470,1798,5616,1252,9672,247,120,127
14805,11471,1798,5616,1252,9673,247,120,127
14810,11476,1798,5619,1252,9678,247,120,127
14815,11478,1798,5620,1252,9680,247,120,127
14820,11486,1800,5623,1254,9686,247,120,127
14825,11489,1800,5626,1254,9689,247,120,127
14830,11494,1801,5629,1255,9693,247,120,127
14835,11498,1801,5629,1255,9697,247,120,127
14840,11501,1801,5631,1255,9700,247,120,127
14845,11502,1801,5631,1255,9701,247,120,127
14850,11507,1801,5633,1255,9706,247,120,127
14855,11509,1801,5635,1255,9708,247,120,127
14860,11517,1803,5636,1256,9714,247,120,127
14865,11520,1803,5637,1256,9717,247,120,127
14870,11525,1804,5639,1256,9721,247,120,127
14875,11529,1804,5641,1256,9725,247,120,127
14880,11532,1804,5641,1256,9728,247,120,127
14885,11533,1804,5641,1256,9729,247,120,127
14890,11538,1805,5643,1256,9733,247,120,127
14895,11540,1806,5644,1257,9734,247,120,127
14900,11548,1806,5644,1257,9742,247,120,127
14905,11551,1807,5645,1258,9744,247,120,127
14910,11556,1809,5649,1260,9747,247,120,127
14915,11560,1809,5650,1260,9750,247,120,127
14920,11563,1810,5652,1261,9753,247,120,127
14925,11564,1810,5652,1261,9754,247,120,127
14930,11569,1811,5653,1261,9758,247,120,127
14935,11571,1812,5653,1261,9759,247,120,127
14940,11579,1812,5656,1261,9767,247,120,127
14945,11582,1812,5656,1261,9770,247,120,127
14950,11587,1814,5658,1262,9773,247,120,127
14955,11591,1814,5659,1262,9777,247,120,127
14960,11594,1814,5661,1262,9780,247,120,127
14965,11595,1814,5661,1262,9781,247,120,127
14970,11600,1815,5663,1263,9785,247,120,127
14975,11602,1816,5665,1264,9786,247,120,127
14980,11610,1816,5668,1264,9794,247,120,127
14985,11613,1817,5670,1265,9796,247,120,127
14990,11618,1819,5673,1266,9799,248,121,127
14995,11622,1819,5675,1266,9802,248,121,127
15000,11625,1820,5675,1267,9805,248,121,127
15005,11626,1820,5676,1267,9806,248,121,127
15010,11631,1820,5678,1267,9811,248,121,127
15015,11633,1820,5679,1267,9813,248,121,127
15020,11641,1821,5683,1268,9820,248,121,127
15025,11644,1821,5684,1268,9823,248,121,127
15030,11649,1822,5687,1269,9827,249,121,128
15035,11653,1822,5689,1269,9831,249,121,128
15040,11656,1823,5691,1270,9833,249,121,128
15045,11657,1823,5691,1270,9834,249,121,128
15050,11662,1823,5691,1270,9839,249,121,128
15055,11664,1823,5692,1270,9841,249,121,128
15060,11672,1825,5697,1272,9847,249,121,128
15065,11675,1825,5698,1272,9850,249,121,128
15070,11680,1826,5700,1273,9854,249,121,128
15075,11684,1827,5703,1274,9857,249,121,128
15080,11687,1828,5704,1275,9859,249,121,128
15085,11688,1828,5704,1275,9860,249,121,128
15090,11693,1828,5705,1275,9865,249,121,128
15095,11695,1828,5705,1275,9867,249,121,128
15100,11703,1829,5707,1275,9874,249,121,128
15105,11706,1829,5709,1275,9877,249,121,128
15110,11711,1830,5713,1275,9881,249,121,128
15115,11715,1831,5717,1276,9883,249,121,128
15120,11718,1832,5718,1277,9886,249,121,128
15125,11719,1833,5719,1278,9886,249,121,128
15130,11724,1834,5720,1278,9890,249,121,128
15135,11726,1835,5720,1278,9891,249,121,128
15140,11734,1835,5725,1278,9899,249,121,128
15145,11737,1835,5728,1278,9902,249,121,128
15150,11742,1835,5731,1278,9907,249,121,128
15155,11746,1835,5733,1278,9910,249,121,128
15160,11749,1836,5735,1279,9913,249,121,128
15165,11750,1837,5736,1280,9913,249,121,128
15170,11755,1838,5739,1281,9916,249,121,128
15175,11757,1840,5740,1283,9917,249,121,128
15180,11765,1840,5744,1283,9925,249,121,128
15185,11768,1840,5745,1283,9928,249,121,128
15190,11773,1840,5747,1283,9933,249,121,128
15195,11777,1840,5749,1283,9936,249,121,128
15200,11780,1841,5750,1284,9939,249,121,128
15205,11781,1841,5750,1284,9940,249,121,128
15210,11786,1842,5753,1284,9943,249,121,128
15215,11788,1844,5753,1285,9944,249,121,128
15220,11796,1844,5756,1285,9952,249,121,128
15225,11799,1844,5758,1285,9955,249,121,128
15230,11804,1845,5759,1285,9959,250,121,129
15235,11808,1845,5759,1285,9963,250,121,129
15240,11811,1845,5760,1285,9966,250,121,129
15245,11812,1845,5760,1285,9967,250,121,129
15250,11817,1845,5762,1285,9972,250,121,129
15255,11819,1845,5764,1285,9974,250,121,129
15260,11827,1845,5768,1285,9982,250,121,129
15265,11830,1845,5771,1285,9985,250,121,129
15270,11835,1846,5775,1286,9989,250,121,129
15275,11839,1846,5775,1286,9993,250,121,129
15280,11842,1846,5777,1286,9996,250,121,129
15285,11843,1846,5777,1286,9997,250,121,129
15290,11848,1846,5779,1286,10002,250,121,129
15295,11850,1846,5780,1286,10004,250,121,129
15300,11858,1846,5783,1286,10012,250,121,129
15305,11861,1846,5786,1286,10015,250,121,129
15310,11866,1847,5790,1287,10019,251,122,129
15315,11870,1847,5793,1287,10022,251,122,129
15320,11873,1848,5793,1288,10025,251,122,129
15325,11874,1848,5793,1288,10026,251,122,129
15330,11879,1848,5797,1288,10031,251,122,129
15335,11881,1848,5798,1288,10033,251,122,129
15340,11889,1848,5803,1288,10041,251,122,129
15345,11892,1848,5805,1288,10044,251,122,129
15350,11897,1849,5808,1289,10048,252,122,130
15355,11901,1850,5811,1290,10050,252,122,130
15360,11904,1852,5813,1292,10052,252,122,130
15365,11905,1852,5813,1292,10053,252,122,130
15370,11910,1853,5815,1292,10057,252,122,130
15375,11912,1853,5816,1292,10059,252,122,130
15380,11920,1855,5823,1294,10065,252,122,130
15385,11923,1855,5825,1294,10068,252,122,130
15390,11928,1855,5827,1294,10073,252,122,130
15395,11932,1855,5829,1294,10077,252,122,130
15400,11935,1855,5830,1294,10080,252,122,130
15405,11936,1856,5831,1295,10080,252,122,130
15410,11941,1857,5832,1296,10084,252,122,130
15415,11943,1857,5832,1296,10086,252,122,130
15420,11951,1859,5837,1298,10092,252,122,130
15425,11954,1859,5838,1298,10095,252,122,130
15430,11959,1859,5841,1298,10100,252,122,130
15435,11963,1859,5843,1298,10104,252,122,130
15440,11966,1859,5845,1298,10107,252,122,130
15445,11967,1860,5846,1299,10107,252,122,130
15450,11972,1861,5846,1299,10111,252,122,130
15455,11974,1861,5847,1299,10113,252,122,130
15460,11982,1863,5851,1300,10119,253,123,130
15465,11985,1863,5853,1300,10122,253,123,130
15470,11990,1864,5856,1301,10126,254,123,131
15475,11994,1864,5857,1301,10130,254,123,131
15480,11997,1864,5857,1301,10133,254,123,131
15485,11998,1864,5857,1301,10134,254,123,131
15490,12003,1864,5860,1301,10139,254,123,131
15495,12005,1865,5862,1302,10140,254,123,131
15500,12013,1865,5866,1302,10148,254,123,131
15505,12016,1865,5868,1302,10151,254,123,131
15510,12021,1866,5870,1303,10155,255,123,132
15515,12025,1866,5873,1303,10158,255,123,132
15520,12028,1867,5875,1304,10161,255,123,132
15525,12029,1867,5876,1304,10162,255,123,132
15530,12034,1867,5878,1304,10166,255,123,132
15535,12036,1869,5879,1306,10167,255,123,132
15540,12044,1869,5883,1306,10175,255,123,132
15545,12047,1869,5885,1306,10178,255,123,132
15550,12052,1870,5885,1306,10182,256,123,133
15555,12056,1870,5887,1306,10186,256,123,133
15560,12059,1870,5890,1306,10189,256,123,133
15565,12060,1870,5891,1306,10190,256,123,133
15570,12065,1870,5894,1306,10195,256,123,133
15575,12067,1871,5895,1307,10196,256,123,133
15580,12075,1871,5899,1307,10204,256,123,133
15585,12078,1871,5901,1307,10207,256,123,133
15590,12083,1873,5904,1309,10210,257,124,133
15595,12087,1873,5905,1309,10214,257,124,133
15600,12090,1874,5908,1310,10216,257,124,133
15605,12091,1874,5909,1310,10217,257,124,133
15610,12096,1875,5914,1311,10221,257,124,133
15615,12098,1875,5914,1311,10223,257,124,133
15620,12106,1876,5917,1311,10230,257,124,133
15625,12109,1877,5918,1312,10232,257,124,133
15630,12114,1878,5919,1312,10236,257,124,133
15635,12118,1878,5921,1312,10240,257,124,133
15640,12121,1878,5924,1312,10243,257,124,133
15645,12122,1878,5925,1312,10244,257,124,133
15650,12127,1879,5929,1313,10248,257,124,133
15655,12129,1879,5930,1313,10250,257,124,133
15660,12137,1880,5936,1313,10256,257,124,133
15665,12140,1881,5937,1314,10259,257,124,133
15670,12145,1882,5939,1315,10263,257,124,133
15675,12149,1882,5939,1315,10267,257,124,133
15680,12152,1882,5941,1315,10270,257,124,133
15685,12153,1882,5941,1315,10271,257,124,133
15690,12158,1883,5944,1316,10275,257,124,133
15695,12160,1883,5944,1316,10277,257,124,133
15700,12168,1884,5949,1316,10283,257,124,133
15705,12171,1886,5951,1318,10285,257,124,133
15710,12176,1887,5953,1319,10289,258,124,134
15715,12180,1888,5955,1320,10292,258,124,134
15720,12183,1888,5956,1320,10295,258,124,134
15725,12184,1889,5957,1321,10295,258,124,134
15730,12189,1890,5959,1321,10298,258,124,134
15735,12191,1892,5959,1322,10299,258,124,134
15740,12199,1893,5960,1323,10306,258,124,134
15745,12202,1893,5961,1323,10309,258,124,134
15750,12207,1894,5966,1324,10313,259,125,134
15755,12211,1894,5966,1324,10317,259,125,134
15760,12214,1894,5967,1324,10320,259,125,134
15765,12215,1895,5968,1325,10320,259,125,134
15770,12220,1896,5972,1326,10323,259,125,134
15775,12222,1898,5973,1327,10324,259,125,134
15780,12230,1899,5978,1328,10331,259,125,134
15785,12233,1899,5978,1328,10334,259,125,134
15790,12238,1900,5981,1329,10338,259,125,134
15795,12242,1900,5984,1329,10341,259,125,134
15800,12245,1901,5986,1330,10344,259,125,134
15805,12246,1902,5987,1331,10344,259,125,134
15810,12251,1903,5987,1331,10348,259,125,134
15815,12253,1904,5989,1332,10349,259,125,134
15820,12261,1904,5992,1332,10357,259,125,134
15825,12264,1904,5992,1332,10360,259,125,134
15830,12269,1905,5992,1332,10364,259,125,134
15835,12273,1905,5993,1332,10368,259,125,134
15840,12276,1906,5995,1333,10370,259,125,134
15845,12277,1906,5995,1333,10371,259,125,134
15850,12282,1906,5996,1333,10376,259,125,134
15855,12284,1906,5996,1333,10378,259,125,134
15860,12292,1907,6001,1334,10385,259,125,134
15865,12295,1907,6002,1334,10388,259,125,134
15870,12300,1907,6003,1334,10393,259,125,134
15875,12304,1907,6004,1334,10397,259,125,134
15880,12307,1907,6005,1334,10400,259,125,134
15885,12308,1907,6005,1334,10401,259,125,134
15890,12313,1907,6006,1334,10406,259,125,134
15895,12315,1907,6006,1334,10408,259,125,134
15900,12323,1908,6010,1335,10415,259,125,134
15905,12326,1908,6012,1335,10418,259,125,134
15910,12331,1908,6015,1335,10423,259,125,134
15915,12335,1908,6016,1335,10427,259,125,134
15920,12338,1908,6018,1335,10430,259,125,134
15925,12339,1908,6018,1335,10431,259,125,134
15930,12344,1908,6020,1335,10436,259,125,134
15935,12346,1908,6022,1335,10438,259,125,134
15940,12354,1909,6024,1335,10445,259,125,134
15945,12357,1909,6024,1335,10448,259,125,134
15950,12362,1910,6025,1336,10452,259,125,134
15955,12366,1910,6026,1336,10455,259,125,134
15960,12369,1912,6028,1338,10457,259,125,134
15965,12370,1912,6028,1338,10458,259,125,134
15970,12375,1913,6031,1339,10462,259,125,134
15975,12377,1913,6031,1339,10464,259,125,134
15980,12385,1914,6032,1339,10471,259,125,134
15985,12388,1914,6032,1339,10474,259,125,134
15990,12393,1914,6033,1339,10479,260,125,135
15995,12397,1914,6036,1339,10483,260,125,135
16000,12400,1914,6036,1339,10486,260,125,135
16005,12401,1914,6036,1339,10487,260,125,135
16010,12406,1915,6038,1339,10491,260,125,135
16015,12408,1915,6040,1339,10493,260,125,135
16020,12416,1916,6042,1339,10500,260,125,135
16025,12419,1916,6044,1339,10503,260,125,135
16030,12424,1916,6045,1339,10508,261,125,136
16035,12428,1916,6046,1339,10511,261,125,136
16040,12431,1917,6048,1340,10514,261,125,136
16045,12432,1917,6048,1340,10515,261,125,136
16050,12437,1918,6050,1341,10519,261,125,136
16055,12439,1918,6051,1341,10521,261,125,136
16060,12447,1920,6054,1342,10527,261,125,136
16065,12450,1920,6055,1342,10530,261,125,136
16070,12455,1922,6060,1344,10533,262,126,136
16075,12459,1922,6063,1344,10536,262,126,136
16080,12462,1923,6065,1345,10539,262,126,136
16085,12463,1923,6065,1345,10540,262,126,136
16090,12468,1923,6065,1345,10545,262,126,136
16095,12470,1924,6065,1345,10546,262,126,136
16100,12478,1924,6066,1345,10554,262,126,136
16105,12481,1924,6068,1345,10557,262,126,136
16110,12486,1925,6072,1346,10561,262,126,136
16115,12490,1925,6074,1346,10565,262,126,136
16120,12493,1925,6076,1346,10568,262,126,136
16125,12494,1925,6076,1346,10569,262,126,136
16130,12499,1925,6078,1346,10574,262,126,136
16135,12501,1926,6080,1347,10575,262,126,136
16140,12509,1926,6083,1347,10583,262,126,136
16145,12512,1926,6084,1347,10586,262,126,136
16150,12517,1927,6084,1347,10590,262,126,136
16155,12521,1927,6085,1347,10594,262,126,136
16160,12524,1927,6088,1347,10597,262,126,136
16165,12525,1927,6088,1347,10598,262,126,136
16170,12530,1927,6091,1347,10602,262,126,136
16175,12532,1929,6092,1349,10603,262,126,136
16180,12540,1929,6096,1349,10611,263,126,137
16185,12543,1929,6097,1349,10614,263,126,137
16190,12548,1931,6101,1351,10617,263,126,137
16195,12552,1931,6102,1351,10620,263,126,137
16200,12555,1932,6102,1352,10623,263,126,137
16205,12556,1932,6102,1352,10624,263,126,137
16210,12561,1933,6104,1352,10627,263,126,137
16215,12563,1935,6106,1354,10628,263,126,137
16220,12571,1936,6109,1354,10635,263,126,137
16225,12574,1936,6110,1354,10638,263,126,137
16230,12579,1937,6113,1355,10642,263,126,137
16235,12583,1937,6116,1355,10645,263,126,137
16240,12586,1938,6117,1356,10648,263,126,137
16245,12587,1939,6118,1357,10648,263,126,137
16250,12592,1940,6119,1357,10652,263,126,137
16255,12594,1941,6120,1357,10653,263,126,137
16260,12602,1942,6125,1358,10660,263,126,137
16265,12605,1942,6127,1358,10663,263,126,137
16270,12610,1943,6130,1359,10667,264,127,137
16275,12614,1943,6132,1359,10670,264,127,137
16280,12617,1944,6134,1360,10673,264,127,137
16285,12618,1944,6134,1360,10674,264,127,137
16290,12623,1945,6136,1360,10678,264,127,137
16295,12625,1946,6138,1361,10679,264,127,137
16300,12633,1947,6143,1361,10686,264,127,137
16305,12636,1947,6144,1361,10689,264,127,137
16310,12641,1948,6147,1362,10693,264,127,137
16315,12645,1948,6148,1362,10697,264,127,137
16320,12648,1949,6149,1363,10699,264,127,137
16325,12649,1949,6149,1363,10700,264,127,137
16330,12654,1950,6152,1364,10704,264,127,137
16335,12656,1950,6152,1364,10706,264,127,137
16340,12664,1951,6155,1365,10713,264,127,137
16345,12667,1952,6158,1366,10715,264,127,137
16350,12672,1953,6159,1366,10719,265,128,137
16355,12676,1953,6162,1366,10723,265,128,137
16360,12679,1953,6163,1366,10726,265,128,137
16365,12680,1954,6164,1367,10726,265,128,137
16370,12685,1955,6167,1368,10730,265,128,137
16375,12687,1955,6168,1368,10732,265,128,137
16380,12695,1956,6171,1368,10739,265,128,137
16385,12698,1957,6174,1369,10741,265,128,137
16390,12703,1958,6175,1369,10745,266,128,138
16395,12707,1958,6175,1369,10749,266,128,138
16400,12710,1959,6177,1370,10751,266,128,138
16405,12711,1959,6177,1370,10752,266,128,138
16410,12716,1960,6179,1371,10756,266,128,138
16415,12718,1960,6179,1371,10758,266,128,138
16420,12726,1962,6181,1372,10764,266,128,138
16425,12729,1963,6183,1373,10766,266,128,138
16430,12734,1964,6186,1374,10770,267,129,138
16435,12738,1965,6188,1375,10772,267,129,138
16440,12741,1966,6188,1376,10775,267,129,138
16445,12742,1967,6189,1377,10775,267,129,138
16450,12747,1968,6189,1377,10779,267,129,138
16455,12749,1969,6189,1377,10780,267,129,138
16460,12757,1969,6190,1377,10788,267,129,138
16465,12760,1969,6192,1377,10791,267,129,138
16470,12765,1970,6195,1378,10795,267,129,138
16475,12769,1970,6197,1378,10799,267,129,138
16480,12772,1970,6198,1378,10802,267,129,138
16485,12773,1971,6199,1379,10802,267,129,138
16490,12778,1972,6200,1379,10806,267,129,138
16495,12780,1973,6201,1379,10807,267,129,138
16500,12788,1974,6206,1380,10814,267,129,138
16505,12791,1974,6207,1380,10817,267,129,138
16510,12796,1975,6210,1380,10821,267,129,138
16515,12800,1975,6213,1380,10824,267,129,138
16520,12803,1976,6214,1381,10827,267,129,138
16525,12804,1976,6214,1381,10828,267,129,138
16530,12809,1976,6216,1381,10833,267,129,138
16535,12811,1977,6217,1381,10834,267,129,138
16540,12819,1977,6220,1381,10842,267,129,138
16545,12822,1977,6222,1381,10845,267,129,138
16550,12827,1979,6226,1383,10848,268,130,138
16555,12831,1979,6228,1383,10851,268,130,138
16560,12834,1981,6230,1385,10853,268,130,138
16565,12835,1981,6230,1385,10854,268,130,138
16570,12840,1982,6232,1386,10858,268,130,138
16575,12842,1982,6234,1386,10860,268,130,138
16580,12850,1984,6239,1387,10866,268,130,138
16585,12853,1984,6241,1387,10869,268,130,138
16590,12858,1985,6243,1388,10873,268,130,138
16595,12862,1985,6244,1388,10877,268,130,138
16600,12865,1985,6247,1388,10880,268,130,138
16605,12866,1985,6247,1388,10881,268,130,138
16610,12871,1986,6251,1388,10885,268,130,138
16615,12873,1986,6252,1388,10887,268,130,138
16620,12881,1989,6256,1391,10892,268,130,138
16625,12884,1989,6258,1391,10895,268,130,138
16630,12889,1990,6260,1391,10899,268,130,138
16635,12893,1990,6262,1391,10903,268,130,138
16640,12896,1990,6263,1391,10906,268,130,138
16645,12897,1990,6264,1391,10907,268,130,138
16650,12902,1990,6266,1391,10912,268,130,138
16655,12904,1990,6267,1391,10914,268,130,138
16660,12912,1991,6271,1391,10921,268,130,138
16665,12915,1991,6272,1391,10924,268,130,138
16670,12920,1992,6273,1391,10928,269,131,138
16675,12924,1992,6275,1391,10932,269,131,138
16680,12927,1992,6275,1391,10935,269,131,138
16685,12928,1992,6275,1391,10936,269,131,138
16690,12933,1992,6278,1391,10941,269,131,138
16695,12935,1992,6280,1391,10943,269,131,138
16700,12943,1993,6283,1391,10950,269,131,138
16705,12946,1993,6285,1391,10953,269,131,138
16710,12951,1993,6287,1391,10958,269,131,138
16715,12955,1993,6290,1391,10962,269,131,138
16720,12958,1993,6292,1391,10965,269,131,138
16725,12959,1993,6292,1391,10966,269,131,138
16730,12964,1994,6294,1391,10970,269,131,138
16735,12966,1994,6296,1391,10972,269,131,138
16740,12974,1996,6301,1392,10978,269,131,138
16745,12977,1996,6303,1392,10981,269,131,138
16750,12982,1997,6307,1393,10985,269,131,138
16755,12986,1997,6310,1393,10988,269,131,138
16760,12989,1998,6311,1394,10991,269,131,138
16765,12990,1999,6312,1395,10991,269,131,138
16770,12995,2000,6315,1396,10995,269,131,138
16775,12997,2000,6317,1396,10997,269,131,138
16780,13005,2001,6321,1396,11004,269,131,138
16785,13008,2001,6323,1396,11007,269,131,138
16790,13013,2003,6325,1397,11010,270,131,139
16795,13017,2004,6328,1398,11012,270,131,139
16800,13020,2005,6328,1399,11015,270,131,139
16805,13021,2006,6329,1400,11015,270,131,139
16810,13026,2007,6332,1401,11019,270,131,139
16815,13028,2007,6334,1401,11021,270,131,139
16820,13036,2008,6339,1401,11028,270,131,139
16825,13039,2008,6341,1401,11031,270,131,139
16830,13044,2008,6344,1401,11036,271,132,139
16835,13048,2008,6346,1401,11040,271,132,139
16840,13051,2008,6348,1401,11043,271,132,139
16845,13052,2009,6349,1402,11043,271,132,139
16850,13057,2010,6352,1403,11047,271,132,139
16855,13059,2010,6353,1403,11049,271,132,139
16860,13067,2012,6358,1405,11055,271,132,139
16865,13070,2012,6358,1405,11058,271,132,139
16870,13075,2012,6361,1405,11063,271,132,139
16875,13079,2012,6363,1405,11067,271,132,139
16880,13082,2012,6364,1405,11070,271,132,139
16885,13083,2012,6364,1405,11071,271,132,139
16890,13088,2012,6366,1405,11076,271,132,139
16895,13090,2012,6367,1405,11078,271,132,139
16900,13098,2013,6368,1405,11085,271,132,139
16905,13101,2013,6368,1405,11088,271,132,139
16910,13106,2015,6371,1406,11091,271,132,139
16915,13110,2015,6373,1406,11094,271,132,139
16920,13113,2016,6373,1407,11097,271,132,139
16925,13114,2016,6373,1407,11098,271,132,139
16930,13119,2016,6376,1407,11103,271,132,139
16935,13121,2017,6377,1408,11104,271,132,139
16940,13129,2019,6382,1410,11110,271,132,139
16945,13132,2019,6384,1410,11113,271,132,139
16950,13137,2020,6386,1411,11117,271,132,139
16955,13141,2020,6387,1411,11121,271,132,139
16960,13144,2020,6387,1411,11124,271,132,139
16965,13145,2020,6387,1411,11125,271,132,139
16970,13150,2021,6389,1412,11129,271,132,139
16975,13152,2022,6390,1413,11130,271,132,139
16980,13160,2024,6394,1415,11136,271,132,139
16985,13163,2024,6395,1415,11139,271,132,139
16990,13168,2025,6398,1416,11143,271,132,139
16995,13172,2025,6399,1416,11147,271,132,139
17000,13175,2025,6402,1416,11150,271,132,139
17005,13176,2025,6402,1416,11151,271,132,139
17010,13181,2026,6405,1416,11154,271,132,139
17015,13183,2028,6407,1418,11155,271,132,139
17020,13191,2030,6410,1420,11161,271,132,139
17025,13194,2030,6413,1420,11164,271,132,139
17030,13199,2031,6414,1421,11168,271,132,139
17035,13203,2031,6416,1421,11172,271,132,139
17040,13206,2031,6417,1421,11175,271,132,139
17045,13207,2031,6417,1421,11176,271,132,139
17050,13212,2032,6420,1422,11180,271,132,139
17055,13214,2032,6421,1422,11182,271,132,139
17060,13222,2033,6423,1422,11189,271,132,139
17065,13225,2033,6424,1422,11192,271,132,139
17070,13230,2034,6427,1423,11196,272,133,139
17075,13234,2035,6430,1424,11199,272,133,139
17080,13237,2036,6432,1425,11201,272,133,139
17085,13238,2036,6432,1425,11202,272,133,139
17090,13243,2037,6433,1425,11206,272,133,139
17095,13245,2037,6434,1425,11208,272,133,139
17100,13253,2038,6440,1426,11215,272,133,139
17105,13256,2038,6442,1426,11218,272,133,139
17110,13261,2038,6443,1426,11223,273,133,140
17115,13265,2038,6445,1426,11227,273,133,140
17120,13268,2038,6445,1426,11230,273,133,140
17125,13269,2038,6445,1426,11231,273,133,140
17130,13274,2039,6446,1426,11235,273,133,140
17135,13276,2039,6446,1426,11237,273,133,140
17140,13284,2040,6449,1426,11244,273,133,140
17145,13287,2040,6451,1426,11247,273,133,140
17150,13292,2040,6453,1426,11252,274,134,140
17155,13296,2040,6455,1426,11256,274,134,140
17160,13299,2040,6457,1426,11259,274,134,140
17165,13300,2040,6458,1426,11260,274,134,140
17170,13305,2041,6462,1427,11263,274,134,140
17175,13307,2043,6463,1428,11264,274,134,140
17180,13315,2044,6465,1429,11271,274,134,140
17185,13318,2045,6466,1430,11273,274,134,140
17190,13323,2045,6468,1430,11278,274,134,140
17195,13327,2046,6472,1431,11280,274,134,140
17200,13330,2048,6474,1433,11282,274,134,140
17205,13331,2049,6475,1434,11282,274,134,140
17210,13336,2050,6479,1435,11285,274,134,140
17215,13338,2052,6480,1436,11286,274,134,140
17220,13346,2055,6486,1439,11290,274,134,140
17225,13349,2056,6488,1440,11293,274,134,140
17230,13354,2057,6490,1441,11297,274,134,140
17235,13358,2057,6490,1441,11301,274,134,140
17240,13361,2057,6491,1441,11304,274,134,140
17245,13362,2058,6492,1442,11304,274,134,140
17250,13367,2059,6495,1443,11308,274,134,140
17255,13369,2059,6496,1443,11310,274,134,140
17260,13377,2060,6501,1444,11317,274,134,140
17265,13380,2060,6502,1444,11320,274,134,140
17270,13385,2061,6503,1444,11324,274,134,140
17275,13389,2061,6504,1444,11328,274,134,140
17280,13392,2061,6507,1444,11331,274,134,140
17285,13393,2061,6507,1444,11332,274,134,140
17290,13398,2062,6511,1445,11336,274,134,140
17295,13400,2062,6513,1445,11338,274,134,140
17300,13408,2063,6517,1445,11345,274,134,140
17305,13411,2063,6519,1445,11348,274,134,140
17310,13416,2064,6523,1446,11352,274,134,140
17315,13420,2064,6526,1446,11355,274,134,140
17320,13423,2065,6528,1447,11358,274,134,140
17325,13424,2066,6529,1448,11358,274,134,140
17330,13429,2067,6530,1448,11362,274,134,140
17335,13431,2068,6531,1449,11363,274,134,140
17340,13439,2070,6536,1450,11368,274,134,140
17345,13442,2071,6538,1451,11371,274,134,140
17350,13447,2071,6538,1451,11376,275,134,141
17355,13451,2071,6541,1451,11380,275,134,141
17360,13454,2071,6541,1451,11383,275,134,141
17365,13455,2071,6541,1451,11384,275,134,141
17370,13460,2072,6544,1451,11388,275,134,141
17375,13462,2072,6545,1451,11390,275,134,141
17380,13470,2073,6550,1452,11397,275,134,141
17385,13473,2073,6553,1452,11400,275,134,141
17390,13478,2073,6555,1452,11405,275,134,141
17395,13482,2073,6556,1452,11409,275,134,141
17400,13485,2073,6556,1452,11412,275,134,141
17405,13486,2073,6556,1452,11413,275,134,141
17410,13491,2074,6558,1452,11417,275,134,141
17415,13493,2074,6560,1452,11419,275,134,141
17420,13501,2075,6563,1452,11426,275,134,141
17425,13504,2075,6566,1452,11429,275,134,141
17430,13509,2075,6568,1452,11434,275,134,141
17435,13513,2075,6570,1452,11437,275,134,141
17440,13516,2076,6572,1453,11440,275,134,141
17445,13517,2076,6573,1453,11441,275,134,141
17450,13522,2077,6575,1453,11445,275,134,141
17455,13524,2078,6577,1454,11446,275,134,141
17460,13532,2081,6582,1456,11450,275,134,141
17465,13535,2082,6585,1457,11453,275,134,141
17470,13540,2083,6589,1457,11457,275,134,141
17475,13544,2083,6590,1457,11461,275,134,141
17480,13547,2083,6590,1457,11464,275,134,141
17485,13548,2083,6591,1457,11465,275,134,141
17490,13553,2084,6592,1458,11469,275,134,141
17495,13555,2084,6594,1458,11471,275,134,141
17500,13563,2086,6598,1459,11477,275,134,141
17505,13566,2086,6600,1459,11480,275,134,141
17510,13571,2087,6603,1459,11484,275,134,141
17515,13575,2087,6605,1459,11488,275,134,141
17520,13578,2087,6607,1459,11491,275,134,141
17525,13579,2088,6608,1460,11491,275,134,141
17530,13584,2089,6612,1461,11495,275,134,141
17535,13586,2089,6613,1461,11497,275,134,141
17540,13594,2090,6616,1462,11504,275,134,141
17545,13597,2090,6618,1462,11507,275,134,141
17550,13602,2091,6621,1462,11511,275,134,141
17555,13606,2091,6622,1462,11515,275,134,141
17560,13609,2091,6623,1462,11518,275,134,141
17565,13610,2091,6623,1462,11519,275,134,141
17570,13615,2092,6624,1463,11523,275,134,141
17575,13617,2093,6626,1464,11524,275,134,141
17580,13625,2094,6628,1464,11531,275,134,141
17585,13628,2094,6631,1464,11534,275,134,141
17590,13633,2095,6634,1464,11538,276,135,141
17595,13637,2095,6634,1464,11542,276,135,141
17600,13640,2095,6635,1464,11545,276,135,141
17605,13641,2095,6635,1464,11546,276,135,141
17610,13646,2096,6638,1464,11549,276,135,141
17615,13648,2098,6639,1466,11550,276,135,141
17620,13656,2100,6642,1467,11556,276,135,141
17625,13659,2100,6643,1467,11559,276,135,141
17630,13664,2101,6647,1467,11563,277,136,141
17635,13668,2101,6647,1467,11567,277,136,141
17640,13671,2102,6649,1468,11569,277,136,141
17645,13672,2103,6650,1469,11569,277,136,141
17650,13677,2104,6652,1469,11573,277,136,141
17655,13679,2104,6653,1469,11575,277,136,141
17660,13687,2106,6658,1470,11581,277,136,141
17665,13690,2106,6659,1470,11584,277,136,141
17670,13695,2106,6661,1470,11589,277,136,141
17675,13699,2106,6664,1470,11593,277,136,141
17680,13702,2106,6664,1470,11596,277,136,141
17685,13703,2107,6665,1471,11596,277,136,141
17690,13708,2108,6667,1472,11600,277,136,141
17695,13710,2108,6667,1472,11602,277,136,141
17700,13718,2109,6669,1473,11608,277,136,141
17705,13721,2110,6671,1474,11611,277,136,141
17710,13726,2110,6673,1474,11616,277,136,141
17715,13730,2110,6673,1474,11620,277,136,141
17720,13733,2110,6674,1474,11623,277,136,141
17725,13734,2110,6674,1474,11624,277,136,141
17730,13739,2111,6677,1475,11628,277,136,141
17735,13741,2111,6677,1475,11630,277,136,141
17740,13749,2113,6683,1476,11636,277,136,141
17745,13752,2113,6683,1476,11639,277,136,141
17750,13757,2114,6684,1476,11643,278,136,142
17755,13761,2114,6685,1476,11646,278,136,142
17760,13764,2115,6687,1477,11649,278,136,142
17765,13765,2115,6687,1477,11650,278,136,142
17770,13770,2115,6688,1477,11655,278,136,142
17775,13772,2115,6688,1477,11657,278,136,142
17780,13780,2116,6693,1477,11664,278,136,142
17785,13783,2116,6695,1477,11667,278,136,142
17790,13788,2117,6698,1478,11671,279,137,142
17795,13792,2117,6700,1478,11675,279,137,142
17800,13795,2118,6701,1479,11677,279,137,142
17805,13796,2118,6701,1479,11678,279,137,142
17810,13801,2118,6705,1479,11682,279,137,142
17815,13803,2120,6707,1481,11683,279,137,142
17820,13811,2121,6710,1482,11690,279,137,142
17825,13814,2122,6713,1483,11692,279,137,142
17830,13819,2123,6715,1484,11696,279,137,142
17835,13823,2123,6718,1484,11700,279,137,142
17840,13826,2123,6719,1484,11703,279,137,142
17845,13827,2123,6720,1484,11704,279,137,142
17850,13832,2123,6721,1484,11709,279,137,142
17855,13834,2124,6722,1485,11710,279,137,142
17860,13842,2125,6727,1486,11716,279,137,142
17865,13845,2126,6728,1487,11719,279,137,142
17870,13850,2127,6729,1487,11723,279,137,142
17875,13854,2127,6730,1487,11727,279,137,142
17880,13857,2127,6732,1487,11730,279,137,142
17885,13858,2127,6732,1487,11731,279,137,142
17890,13863,2128,6733,1487,11735,279,137,142
17895,13865,2128,6734,1487,11737,279,137,142
17900,13873,2131,6736,1489,11742,279,137,142
17905,13876,2131,6737,1489,11745,279,137,142
17910,13881,2132,6739,1490,11749,280,138,142
17915,13885,2132,6741,1490,11753,280,138,142
17920,13888,2132,6741,1490,11756,280,138,142
17925,13889,2132,6741,1490,11757,280,138,142
17930,13894,2133,6743,1490,11761,280,138,142
17935,13896,2133,6744,1490,11763,280,138,142
17940,13904,2135,6746,1491,11769,280,138,142
17945,13907,2135,6747,1491,11772,280,138,142
17950,13912,2137,6751,1493,11775,281,139,142
17955,13916,2138,6753,1494,11778,281,139,142
17960,13919,2138,6753,1494,11781,281,139,142
17965,13920,2139,6754,1495,11781,281,139,142
17970,13925,2140,6754,1495,11785,281,139,142
17975,13927,2140,6755,1495,11787,281,139,142
17980,13935,2141,6758,1496,11794,281,139,142
17985,13938,2141,6759,1496,11797,281,139,142
17990,13943,2142,6762,1497,11801,281,139,142
17995,13947,2143,6765,1498,11803,281,139,142
18000,13950,2145,6766,1500,11805,281,139,142
18005,13951,2146,6767,1501,11805,281,139,142
18010,13956,2147,6769,1501,11809,281,139,142
18015,13958,2148,6770,1501,11810,281,139,142
18020,13966,2149,6772,1501,11817,281,139,142
18025,13969,2150,6773,1502,11819,281,139,142
18030,13974,2151,6774,1502,11823,281,139,142
18035,13978,2151,6777,1502,11827,281,139,142
18040,13981,2151,6778,1502,11830,281,139,142
18045,13982,2151,6778,1502,11831,281,139,142
18050,13987,2152,6782,1502,11834,281,139,142
18055,13989,2154,6783,1504,11835,281,139,142
18060,13997,2156,6787,1506,11841,281,139,142
18065,14000,2156,6787,1506,11844,281,139,142
18070,14005,2157,6789,1506,11848,281,139,142
18075,14009,2157,6790,1506,11852,281,139,142
18080,14012,2157,6791,1506,11855,281,139,142
18085,14013,2157,6791,1506,11856,281,139,142
18090,14018,2157,6795,1506,11860,281,139,142
18095,14020,2159,6796,1508,11861,281,139,142
18100,14028,2160,6799,1509,11868,281,139,142
18105,14031,2160,6799,1509,11871,281,139,142
18110,14036,2161,6801,1510,11875,281,139,142
18115,14040,2161,6802,1510,11878,281,139,142
18120,14043,2162,6802,1511,11881,281,139,142
18125,14044,2162,6802,1511,11882,281,139,142
18130,14049,2162,6805,1511,11886,281,139,142
18135,14051,2164,6806,1513,11887,281,139,142
18140,14059,2165,6810,1514,11894,281,139,142
18145,14062,2165,6812,1514,11897,281,139,142
18150,14067,2165,6815,1514,11902,281,139,142
18155,14071,2165,6818,1514,11906,281,139,142
18160,14074,2166,6820,1515,11908,281,139,142
18165,14075,2166,6820,1515,11909,281,139,142
18170,14080,2167,6822,1515,11912,281,139,142
18175,14082,2169,6823,1517,11913,281,139,142
18180,14090,2172,6829,1519,11918,281,139,142
18185,14093,2173,6832,1520,11920,281,139,142
18190,14098,2173,6834,1520,11925,282,140,142
18195,14102,2173,6834,1520,11929,282,140,142
18200,14105,2173,6837,1520,11932,282,140,142
18205,14106,2174,6838,1521,11932,282,140,142
18210,14111,2175,6838,1521,11936,282,140,142
18215,14113,2175,6838,1521,11938,282,140,142
18220,14121,2175,6843,1521,11946,282,140,142
18225,14124,2175,6843,1521,11949,282,140,142
18230,14129,2176,6845,1522,11953,283,140,143
18235,14133,2177,6847,1523,11956,283,140,143
18240,14136,2177,6849,1523,11959,283,140,143
18245,14137,2178,6850,1524,11959,283,140,143
18250,14142,2179,6853,1525,11963,283,140,143
18255,14144,2179,6853,1525,11965,283,140,143
18260,14152,2180,6856,1526,11972,283,140,143
18265,14155,2180,6856,1526,11975,283,140,143
18270,14160,2182,6858,1528,11978,284,140,144
18275,14164,2182,6860,1528,11981,284,140,144
18280,14167,2183,6863,1529,11984,284,140,144
18285,14168,2183,6863,1529,11985,284,140,144
18290,14173,2184,6864,1529,11989,284,140,144
18295,14175,2185,6864,1529,11990,284,140,144
18300,14183,2187,6868,1531,11996,284,140,144
18305,14186,2187,6868,1531,11999,284,140,144
18310,14191,2188,6870,1531,12003,284,140,144
18315,14195,2188,6872,1531,12006,284,140,144
18320,14198,2189,6873,1532,12009,284,140,144
18325,14199,2189,6873,1532,12010,284,140,144
18330,14204,2189,6874,1532,12015,284,140,144
18335,14206,2190,6876,1533,12016,284,140,144
18340,14214,2190,6878,1533,12024,284,140,144
18345,14217,2190,6880,1533,12027,284,140,144
18350,14222,2191,6883,1534,12031,284,140,144
18355,14226,2191,6886,1534,12035,284,140,144
18360,14229,2191,6886,1534,12038,284,140,144
18365,14230,2191,6886,1534,12039,284,140,144
18370,14235,2191,6887,1534,12044,284,140,144
18375,14237,2192,6889,1535,12045,284,140,144
18380,14245,2192,6895,1535,12053,284,140,144
18385,14248,2192,6897,1535,12056,284,140,144
18390,14253,2193,6899,1536,12060,284,140,144
18395,14257,2193,6901,1536,12063,284,140,144
18400,14260,2194,6903,1537,12066,284,140,144
18405,14261,2194,6904,1537,12067,284,140,144
18410,14266,2195,6909,1538,12070,284,140,144
18415,14268,2197,6911,1540,12071,284,140,144
18420,14276,2198,6914,1540,12078,284,140,144
18425,14279,2199,6916,1541,12080,284,140,144
18430,14284,2200,6920,1541,12084,285,141,144
18435,14288,2200,6922,1541,12088,285,141,144
18440,14291,2200,6924,1541,12091,285,141,144
18445,14292,2200,6924,1541,12092,285,141,144
18450,14297,2201,6926,1541,12096,285,141,144
18455,14299,2201,6927,1541,12098,285,141,144
18460,14307,2202,6930,1542,12105,285,141,144
18465,14310,2203,6931,1543,12107,285,141,144
18470,14315,2204,6933,1543,12111,286,141,145
18475,14319,2204,6935,1543,12115,286,141,145
18480,14322,2204,6937,1543,12118,286,141,145
18485,14323,2205,6938,1544,12118,286,141,145
18490,14328,2206,6942,1545,12122,286,141,145
18495,14330,2206,6944,1545,12124,286,141,145
18500,14338,2207,6947,1545,12131,286,141,145
18505,14341,2208,6948,1546,12133,286,141,145
18510,14346,2209,6950,1546,12137,287,142,145
18515,14350,2209,6953,1546,12141,287,142,145
18520,14353,2209,6953,1546,12144,287,142,145
18525,14354,2209,6953,1546,12145,287,142,145
18530,14359,2210,6955,1546,12149,287,142,145
18535,14361,2211,6955,1546,12150,287,142,145
18540,14369,2212,6956,1546,12157,287,142,145
18545,14372,2212,6958,1546,12160,287,142,145
18550,14377,2213,6958,1546,12164,287,142,145
18555,14381,2213,6962,1546,12168,287,142,145
18560,14384,2213,6965,1546,12171,287,142,145
18565,14385,2214,6966,1547,12171,287,142,145
18570,14390,2215,6967,1547,12175,287,142,145
18575,14392,2215,6967,1547,12177,287,142,145
18580,14400,2216,6972,1548,12184,287,142,145
18585,14403,2216,6974,1548,12187,287,142,145
18590,14408,2217,6976,1548,12191,287,142,145
18595,14412,2217,6976,1548,12195,287,142,145
18600,14415,2217,6977,1548,12198,287,142,145
18605,14416,2218,6978,1549,12198,287,142,145
18610,14421,2219,6979,1549,12202,287,142,145
18615,14423,2219,6980,1549,12204,287,142,145
18620,14431,2220,6985,1549,12211,287,142,145
18625,14434,2220,6986,1549,12214,287,142,145
18630,14439,2221,6988,1549,12218,287,142,145
18635,14443,2221,6991,1549,12221,287,142,145
18640,14446,2222,6993,1550,12224,287,142,145
18645,14447,2223,6994,1551,12224,287,142,145
18650,14452,2224,6996,1552,12227,287,142,145
18655,14454,2226,6998,1554,12228,287,142,145
18660,14462,2227,7001,1555,12235,287,142,145
18665,14465,2227,7003,1555,12238,287,142,145
18670,14470,2227,7006,1555,12243,288,142,146
18675,14474,2227,7009,1555,12246,288,142,146
18680,14477,2228,7010,1556,12249,288,142,146
18685,14478,2229,7011,1557,12249,288,142,146
18690,14483,2230,7012,1557,12253,288,142,146
18695,14485,2230,7013,1557,12255,288,142,146
18700,14493,2230,7015,1557,12263,288,142,146
18705,14496,2230,7016,1557,12266,288,142,146
18710,14501,2230,7019,1557,12271,289,142,147
18715,14505,2230,7020,1557,12275,289,142,147
18720,14508,2230,7021,1557,12278,289,142,147
18725,14509,2230,7021,1557,12279,289,142,147
18730,14514,2231,7024,1557,12283,289,142,147
18735,14516,2231,7024,1557,12285,289,142,147
18740,14524,2231,7028,1557,12293,289,142,147
18745,14527,2231,7029,1557,12296,289,142,147
18750,14532,2231,7031,1557,12301,289,142,147
18755,14536,2231,7033,1557,12305,289,142,147
18760,14539,2231,7035,1557,12308,289,142,147
18765,14540,2231,7035,1557,12309,289,142,147
18770,14545,2232,7038,1557,12312,289,142,147
18775,14547,2234,7039,1559,12313,289,142,147
18780,14555,2236,7044,1561,12318,289,142,147
18785,14558,2237,7046,1562,12321,289,142,147
18790,14563,2238,7049,1563,12325,289,142,147
18795,14567,2238,7050,1563,12329,289,142,147
18800,14570,2238,7052,1563,12332,289,142,147
18805,14571,2238,7052,1563,12333,289,142,147
18810,14576,2239,7056,1563,12337,289,142,147
18815,14578,2239,7057,1563,12339,289,142,147
18820,14586,2240,7062,1564,12346,289,142,147
18825,14589,2240,7065,1564,12349,289,142,147
18830,14594,2241,7070,1565,12353,289,142,147
18835,14598,2241,7070,1565,12357,289,142,147
18840,14601,2242,7072,1566,12359,289,142,147
18845,14602,2243,7073,1567,12359,289,142,147
18850,14607,2244,7076,1567,12363,289,142,147
18855,14609,2244,7076,1567,12365,289,142,147
18860,14617,2244,7079,1567,12373,289,142,147
18865,14620,2244,7079,1567,12376,289,142,147
18870,14625,2245,7081,1567,12380,289,142,147
18875,14629,2245,7082,1567,12384,289,142,147
18880,14632,2245,7083,1567,12387,289,142,147
18885,14633,2246,7084,1568,12387,289,142,147
18890,14638,2247,7086,1568,12390,289,142,147
18895,14640,2249,7087,1569,12391,289,142,147
18900,14648,2250,7090,1569,12398,289,142,147
18905,14651,2250,7091,1569,12401,289,142,147
18910,14656,2251,7095,1570,12405,289,142,147
18915,14660,2251,7096,1570,12409,289,142,147
18920,14663,2251,7097,1570,12412,289,142,147
18925,14664,2251,7097,1570,12413,289,142,147
18930,14669,2252,7099,1571,12417,289,142,147
18935,14671,2253,7101,1572,12418,289,142,147
18940,14679,2255,7103,1573,12424,289,142,147
18945,14682,2255,7105,1573,12427,289,142,147
18950,14687,2256,7107,1574,12431,289,142,147
18955,14691,2256,7109,1574,12435,289,142,147
18960,14694,2256,7109,1574,12438,289,142,147
18965,14695,2257,7110,1575,12438,289,142,147
18970,14700,2258,7111,1575,12442,289,142,147
18975,14702,2259,7113,1576,12443,289,142,147
18980,14710,2261,7119,1577,12449,289,142,147
18985,14713,2261,7120,1577,12452,289,142,147
18990,14718,2262,7121,1577,12456,289,142,147
18995,14722,2262,7122,1577,12459,289,142,147
19000,14725,2263,7124,1578,12462,289,142,147
19005,14726,2263,7124,1578,12463,289,142,147
19010,14731,2264,7128,1579,12466,289,142,147
19015,14733,2266,7129,1581,12467,289,142,147
19020,14741,2267,7134,1582,12474,289,142,147
19025,14744,2267,7134,1582,12477,289,142,147
19030,14749,2267,7136,1582,12482,289,142,147
19035,14753,2267,7138,1582,12486,289,142,147
19040,14756,2267,7141,1582,12489,289,142,147
19045,14757,2267,7141,1582,12490,289,142,147
19050,14762,2268,7145,1583,12494,289,142,147
19055,14764,2268,7146,1583,12496,289,142,147
19060,14772,2269,7150,1583,12503,289,142,147
19065,14775,2269,7153,1583,12506,289,142,147
19070,14780,2269,7157,1583,12511,289,142,147
19075,14784,2269,7159,1583,12515,289,142,147
19080,14787,2269,7161,1583,12518,289,142,147
19085,14788,2270,7162,1584,12518,289,142,147
19090,14793,2271,7164,1584,12522,289,142,147
19095,14795,2271,7166,1584,12524,289,142,147
19100,14803,2273,7170,1586,12530,289,142,147
19105,14806,2273,7172,1586,12533,289,142,147
19110,14811,2273,7173,1586,12538,289,142,147
19115,14815,2273,7176,1586,12541,289,142,147
19120,14818,2274,7177,1587,12544,289,142,147
19125,14819,2274,7177,1587,12545,289,142,147
19130,14824,2275,7181,1587,12548,289,142,147
19135,14826,2277,7182,1589,12549,289,142,147
19140,14834,2278,7185,1589,12556,289,142,147
19145,14837,2278,7186,1589,12559,289,142,147
19150,14842,2279,7186,1589,12563,290,142,148
19155,14846,2279,7187,1589,12567,290,142,148
19160,14849,2279,7189,1589,12570,290,142,148
19165,14850,2279,7189,1589,12571,290,142,148
19170,14855,2279,7192,1589,12576,290,142,148
19175,14857,2280,7194,1590,12577,290,142,148
19180,14865,2281,7198,1591,12584,290,142,148
19185,14868,2281,7200,1591,12587,290,142,148
19190,14873,2282,7200,1591,12591,291,142,149
19195,14877,2282,7201,1591,12595,291,142,149
19200,14880,2282,7201,1591,12598,291,142,149
19205,14881,2282,7201,1591,12599,291,142,149
19210,14886,2282,7203,1591,12603,291,142,149
19215,14888,2284,7205,1593,12604,291,142,149
19220,14896,2285,7209,1594,12611,291,142,149
19225,14899,2285,7211,1594,12614,291,142,149
19230,14904,2286,7214,1595,12618,291,142,149
19235,14908,2286,7216,1595,12622,291,142,149
19240,14911,2286,7217,1595,12625,291,142,149
19245,14912,2286,7217,1595,12626,291,142,149
19250,14917,2287,7218,1595,12630,291,142,149
19255,14919,2288,7219,1595,12631,291,142,149
19260,14927,2289,7220,1596,12638,291,142,149
19265,14930,2289,7222,1596,12641,291,142,149
19270,14935,2290,7225,1596,12645,291,142,149
19275,14939,2290,7227,1596,12649,291,142,149
19280,14942,2291,7229,1597,12651,291,142,149
19285,14943,2292,7230,1598,12651,291,142,149
19290,14948,2293,7233,1598,12655,291,142,149
19295,14950,2293,7233,1598,12657,291,142,149
19300,14958,2294,7237,1599,12664,291,142,149
19305,14961,2294,7239,1599,12667,291,142,149
19310,14966,2295,7240,1599,12671,291,142,149
19315,14970,2295,7242,1599,12675,291,142,149
19320,14973,2295,7244,1599,12678,291,142,149
19325,14974,2296,7245,1600,12678,291,142,149
19330,14979,2297,7248,1601,12682,291,142,149
19335,14981,2297,7250,1601,12684,291,142,149
19340,14989,2298,7253,1601,12691,291,142,149
19345,14992,2298,7254,1601,12694,291,142,149
19350,14997,2299,7255,1602,12698,291,142,149
19355,15001,2299,7256,1602,12702,291,142,149
19360,15004,2299,7256,1602,12705,291,142,149
19365,15005,2300,7257,1603,12705,291,142,149
19370,15010,2301,7259,1603,12708,291,142,149
19375,15012,2303,7260,1605,12709,291,142,149
19380,15020,2304,7263,1606,12715,291,142,149
19385,15023,2305,7265,1607,12718,291,142,149
19390,15028,2306,7268,1607,12722,291,142,149
19395,15032,2306,7270,1607,12725,291,142,149
19400,15035,2307,7271,1608,12728,291,142,149
19405,15036,2307,7272,1608,12729,291,142,149
19410,15041,2307,7274,1608,12734,291,142,149
19415,15043,2308,7274,1608,12735,291,142,149
19420,15051,2309,7280,1609,12742,291,142,149
19425,15054,2309,7283,1609,12745,291,142,149
19430,15059,2310,7285,1610,12749,291,142,149
19435,15063,2310,7286,1610,12752,291,142,149
19440,15066,2311,7289,1611,12755,291,142,149
19445,15067,2311,7290,1611,12756,291,142,149
19450,15072,2311,7293,1611,12760,291,142,149
19455,15074,2313,7295,1613,12761,291,142,149
19460,15082,2314,7298,1613,12768,291,142,149
19465,15085,2314,7299,1613,12771,291,142,149
19470,15090,2315,7300,1613,12775,291,142,149
19475,15094,2315,7303,1613,12778,291,142,149
19480,15097,2316,7304,1614,12781,291,142,149
19485,15098,2316,7304,1614,12782,291,142,149
19490,15103,2317,7306,1615,12786,291,142,149
19495,15105,2318,7307,1616,12787,291,142,149
19500,15113,2320,7313,1618,12792,291,142,149
19505,15116,2321,7314,1619,12795,291,142,149
19510,15121,2322,7317,1619,12799,292,143,149
19515,15125,2322,7319,1619,12803,292,143,149
19520,15128,2323,7321,1620,12805,292,143,149
19525,15129,2323,7322,1620,12806,292,143,149
19530,15134,2324,7324,1621,12810,292,143,149
19535,15136,2324,7324,1621,12812,292,143,149
19540,15144,2325,7331,1622,12819,292,143,149
19545,15147,2325,7333,1622,12822,292,143,149
19550,15152,2326,7336,1623,12826,293,143,150
19555,15156,2326,7338,1623,12830,293,143,150
19560,15159,2327,7340,1624,12832,293,143,150
19565,15160,2327,7341,1624,12833,293,143,150
19570,15165,2328,7344,1625,12837,293,143,150
19575,15167,2328,7346,1625,12839,293,143,150
19580,15175,2329,7349,1626,12846,293,143,150
19585,15178,2329,7349,1626,12849,293,143,150
19590,15183,2330,7351,1626,12853,294,144,150
19595,15187,2330,7353,1626,12857,294,144,150
19600,15190,2330,7354,1626,12860,294,144,150
19605,15191,2331,7355,1627,12860,294,144,150
19610,15196,2332,7356,1627,12863,294,144,150
19615,15198,2334,7356,1628,12864,294,144,150
19620,15206,2335,7356,1628,12871,294,144,150
19625,15209,2335,7358,1628,12874,294,144,150
19630,15214,2336,7362,1629,12878,294,144,150
19635,15218,2336,7365,1629,12881,294,144,150
19640,15221,2337,7367,1630,12884,294,144,150
19645,15222,2338,7368,1631,12884,294,144,150
19650,15227,2339,7370,1631,12887,294,144,150
19655,15229,2341,7372,1633,12888,294,144,150
19660,15237,2342,7373,1633,12895,294,144,150
19665,15240,2342,7373,1633,12898,294,144,150
19670,15245,2343,7375,1633,12902,294,144,150
19675,15249,2343,7378,1633,12905,294,144,150
19680,15252,2344,7381,1634,12908,294,144,150
19685,15253,2345,7382,1635,12908,294,144,150
19690,15258,2346,7384,1635,12911,294,144,150
19695,15260,2348,7384,1636,12912,294,144,150
19700,15268,2349,7386,1636,12919,294,144,150
19705,15271,2349,7387,1636,12922,294,144,150
19710,15276,2350,7389,1636,12926,294,144,150
19715,15280,2350,7391,1636,12929,294,144,150
19720,15283,2351,7391,1637,12932,294,144,150
19725,15284,2351,7391,1637,12933,294,144,150
19730,15289,2352,7392,1637,12937,294,144,150
19735,15291,2353,7392,1637,12938,294,144,150
19740,15299,2355,7395,1639,12944,294,144,150
19745,15302,2355,7396,1639,12947,294,144,150
19750,15307,2356,7399,1639,12951,294,144,150
19755,15311,2356,7402,1639,12955,294,144,150
19760,15314,2357,7405,1640,12957,294,144,150
19765,15315,2357,7405,1640,12958,294,144,150
19770,15320,2357,7407,1640,12963,294,144,150
19775,15322,2357,7409,1640,12965,294,144,150
19780,15330,2358,7413,1640,12972,294,144,150
19785,15333,2358,7415,1640,12975,294,144,150
19790,15338,2359,7417,1641,12979,294,144,150
19795,15342,2359,7418,1641,12983,294,144,150
19800,15345,2360,7421,1642,12985,294,144,150
19805,15346,2360,7421,1642,12986,294,144,150
19810,15351,2360,7425,1642,12991,294,144,150
19815,15353,2360,7425,1642,12993,294,144,150
19820,15361,2361,7431,1642,13000,294,144,150
19825,15364,2361,7434,1642,13003,294,144,150
19830,15369,2362,7436,1642,13007,294,144,150
19835,15373,2362,7438,1642,13011,294,144,150
19840,15376,2363,7439,1643,13013,294,144,150
19845,15377,2363,7440,1643,13014,294,144,150
19850,15382,2364,7443,1643,13017,294,144,150
19855,15384,2366,7443,1644,13018,294,144,150
19860,15392,2368,7448,1646,13023,294,144,150
19865,15395,2369,7448,1647,13026,294,144,150
19870,15400,2370,7451,1648,13030,294,144,150
19875,15404,2370,7452,1648,13034,294,144,150
19880,15407,2370,7454,1648,13037,294,144,150
19885,15408,2371,7455,1649,13037,294,144,150
19890,15413,2372,7457,1650,13041,294,144,150
19895,15415,2373,7457,1650,13042,294,144,150
19900,15423,2373,7459,1650,13050,294,144,150
19905,15426,2373,7461,1650,13053,294,144,150
19910,15431,2374,7462,1650,13057,294,144,150
19915,15435,2374,7463,1650,13061,294,144,150
19920,15438,2374,7465,1650,13064,294,144,150
19925,15439,2374,7465,1650,13065,294,144,150
19930,15444,2375,7469,1651,13069,294,144,150
19935,15446,2376,7470,1651,13070,294,144,150
19940,15454,2378,7473,1653,13076,294,144,150
19945,15457,2378,7474,1653,13079,294,144,150
19950,15462,2379,7476,1653,13083,294,144,150
19955,15466,2379,7478,1653,13087,294,144,150
19960,15469,2379,7478,1653,13090,294,144,150
19965,15470,2380,7479,1654,13090,294,144,150
19970,15475,2381,7481,1655,13094,294,144,150
19975,15477,2382,7483,1656,13095,294,144,150
19980,15485,2385,7488,1659,13100,294,144,150
19985,15488,2385,7489,1659,13103,294,144,150
19990,15493,2386,7493,1659,13107,295,145,150
19995,15497,2386,7495,1659,13111,295,145,150
20000,15500,2386,7496,1659,13114,295,145,150
20005,15501,2386,7496,1659,13115,295,145,150
20010,15506,2387,7498,1659,13119,295,145,150
20015,15508,2387,7500,1659,13121,295,145,150
20020,15516,2387,7504,1659,13129,295,145,150
20025,15519,2387,7506,1659,13132,295,145,150
20030,15524,2388,7508,1659,13136,296,146,150
20035,15528,2388,7510,1659,13140,296,146,150
20040,15531,2389,7511,1660,13142,296,146,150
20045,15532,2390,7512,1661,13142,296,146,150
20050,15537,2391,7514,1661,13146,296,146,150
20055,15539,2391,7515,1661,13148,296,146,150
20060,15547,2391,7520,1661,13156,296,146,150
20065,15550,2391,7522,1661,13159,296,146,150
20070,15555,2392,7524,1662,13163,296,146,150
20075,15559,2392,7526,1662,13167,296,146,150
20080,15562,2393,7528,1663,13169,296,146,150
20085,15563,2394,7529,1664,13169,296,146,150
20090,15568,2395,7531,1664,13172,296,146,150
20095,15570,2397,7532,1665,13173,296,146,150
20100,15578,2399,7537,1666,13179,296,146,150
20105,15581,2399,7538,1666,13182,296,146,150
20110,15586,2399,7541,1666,13187,296,146,150
20115,15590,2399,7544,1666,13191,296,146,150
20120,15593,2399,7544,1666,13194,296,146,150
20125,15594,2400,7545,1667,13194,296,146,150
20130,15599,2401,7548,1668,13197,296,146,150
20135,15601,2403,7550,1670,13198,296,146,150
20140,15609,2404,7554,1671,13205,296,146,150
20145,15612,2404,7556,1671,13208,296,146,150
20150,15617,2404,7560,1671,13213,297,147,150
20155,15621,2404,7561,1671,13217,297,147,150
20160,15624,2404,7564,1671,13220,297,147,150
20165,15625,2404,7564,1671,13221,297,147,150
20170,15630,2405,7568,1672,13225,297,147,150
20175,15632,2405,7569,1672,13227,297,147,150
20180,15640,2405,7576,1672,13235,297,147,150
20185,15643,2405,7577,1672,13238,297,147,150
20190,15648,2405,7580,1672,13243,297,147,150
20195,15652,2405,7582,1672,13247,297,147,150
20200,15655,2405,7584,1672,13250,297,147,150
20205,15656,2405,7584,1672,13251,297,147,150
20210,15661,2406,7586,1673,13255,297,147,150
20215,15663,2406,7588,1673,13257,297,147,150
20220,15671,2408,7594,1675,13263,297,147,150
20225,15674,2408,7597,1675,13266,297,147,150
20230,15679,2409,7601,1676,13270,297,147,150
20235,15683,2409,7601,1676,13274,297,147,150
20240,15686,2409,7604,1676,13277,297,147,150
20245,15687,2410,7605,1677,13277,297,147,150
20250,15692,2411,7607,1678,13281,297,147,150
20255,15694,2412,7607,1678,13282,297,147,150
20260,15702,2414,7610,1680,13288,297,147,150
20265,15705,2414,7611,1680,13291,297,147,150
20270,15710,2415,7614,1681,13295,297,147,150
20275,15714,2415,7615,1681,13299,297,147,150
20280,15717,2416,7617,1682,13301,297,147,150
20285,15718,2416,7618,1682,13302,297,147,150
20290,15723,2416,7621,1682,13306,297,147,150
20295,15725,2418,7623,1684,13307,297,147,150
20300,15733,2419,7626,1684,13314,297,147,150
20305,15736,2420,7627,1685,13316,297,147,150
20310,15741,2421,7631,1685,13320,297,147,150
20315,15745,2421,7632,1685,13323,297,147,150
20320,15748,2422,7634,1686,13326,297,147,150
20325,15749,2422,7635,1686,13327,297,147,150
20330,15754,2422,7639,1686,13331,297,147,150
20335,15756,2424,7639,1687,13332,297,147,150
20340,15764,2425,7643,1687,13339,297,147,150
20345,15767,2425,7643,1687,13342,297,147,150
20350,15772,2426,7646,1688,13346,297,147,150
20355,15776,2426,7648,1688,13349,297,147,150
20360,15779,2427,7650,1689,13352,297,147,150
20365,15780,2427,7650,1689,13353,297,147,150
20370,15785,2427,7654,1689,13357,297,147,150
20375,15787,2429,7654,1690,13358,297,147,150
20380,15795,2430,7658,1690,13365,297,147,150
20385,15798,2431,7659,1691,13367,297,147,150
20390,15803,2432,7661,1691,13371,298,148,150
20395,15807,2432,7661,1691,13375,298,148,150
20400,15810,2432,7661,1691,13378,298,148,150
20405,15811,2433,7662,1692,13378,298,148,150
20410,15816,2434,7665,1692,13382,298,148,150
20415,15818,2434,7666,1692,13384,298,148,150
20420,15826,2436,7673,1694,13390,298,148,150
20425,15829,2436,7675,1694,13393,298,148,150
20430,15834,2437,7677,1695,13397,299,148,151
20435,15838,2437,7679,1695,13400,299,148,151
20440,15841,2438,7680,1696,13403,299,148,151
20445,15842,2438,7680,1696,13404,299,148,151
20450,15847,2439,7684,1697,13408,299,148,151
20455,15849,2439,7685,1697,13410,299,148,151
20460,15857,2441,7689,1699,13416,299,148,151
20465,15860,2442,7692,1700,13418,299,148,151
20470,15865,2443,7693,1701,13422,299,148,151
20475,15869,2443,7697,1701,13425,299,148,151
20480,15872,2444,7699,1702,13428,299,148,151
20485,15873,2444,7699,1702,13429,299,148,151
20490,15878,2445,7702,1702,13433,299,148,151
20495,15880,2445,7703,1702,13435,299,148,151
20500,15888,2447,7705,1703,13441,299,148,151
20505,15891,2447,7706,1703,13444,299,148,151
20510,15896,2448,7708,1703,13448,299,148,151
20515,15900,2448,7709,1703,13452,299,148,151
20520,15903,2448,7711,1703,13455,299,148,151
20525,15904,2448,7711,1703,13456,299,148,151
20530,15909,2449,7714,1704,13460,299,148,151
20535,15911,2450,7715,1705,13461,299,148,151
20540,15919,2452,7718,1706,13467,299,148,151
20545,15922,2452,7719,1706,13470,299,148,151
20550,15927,2452,7720,1706,13475,299,148,151
20555,15931,2452,7720,1706,13479,299,148,151
20560,15934,2452,7722,1706,13482,299,148,151
20565,15935,2452,7722,1706,13483,299,148,151
20570,15940,2453,7725,1707,13487,299,148,151
20575,15942,2454,7725,1707,13488,299,148,151
20580,15950,2455,7730,1707,13495,299,148,151
20585,15953,2455,7730,1707,13498,299,148,151
20590,15958,2455,7732,1707,13503,299,148,151
20595,15962,2455,7735,1707,13507,299,148,151
20600,15965,2455,7736,1707,13510,299,148,151
20605,15966,2456,7737,1708,13510,299,148,151
20610,15971,2457,7740,1709,13513,299,148,151
20615,15973,2459,7742,1711,13514,299,148,151
20620,15981,2460,7747,1711,13521,299,148,151
20625,15984,2460,7749,1711,13524,299,148,151
20630,15989,2461,7754,1712,13528,300,149,151
20635,15993,2461,7757,1712,13532,300,149,151
20640,15996,2462,7758,1713,13534,300,149,151
20645,15997,2462,7758,1713,13535,300,149,151
20650,16002,2463,7760,1713,13538,300,149,151
20655,16004,2465,7762,1715,13539,300,149,151
20660,16012,2468,7767,1717,13544,300,149,151
20665,16015,2469,7768,1718,13546,300,149,151
20670,16020,2470,7771,1719,13550,301,150,151
20675,16024,2470,7775,1719,13554,301,150,151
20680,16027,2470,7777,1719,13557,301,150,151
20685,16028,2470,7777,1719,13558,301,150,151
20690,16033,2471,7780,1719,13561,301,150,151
20695,16035,2473,7780,1720,13562,301,150,151
20700,16043,2474,7783,1721,13569,301,150,151
20705,16046,2475,7785,1722,13571,301,150,151
20710,16051,2476,7790,1723,13575,301,150,151
20715,16055,2476,7792,1723,13579,301,150,151
20720,16058,2476,7793,1723,13582,301,150,151
20725,16059,2477,7794,1724,13582,301,150,151
20730,16064,2478,7796,1725,13585,301,150,151
20735,16066,2480,7798,1727,13586,301,150,151
20740,16074,2481,7800,1727,13593,301,150,151
20745,16077,2482,7801,1728,13595,301,150,151
20750,16082,2483,7803,1729,13599,301,150,151
20755,16086,2483,7806,1729,13602,301,150,151
20760,16089,2485,7809,1731,13604,301,150,151
20765,16090,2485,7809,1731,13605,301,150,151
20770,16095,2486,7812,1732,13609,301,150,151
20775,16097,2486,7812,1732,13611,301,150,151
20780,16105,2487,7818,1733,13618,301,150,151
20785,16108,2488,7820,1734,13620,301,150,151
20790,16113,2489,7823,1735,13624,301,150,151
20795,16117,2489,7824,1735,13628,301,150,151
20800,16120,2489,7826,1735,13631,301,150,151
20805,16121,2490,7827,1736,13631,301,150,151
20810,16126,2491,7830,1736,13635,301,150,151
20815,16128,2491,7832,1736,13637,301,150,151
20820,16136,2493,7839,1738,13643,301,150,151
20825,16139,2494,7841,1739,13645,301,150,151
20830,16144,2495,7843,1740,13649,302,150,152
20835,16148,2495,7847,1740,13652,302,150,152
20840,16151,2496,7848,1741,13655,302,150,152
20845,16152,2496,7849,1741,13656,302,150,152
20850,16157,2496,7852,1741,13661,302,150,152
20855,16159,2496,7853,1741,13663,302,150,152
20860,16167,2497,7857,1741,13670,302,150,152
20865,16170,2497,7857,1741,13673,302,150,152
20870,16175,2498,7859,1741,13677,303,151,152
20875,16179,2498,7860,1741,13681,303,151,152
20880,16182,2499,7861,1742,13683,303,151,152
20885,16183,2499,7861,1742,13684,303,151,152
20890,16188,2499,7864,1742,13688,303,151,152
20895,16190,2501,7864,1743,13689,303,151,152
20900,16198,2502,7866,1743,13696,303,151,152
20905,16201,2502,7868,1743,13699,303,151,152
20910,16206,2503,7870,1743,13703,303,151,152
20915,16210,2503,7873,1743,13706,303,151,152
20920,16213,2504,7874,1744,13709,303,151,152
20925,16214,2505,7875,1745,13709,303,151,152
20930,16219,2506,7879,1746,13713,303,151,152
20935,16221,2507,7881,1747,13714,303,151,152
20940,16229,2509,7884,1748,13720,303,151,152
20945,16232,2509,7886,1748,13723,303,151,152
20950,16237,2510,7887,1748,13727,303,151,152
20955,16241,2510,7889,1748,13731,303,151,152
20960,16244,2510,7891,1748,13734,303,151,152
20965,16245,2510,7891,1748,13735,303,151,152
20970,16250,2511,7893,1749,13739,303,151,152
20975,16252,2512,7894,1750,13740,303,151,152
20980,16260,2513,7899,1750,13747,303,151,152
20985,16263,2513,7901,1750,13750,303,151,152
20990,16268,2514,7902,1750,13754,304,151,153
20995,16272,2515,7904,1751,13757,304,151,153
21000,16275,2515,7904,1751,13760,304,151,153
21005,16276,2516,7905,1752,13760,304,151,153
21010,16281,2517,7907,1752,13764,304,151,153
21015,16283,2518,7908,1753,13765,304,151,153
21020,16291,2519,7912,1754,13772,304,151,153
21025,16294,2520,7915,1755,13774,304,151,153
21030,16299,2520,7918,1755,13779,304,151,153
21035,16303,2520,7919,1755,13783,304,151,153
21040,16306,2520,7921,1755,13786,304,151,153
21045,16307,2521,7922,1756,13786,304,151,153
21050,16312,2522,7924,1756,13789,304,151,153
21055,16314,2524,7926,1758,13790,304,151,153
21060,16322,2526,7930,1759,13796,304,151,153
21065,16325,2526,7931,1759,13799,304,151,153
21070,16330,2527,7934,1760,13803,304,151,153
21075,16334,2527,7937,1760,13807,304,151,153
21080,16337,2527,7938,1760,13810,304,151,153
21085,16338,2527,7939,1760,13811,304,151,153
21090,16343,2527,7941,1760,13816,304,151,153
21095,16345,2527,7941,1760,13818,304,151,153
21100,16353,2528,7944,1760,13825,304,151,153
21105,16356,2528,7945,1760,13828,304,151,153
21110,16361,2529,7947,1760,13832,305,151,154
21115,16365,2530,7950,1761,13835,305,151,154
21120,16368,2530,7952,1761,13838,305,151,154
21125,16369,2530,7952,1761,13839,305,151,154
21130,16374,2530,7954,1761,13844,305,151,154
21135,16376,2531,7956,1762,13845,305,151,154
21140,16384,2533,7959,1764,13851,305,151,154
21145,16387,2534,7961,1765,13853,305,151,154
21150,16392,2534,7963,1765,13858,306,151,155
21155,16396,2534,7966,1765,13862,306,151,155
21160,16399,2534,7968,1765,13865,306,151,155
21165,16400,2534,7969,1765,13866,306,151,155
21170,16405,2535,7971,1766,13870,306,151,155
21175,16407,2536,7972,1767,13871,306,151,155
21180,16415,2538,7977,1769,13877,306,151,155
21185,16418,2538,7978,1769,13880,306,151,155
21190,16423,2538,7980,1769,13885,306,151,155
21195,16427,2538,7984,1769,13888,306,151,155
21200,16430,2539,7986,1770,13891,306,151,155
21205,16431,2539,7986,1770,13892,306,151,155
21210,16436,2540,7986,1770,13896,306,151,155
21215,16438,2541,7987,1771,13897,306,151,155
21220,16446,2542,7990,1771,13904,306,151,155
21225,16449,2542,7993,1771,13907,306,151,155
21230,16454,2543,7996,1771,13911,306,151,155
21235,16458,2543,7997,1771,13914,306,151,155
21240,16461,2545,7998,1773,13916,306,151,155
21245,16462,2546,7999,1774,13916,306,151,155
21250,16467,2547,8001,1775,13920,306,151,155
21255,16469,2548,8002,1776,13921,306,151,155
21260,16477,2550,8007,1778,13927,306,151,155
21265,16480,2550,8009,1778,13930,306,151,155
21270,16485,2551,8012,1779,13934,306,151,155
21275,16489,2551,8012,1779,13938,306,151,155
21280,16492,2551,8013,1779,13941,306,151,155
21285,16493,2551,8013,1779,13942,306,151,155
21290,16498,2552,8015,1779,13946,306,151,155
21295,16500,2553,8015,1779,13947,306,151,155
21300,16508,2554,8019,1780,13954,306,151,155
21305,16511,2554,8020,1780,13957,306,151,155
21310,16516,2554,8023,1780,13962,306,151,155
21315,16520,2554,8025,1780,13966,306,151,155
21320,16523,2554,8027,1780,13969,306,151,155
21325,16524,2554,8027,1780,13970,306,151,155
21330,16529,2554,8028,1780,13975,306,151,155
21335,16531,2554,8028,1780,13977,306,151,155
21340,16539,2555,8032,1780,13984,306,151,155
21345,16542,2555,8032,1780,13987,306,151,155
21350,16547,2556,8037,1781,13991,306,151,155
21355,16551,2556,8040,1781,13995,306,151,155
21360,16554,2556,8041,1781,13998,306,151,155
21365,16555,2556,8041,1781,13999,306,151,155
21370,16560,2556,8044,1781,14004,306,151,155
21375,16562,2556,8046,1781,14006,306,151,155
21380,16570,2557,8048,1781,14013,306,151,155
21385,16573,2557,8051,1781,14016,306,151,155
21390,16578,2558,8053,1782,14020,306,151,155
21395,16582,2558,8054,1782,14024,306,151,155
21400,16585,2558,8054,1782,14027,306,151,155
21405,16586,2558,8055,1782,14028,306,151,155
21410,16591,2559,8058,1783,14032,306,151,155
21415,16593,2560,8058,1783,14033,306,151,155
21420,16601,2561,8060,1783,14040,306,151,155
21425,16604,2561,8062,1783,14043,306,151,155
21430,16609,2562,8064,1783,14047,307,152,155
21435,16613,2562,8067,1783,14051,307,152,155
21440,16616,2562,8069,1783,14054,307,152,155
21445,16617,2562,8069,1783,14055,307,152,155
21450,16622,2563,8070,1783,14059,307,152,155
21455,16624,2564,8072,1784,14060,307,152,155
21460,16632,2566,8075,1785,14066,307,152,155
21465,16635,2566,8076,1785,14069,307,152,155
21470,16640,2567,8078,1785,14073,308,152,156
21475,16644,2567,8080,1785,14077,308,152,156
21480,16647,2567,8082,1785,14080,308,152,156
21485,16648,2567,8082,1785,14081,308,152,156
21490,16653,2568,8084,1785,14085,308,152,156
21495,16655,2569,8085,1785,14086,308,152,156
21500,16663,2570,8090,1786,14093,308,152,156
21505,16666,2570,8091,1786,14096,308,152,156
21510,16671,2571,8092,1786,14100,308,152,156
21515,16675,2571,8095,1786,14104,308,152,156
21520,16678,2571,8096,1786,14107,308,152,156
21525,16679,2572,8097,1787,14107,308,152,156
21530,16684,2573,8100,1787,14111,308,152,156
21535,16686,2574,8102,1788,14112,308,152,156
21540,16694,2575,8105,1789,14119,308,152,156
21545,16697,2575,8105,1789,14122,308,152,156
21550,16702,2576,8107,1789,14126,308,152,156
21555,16706,2576,8108,1789,14130,308,152,156
21560,16709,2576,8108,1789,14133,308,152,156
21565,16710,2577,8109,1790,14133,308,152,156
21570,16715,2578,8111,1791,14137,308,152,156
21575,16717,2579,8112,1791,14138,308,152,156
21580,16725,2580,8114,1791,14145,308,152,156
21585,16728,2580,8114,1791,14148,308,152,156
21590,16733,2581,8117,1792,14152,309,152,157
21595,16737,2581,8118,1792,14156,309,152,157
21600,16740,2581,8118,1792,14159,309,152,157
21605,16741,2581,8118,1792,14160,309,152,157
21610,16746,2582,8120,1793,14164,309,152,157
21615,16748,2583,8120,1793,14165,309,152,157
21620,16756,2584,8125,1794,14172,309,152,157
21625,16759,2584,8128,1794,14175,309,152,157
21630,16764,2585,8130,1794,14179,310,152,158
21635,16768,2585,8131,1794,14183,310,152,158
21640,16771,2585,8131,1794,14186,310,152,158
21645,16772,2586,8132,1795,14186,310,152,158
21650,16777,2587,8134,1796,14190,310,152,158
21655,16779,2588,8136,1797,14191,310,152,158
21660,16787,2590,8139,1798,14197,310,152,158
21665,16790,2590,8140,1798,14200,310,152,158
21670,16795,2591,8142,1798,14204,310,152,158
21675,16799,2591,8143,1798,14208,310,152,158
21680,16802,2592,8145,1799,14210,310,152,158
21685,16803,2593,8146,1800,14210,310,152,158
21690,16808,2594,8148,1800,14214,310,152,158
21695,16810,2595,8150,1801,14215,310,152,158
21700,16818,2598,8154,1803,14220,310,152,158
21705,16821,2598,8156,1803,14223,310,152,158
21710,16826,2599,8159,1804,14227,310,152,158
21715,16830,2599,8162,1804,14231,310,152,158
21720,16833,2599,8162,1804,14234,310,152,158
21725,16834,2600,8163,1805,14234,310,152,158
21730,16839,2601,8166,1805,14238,310,152,158
21735,16841,2601,8167,1805,14240,310,152,158
21740,16849,2602,8169,1805,14247,310,152,158
21745,16852,2603,8172,1806,14249,310,152,158
21750,16857,2604,8174,1807,14253,311,152,159
21755,16861,2604,8175,1807,14257,311,152,159
21760,16864,2604,8176,1807,14260,311,152,159
21765,16865,2605,8177,1808,14260,311,152,159
21770,16870,2606,8178,1808,14264,311,152,159
21775,16872,2606,8179,1808,14266,311,152,159
21780,16880,2608,8183,1809,14272,311,152,159
21785,16883,2608,8184,1809,14275,311,152,159
21790,16888,2609,8187,1810,14279,311,152,159
21795,16892,2609,8190,1810,14282,311,152,159
21800,16895,2611,8191,1812,14284,311,152,159
21805,16896,2611,8191,1812,14285,311,152,159
21810,16901,2612,8193,1813,14289,311,152,159
21815,16903,2612,8195,1813,14291,311,152,159
21820,16911,2613,8200,1814,14298,311,152,159
21825,16914,2613,8202,1814,14301,311,152,159
21830,16919,2614,8205,1814,14305,311,152,159
21835,16923,2614,8206,1814,14309,311,152,159
21840,16926,2615,8209,1815,14311,311,152,159
21845,16927,2615,8209,1815,14312,311,152,159
21850,16932,2616,8211,1815,14316,311,152,159
21855,16934,2617,8212,1815,14317,311,152,159
21860,16942,2618,8215,1815,14324,311,152,159
21865,16945,2618,8216,1815,14327,311,152,159
21870,16950,2619,8217,1815,14331,312,152,160
21875,16954,2619,8220,1815,14335,312,152,160
21880,16957,2619,8221,1815,14338,312,152,160
21885,16958,2620,8222,1816,14338,312,152,160
21890,16963,2621,8225,1817,14342,312,152,160
21895,16965,2622,8226,1817,14343,312,152,160
21900,16973,2625,8229,1819,14348,312,152,160
21905,16976,2625,8231,1819,14351,312,152,160
21910,16981,2626,8233,1820,14355,312,152,160
21915,16985,2626,8235,1820,14359,312,152,160
21920,16988,2626,8237,1820,14362,312,152,160
21925,16989,2627,8238,1821,14362,312,152,160
21930,16994,2628,8240,1821,14365,312,152,160
21935,16996,2630,8240,1822,14366,312,152,160
21940,17004,2631,8244,1823,14373,312,152,160
21945,17007,2631,8246,1823,14376,312,152,160
21950,17012,2632,8249,1824,14380,312,152,160
21955,17016,2632,8251,1824,14384,312,152,160
21960,17019,2632,8251,1824,14387,312,152,160
21965,17020,2632,8251,1824,14388,312,152,160
21970,17025,2633,8253,1825,14392,312,152,160
21975,17027,2634,8254,1826,14393,312,152,160
21980,17035,2635,8258,1827,14400,312,152,160
21985,17038,2635,8259,1827,14403,312,152,160
21990,17043,2635,8262,1827,14408,312,152,160
21995,17047,2636,8266,1828,14410,312,152,160
22000,17050,2637,8267,1829,14413,312,152,160
22005,17051,2637,8267,1829,14414,312,152,160
22010,17056,2638,8270,1830,14417,312,152,160
22015,17058,2640,8272,1832,14418,312,152,160
22020,17066,2641,8276,1832,14425,312,152,160
22025,17069,2641,8277,1832,14428,312,152,160
22030,17074,2641,8281,1832,14433,313,153,160
22035,17078,2641,8282,1832,14437,313,153,160
22040,17081,2641,8285,1832,14440,313,153,160
22045,17082,2641,8285,1832,14441,313,153,160
22050,17087,2642,8288,1832,14445,313,153,160
22055,17089,2642,8290,1832,14447,313,153,160
22060,17097,2644,8293,1834,14453,313,153,160
22065,17100,2644,8295,1834,14456,313,153,160
22070,17105,2645,8298,1835,14460,314,153,161
22075,17109,2645,8300,1835,14464,314,153,161
22080,17112,2645,8303,1835,14467,314,153,161
22085,17113,2645,8303,1835,14468,314,153,161
22090,17118,2646,8306,1836,14471,314,153,161
22095,17120,2648,8307,1837,14472,314,153,161
22100,17128,2649,8310,1838,14479,314,153,161
22105,17131,2649,8311,1838,14482,314,153,161
22110,17136,2650,8312,1838,14486,314,153,161
22115,17140,2650,8315,1838,14489,314,153,161
22120,17143,2651,8315,1839,14492,314,153,161
22125,17144,2651,8315,1839,14493,314,153,161
22130,17149,2652,8319,1840,14496,314,153,161
22135,17151,2654,8319,1841,14497,314,153,161
22140,17159,2655,8322,1841,14504,314,153,161
22145,17162,2656,8325,1842,14506,314,153,161
22150,17167,2657,8329,1842,14510,314,153,161
22155,17171,2657,8332,1842,14513,314,153,161
22160,17174,2658,8334,1843,14516,314,153,161
22165,17175,2659,8335,1844,14516,314,153,161
22170,17180,2660,8338,1845,14520,314,153,161
22175,17182,2660,8339,1845,14522,314,153,161
22180,17190,2661,8343,1846,14529,314,153,161
22185,17193,2662,8346,1847,14531,314,153,161
22190,17198,2663,8347,1847,14535,314,153,161
22195,17202,2664,8349,1848,14538,314,153,161
22200,17205,2665,8351,1849,14540,314,153,161
22205,17206,2666,8352,1850,14540,314,153,161
22210,17211,2667,8353,1850,14544,314,153,161
22215,17213,2667,8354,1850,14546,314,153,161
22220,17221,2668,8356,1851,14553,314,153,161
22225,17224,2668,8357,1851,14556,314,153,161
22230,17229,2669,8359,1852,14560,315,153,162
22235,17233,2669,8361,1852,14564,315,153,162
22240,17236,2670,8363,1853,14566,315,153,162
22245,17237,2670,8363,1853,14567,315,153,162
22250,17242,2671,8364,1853,14571,315,153,162
22255,17244,2672,8365,1853,14572,315,153,162
22260,17252,2674,8369,1855,14578,315,153,162
22265,17255,2674,8370,1855,14581,315,153,162
22270,17260,2675,8371,1855,14585,315,153,162
22275,17264,2675,8371,1855,14589,315,153,162
22280,17267,2675,8373,1855,14592,315,153,162
22285,17268,2676,8374,1856,14592,315,153,162
22290,17273,2677,8377,1856,14595,315,153,162
22295,17275,2679,8379,1858,14596,315,153,162
22300,17283,2680,8380,1858,14603,315,153,162
22305,17286,2680,8381,1858,14606,315,153,162
22310,17291,2681,8382,1858,14610,315,153,162
22315,17295,2681,8385,1858,14613,315,153,162
22320,17298,2682,8386,1859,14616,315,153,162
22325,17299,2682,8386,1859,14617,315,153,162
22330,17304,2683,8389,1860,14621,315,153,162
22335,17306,2684,8390,1860,14622,315,153,162
22340,17314,2685,8394,1860,14629,315,153,162
22345,17317,2685,8397,1860,14632,315,153,162
22350,17322,2686,8401,1860,14636,315,153,162
22355,17326,2686,8403,1860,14639,315,153,162
22360,17329,2687,8404,1861,14642,315,153,162
22365,17330,2688,8405,1862,14642,315,153,162
22370,17335,2689,8407,1863,14646,315,153,162
22375,17337,2690,8409,1864,14647,315,153,162
22380,17345,2692,8411,1865,14653,315,153,162
22385,17348,2692,8412,1865,14656,315,153,162
22390,17353,2692,8416,1865,14661,316,153,163
22395,17357,2692,8417,1865,14665,316,153,163
22400,17360,2692,8418,1865,14668,316,153,163
22405,17361,2692,8418,1865,14669,316,153,163
22410,17366,2692,8418,1865,14674,316,153,163
22415,17368,2692,8418,1865,14676,316,153,163
22420,17376,2693,8421,1866,14683,316,153,163
22425,17379,2693,8421,1866,14686,316,153,163
22430,17384,2693,8424,1866,14691,317,154,163
22435,17388,2693,8425,1866,14695,317,154,163
22440,17391,2693,8425,1866,14698,317,154,163
22445,17392,2693,8425,1866,14699,317,154,163
22450,17397,2693,8427,1866,14704,317,154,163
22455,17399,2693,8429,1866,14706,317,154,163
22460,17407,2694,8432,1866,14713,317,154,163
22465,17410,2694,8433,1866,14716,317,154,163
22470,17415,2694,8436,1866,14721,318,155,163
22475,17419,2694,8439,1866,14725,318,155,163
22480,17422,2694,8441,1866,14728,318,155,163
22485,17423,2694,8441,1866,14729,318,155,163
22490,17428,2695,8443,1866,14732,318,155,163
22495,17430,2697,8444,1868,14733,318,155,163
22500,17438,2698,8448,1868,14740,318,155,163
22505,17441,2699,8450,1869,14742,318,155,163
22510,17446,2700,8452,1869,14746,318,155,163
22515,17450,2700,8455,1869,14749,318,155,163
22520,17453,2701,8455,1870,14752,318,155,163
22525,17454,2701,8455,1870,14753,318,155,163
22530,17459,2702,8457,1870,14757,318,155,163
22535,17461,2703,8458,1871,14758,318,155,163
22540,17469,2704,8461,1871,14765,318,155,163
22545,17472,2704,8462,1871,14768,318,155,163
22550,17477,2705,8464,1872,14772,318,155,163
22555,17481,2705,8467,1872,14776,318,155,163
22560,17484,2705,8470,1872,14779,318,155,163
22565,17485,2706,8471,1873,14779,318,155,163
22570,17490,2707,8473,1874,14783,318,155,163
22575,17492,2708,8474,1875,14784,318,155,163
22580,17500,2709,8476,1876,14791,318,155,163
22585,17503,2709,8479,1876,14794,318,155,163
22590,17508,2710,8481,1877,14798,318,155,163
22595,17512,2710,8483,1877,14801,318,155,163
22600,17515,2711,8486,1878,14804,318,155,163
22605,17516,2711,8486,1878,14805,318,155,163
22610,17521,2712,8487,1878,14809,318,155,163
22615,17523,2713,8488,1878,14810,318,155,163
22620,17531,2714,8490,1879,14817,318,155,163
22625,17534,2714,8493,1879,14820,318,155,163
22630,17539,2716,8496,1880,14823,318,155,163
22635,17543,2716,8498,1880,14827,318,155,163
22640,17546,2716,8500,1880,14830,318,155,163
22645,17547,2717,8501,1881,14830,318,155,163
22650,17552,2718,8503,1881,14833,318,155,163
22655,17554,2720,8503,1882,14834,318,155,163
22660,17562,2721,8506,1882,14841,318,155,163
22665,17565,2721,8509,1882,14844,318,155,163
22670,17570,2722,8512,1883,14848,318,155,163
22675,17574,2722,8513,1883,14852,318,155,163
22680,17577,2723,8516,1884,14854,318,155,163
22685,17578,2723,8516,1884,14855,318,155,163
22690,17583,2724,8520,1884,14858,318,155,163
22695,17585,2726,8521,1885,14859,318,155,163
22700,17593,2727,8523,1886,14866,318,155,163
22705,17596,2728,8524,1887,14868,318,155,163
22710,17601,2729,8527,1887,14872,318,155,163
22715,17605,2729,8530,1887,14876,318,155,163
22720,17608,2729,8533,1887,14879,318,155,163
22725,17609,2730,8534,1888,14879,318,155,163
22730,17614,2731,8536,1889,14883,318,155,163
22735,17616,2732,8537,1890,14884,318,155,163
22740,17624,2733,8539,1890,14891,318,155,163
22745,17627,2733,8540,1890,14894,318,155,163
22750,17632,2734,8541,1891,14898,318,155,163
22755,17636,2734,8543,1891,14902,318,155,163
22760,17639,2734,8546,1891,14905,318,155,163
22765,17640,2735,8547,1892,14905,318,155,163
22770,17645,2736,8548,1892,14909,318,155,163
22775,17647,2737,8550,1893,14910,318,155,163
22780,17655,2739,8556,1894,14916,318,155,163
22785,17658,2739,8557,1894,14919,318,155,163
22790,17663,2740,8561,1895,14923,318,155,163
22795,17667,2740,8562,1895,14927,318,155,163
22800,17670,2740,8562,1895,14930,318,155,163
22805,17671,2741,8563,1896,14930,318,155,163
22810,17676,2742,8566,1897,14933,318,155,163
22815,17678,2744,8567,1898,14934,318,155,163
22820,17686,2745,8571,1899,14941,318,155,163
22825,17689,2745,8571,1899,14944,318,155,163
22830,17694,2746,8571,1899,14948,318,155,163
22835,17698,2746,8573,1899,14951,318,155,163
22840,17701,2748,8575,1901,14953,318,155,163
22845,17702,2748,8575,1901,14954,318,155,163
22850,17707,2749,8578,1901,14958,318,155,163
22855,17709,2750,8579,1902,14959,318,155,163
22860,17717,2751,8583,1903,14966,318,155,163
22865,17720,2751,8584,1903,14969,318,155,163
22870,17725,2752,8587,1904,14973,318,155,163
22875,17729,2752,8589,1904,14977,318,155,163
22880,17732,2752,8590,1904,14980,318,155,163
22885,17733,2752,8591,1904,14981,318,155,163
22890,17738,2752,8593,1904,14986,318,155,163
22895,17740,2752,8594,1904,14988,318,155,163
22900,17748,2753,8597,1904,14995,318,155,163
22905,17751,2753,8597,1904,14998,318,155,163
22910,17756,2754,8602,1905,15002,318,155,163
22915,17760,2754,8602,1905,15006,318,155,163
22920,17763,2754,8603,1905,15009,318,155,163
22925,17764,2754,8603,1905,15010,318,155,163
22930,17769,2754,8606,1905,15015,318,155,163
22935,17771,2754,8607,1905,15017,318,155,163
22940,17779,2755,8611,1905,15024,318,155,163
22945,17782,2755,8611,1905,15027,318,155,163
22950,17787,2756,8614,1906,15031,318,155,163
22955,17791,2756,8616,1906,15035,318,155,163
22960,17794,2756,8617,1906,15038,318,155,163
22965,17795,2756,8617,1906,15039,318,155,163
22970,17800,2757,8619,1906,15042,318,155,163
22975,17802,2759,8619,1907,15043,318,155,163
22980,17810,2762,8624,1910,15048,318,155,163
22985,17813,2762,8626,1910,15051,318,155,163
22990,17818,2763,8628,1910,15055,318,155,163
22995,17822,2763,8630,1910,15059,318,155,163
23000,17825,2763,8631,1910,15062,318,155,163
23005,17826,2764,8632,1911,15062,318,155,163
23010,17831,2765,8633,1911,15066,318,155,163
23015,17833,2766,8634,1912,15067,318,155,163
23020,17841,2767,8638,1912,15074,318,155,163
23025,17844,2767,8641,1912,15077,318,155,163
23030,17849,2768,8643,1912,15081,318,155,163
23035,17853,2768,8645,1912,15085,318,155,163
23040,17856,2768,8646,1912,15088,318,155,163
23045,17857,2769,8647,1913,15088,318,155,163
23050,17862,2770,8650,1914,15092,318,155,163
23055,17864,2771,8651,1914,15093,318,155,163
23060,17872,2772,8655,1915,15100,318,155,163
23065,17875,2772,8656,1915,15103,318,155,163
23070,17880,2773,8659,1916,15107,318,155,163
23075,17884,2773,8662,1916,15110,318,155,163
23080,17887,2774,8664,1917,15113,318,155,163
23085,17888,2775,8665,1918,15113,318,155,163
23090,17893,2776,8667,1918,15117,318,155,163
23095,17895,2777,8668,1918,15118,318,155,163
23100,17903,2779,8674,1920,15124,318,155,163
23105,17906,2779,8674,1920,15127,318,155,163
23110,17911,2779,8677,1920,15132,318,155,163
23115,17915,2779,8678,1920,15136,318,155,163
23120,17918,2779,8679,1920,15139,318,155,163
23125,17919,2779,8679,1920,15140,318,155,163
23130,17924,2779,8681,1920,15145,318,155,163
23135,17926,2779,8682,1920,15147,318,155,163
23140,17934,2780,8688,1921,15154,318,155,163
23145,17937,2780,8690,1921,15157,318,155,163
23150,17942,2780,8692,1921,15162,318,155,163
23155,17946,2780,8693,1921,15166,318,155,163
23160,17949,2780,8696,1921,15169,318,155,163
23165,17950,2780,8697,1921,15170,318,155,163
23170,17955,2780,8699,1921,15175,318,155,163
23175,17957,2780,8699,1921,15177,318,155,163
23180,17965,2781,8705,1922,15184,318,155,163
23185,17968,2782,8707,1923,15186,318,155,163
23190,17973,2782,8710,1923,15191,318,155,163
23195,17977,2782,8712,1923,15195,318,155,163
23200,17980,2782,8714,1923,15198,318,155,163
23205,17981,2782,8714,1923,15199,318,155,163
23210,17986,2783,8716,1924,15203,318,155,163
23215,17988,2784,8718,1925,15204,318,155,163
23220,17996,2786,8723,1927,15210,318,155,163
23225,17999,2786,8724,1927,15213,318,155,163
23230,18004,2787,8727,1928,15217,319,155,164
23235,18008,2787,8729,1928,15220,319,155,164
23240,18011,2788,8731,1929,15223,319,155,164
23245,18012,2788,8732,1929,15224,319,155,164
23250,18017,2789,8735,1929,15228,319,155,164
23255,18019,2790,8736,1929,15229,319,155,164
23260,18027,2791,8743,1930,15236,319,155,164
23265,18030,2791,8744,1930,15239,319,155,164
23270,18035,2792,8747,1930,15243,320,155,165
23275,18039,2792,8748,1930,15247,320,155,165
23280,18042,2792,8750,1930,15250,320,155,165
23285,18043,2792,8750,1930,15251,320,155,165
23290,18048,2793,8755,1931,15254,320,155,165
23295,18050,2795,8755,1932,15255,320,155,165
23300,18058,2796,8759,1933,15262,320,155,165
23305,18061,2796,8762,1933,15265,320,155,165
23310,18066,2797,8764,1933,15269,320,155,165
23315,18070,2797,8768,1933,15272,320,155,165
23320,18073,2798,8770,1934,15275,320,155,165
23325,18074,2799,8771,1935,15275,320,155,165
23330,18079,2800,8772,1935,15279,320,155,165
23335,18081,2801,8772,1935,15280,320,155,165
23340,18089,2802,8774,1935,15287,320,155,165
23345,18092,2802,8774,1935,15290,320,155,165
23350,18097,2802,8776,1935,15295,320,155,165
23355,18101,2802,8777,1935,15299,320,155,165
23360,18104,2802,8778,1935,15302,320,155,165
23365,18105,2803,8779,1936,15302,320,155,165
23370,18110,2804,8782,1937,15306,320,155,165
23375,18112,2805,8783,1938,15307,320,155,165
23380,18120,2807,8786,1940,15313,320,155,165
23385,18123,2807,8788,1940,15316,320,155,165
23390,18128,2807,8791,1940,15321,320,155,165
23395,18132,2807,8792,1940,15325,320,155,165
23400,18135,2807,8793,1940,15328,320,155,165
23405,18136,2808,8794,1941,15328,320,155,165
23410,18141,2809,8797,1942,15332,320,155,165
23415,18143,2809,8799,1942,15334,320,155,165
23420,18151,2810,8802,1942,15341,320,155,165
23425,18154,2811,8805,1943,15343,320,155,165
23430,18159,2811,8808,1943,15348,320,155,165
23435,18163,2811,8809,1943,15352,320,155,165
23440,18166,2811,8809,1943,15355,320,155,165
23445,18167,2811,8809,1943,15356,320,155,165
23450,18172,2812,8810,1943,15360,320,155,165
23455,18174,2812,8811,1943,15362,320,155,165
23460,18182,2815,8815,1945,15367,320,155,165
23465,18185,2816,8816,1946,15369,320,155,165
23470,18190,2817,8820,1947,15373,320,155,165
23475,18194,2817,8823,1947,15376,320,155,165
23480,18197,2818,8824,1948,15379,320,155,165
23485,18198,2818,8825,1948,15380,320,155,165
23490,18203,2818,8829,1948,15385,320,155,165
23495,18205,2818,8830,1948,15387,320,155,165
23500,18213,2819,8832,1948,15394,320,155,165
23505,18216,2819,8833,1948,15397,320,155,165
23510,18221,2820,8836,1949,15401,321,156,165
23515,18225,2820,8839,1949,15404,321,156,165
23520,18228,2821,8841,1950,15407,321,156,165
23525,18229,2821,8842,1950,15408,321,156,165
23530,18234,2821,8845,1950,15413,321,156,165
23535,18236,2822,8845,1950,15414,321,156,165
23540,18244,2823,8850,1951,15421,321,156,165
23545,18247,2823,8853,1951,15424,321,156,165
23550,18252,2824,8855,1952,15428,322,156,166
23555,18256,2824,8857,1952,15432,322,156,166
23560,18259,2824,8858,1952,15435,322,156,166
23565,18260,2824,8859,1952,15436,322,156,166
23570,18265,2825,8860,1952,15440,322,156,166
23575,18267,2826,8861,1953,15441,322,156,166
23580,18275,2828,8867,1954,15447,322,156,166
23585,18278,2828,8868,1954,15450,322,156,166
23590,18283,2829,8871,1955,15454,323,157,166
23595,18287,2829,8872,1955,15458,323,157,166
23600,18290,2829,8873,1955,15461,323,157,166
23605,18291,2829,8873,1955,15462,323,157,166
23610,18296,2830,8873,1955,15466,323,157,166
23615,18298,2831,8873,1955,15467,323,157,166
23620,18306,2833,8878,1957,15473,323,157,166
23625,18309,2833,8878,1957,15476,323,157,166
23630,18314,2834,8881,1958,15480,324,158,166
23635,18318,2834,8883,1958,15484,324,158,166
23640,18321,2835,8885,1959,15486,324,158,166
23645,18322,2835,8885,1959,15487,324,158,166
23650,18327,2836,8888,1959,15491,324,158,166
23655,18329,2837,8889,1960,15492,324,158,166
23660,18337,2839,8893,1961,15498,324,158,166
23665,18340,2840,8895,1962,15500,324,158,166
23670,18345,2840,8898,1962,15505,324,158,166
23675,18349,2840,8899,1962,15509,324,158,166
23680,18352,2840,8901,1962,15512,324,158,166
23685,18353,2840,8901,1962,15513,324,158,166
23690,18358,2841,8904,1962,15517,324,158,166
23695,18360,2842,8905,1963,15518,324,158,166
23700,18368,2844,8910,1964,15524,324,158,166
23705,18371,2844,8912,1964,15527,324,158,166
23710,18376,2845,8914,1964,15531,324,158,166
23715,18380,2845,8917,1964,15534,324,158,166
23720,18383,2846,8919,1965,15537,324,158,166
23725,18384,2846,8920,1965,15538,324,158,166
23730,18389,2847,8923,1965,15542,324,158,166
23735,18391,2848,8925,1966,15543,324,158,166
23740,18399,2849,8930,1966,15550,324,158,166
23745,18402,2849,8931,1966,15553,324,158,166
23750,18407,2850,8934,1966,15557,325,158,167
23755,18411,2850,8937,1966,15560,325,158,167
23760,18414,2851,8939,1967,15563,325,158,167
23765,18415,2851,8940,1967,15564,325,158,167
23770,18420,2852,8944,1967,15567,325,158,167
23775,18422,2854,8944,1968,15568,325,158,167
23780,18430,2856,8950,1970,15574,325,158,167
23785,18433,2856,8951,1970,15577,325,158,167
23790,18438,2856,8953,1970,15582,325,158,167
23795,18442,2856,8955,1970,15585,325,158,167
23800,18445,2857,8956,1971,15588,325,158,167
23805,18446,2857,8956,1971,15589,325,158,167
23810,18451,2858,8961,1972,15592,325,158,167
23815,18453,2860,8962,1973,15593,325,158,167
23820,18461,2861,8967,1974,15600,325,158,167
23825,18464,2862,8968,1975,15602,325,158,167
23830,18469,2862,8971,1975,15607,325,158,167
23835,18473,2862,8971,1975,15611,325,158,167
23840,18476,2862,8972,1975,15614,325,158,167
23845,18477,2862,8972,1975,15615,325,158,167
23850,18482,2863,8974,1976,15619,325,158,167
23855,18484,2864,8976,1977,15620,325,158,167
23860,18492,2866,8978,1978,15626,325,158,167
23865,18495,2867,8980,1979,15628,325,158,167
23870,18500,2868,8980,1979,15632,326,158,168
23875,18504,2869,8984,1980,15634,326,158,168
23880,18507,2870,8986,1981,15637,326,158,168
23885,18508,2871,8987,1982,15637,326,158,168
23890,18513,2872,8989,1982,15641,326,158,168
23895,18515,2873,8990,1983,15642,326,158,168
23900,18523,2874,8993,1983,15649,326,158,168
23905,18526,2874,8994,1983,15652,326,158,168
23910,18531,2875,8997,1984,15656,327,158,169
23915,18535,2875,8998,1984,15660,327,158,169
23920,18538,2875,8999,1984,15663,327,158,169
23925,18539,2876,9000,1985,15663,327,158,169
23930,18544,2877,9001,1986,15667,327,158,169
23935,18546,2878,9001,1986,15668,327,158,169
23940,18554,2880,9005,1988,15674,327,158,169
23945,18557,2880,9006,1988,15677,327,158,169
23950,18562,2881,9011,1989,15681,327,158,169
23955,18566,2881,9013,1989,15685,327,158,169
23960,18569,2881,9015,1989,15688,327,158,169
23965,18570,2882,9016,1990,15688,327,158,169
23970,18575,2883,9020,1991,15691,327,158,169
23975,18577,2885,9021,1992,15692,327,158,169
23980,18585,2886,9025,1993,15699,327,158,169
23985,18588,2887,9026,1994,15701,327,158,169
23990,18593,2888,9029,1995,15705,327,158,169
23995,18597,2889,9032,1996,15708,327,158,169
24000,18600,2889,9032,1996,15711,327,158,169
24005,18601,2890,9033,1997,15711,327,158,169
24010,18606,2891,9035,1998,15715,327,158,169
24015,18608,2891,9035,1998,15717,327,158,169
24020,18616,2892,9038,1999,15724,327,158,169
24025,18619,2892,9040,1999,15727,327,158,169
24030,18624,2892,9042,1999,15732,327,158,169
24035,18628,2892,9043,1999,15736,327,158,169
24040,18631,2892,9045,1999,15739,327,158,169
24045,18632,2893,9046,2000,15739,327,158,169
24050,18637,2894,9046,2000,15743,327,158,169
24055,18639,2894,9046,2000,15745,327,158,169
24060,18647,2896,9053,2002,15751,327,158,169
24065,18650,2896,9055,2002,15754,327,158,169
24070,18655,2896,9059,2002,15759,327,158,169
24075,18659,2896,9060,2002,15763,327,158,169
24080,18662,2896,9061,2002,15766,327,158,169
24085,18663,2896,9061,2002,15767,327,158,169
24090,18668,2896,9065,2002,15772,327,158,169
24095,18670,2896,9066,2002,15774,327,158,169
24100,18678,2898,9072,2004,15780,327,158,169
24105,18681,2898,9072,2004,15783,327,158,169
24110,18686,2899,9074,2005,15787,328,158,170
24115,18690,2899,9076,2005,15790,328,158,170
24120,18693,2900,9076,2006,15793,328,158,170
24125,18694,2900,9076,2006,15794,328,158,170
24130,18699,2900,9078,2006,15799,328,158,170
24135,18701,2901,9078,2006,15800,328,158,170
24140,18709,2902,9082,2007,15807,328,158,170
24145,18712,2902,9082,2007,15810,328,158,170
24150,18717,2903,9085,2007,15814,329,158,171
24155,18721,2903,9087,2007,15817,329,158,171
24160,18724,2904,9089,2008,15820,329,158,171
24165,18725,2904,9089,2008,15821,329,158,171
24170,18730,2905,9094,2009,15824,329,158,171
24175,18732,2907,9096,2011,15825,329,158,171
24180,18740,2908,9101,2012,15832,329,158,171
24185,18743,2909,9104,2013,15834,329,158,171
24190,18748,2910,9106,2013,15838,330,159,171
24195,18752,2910,9109,2013,15841,330,159,171
24200,18755,2911,9109,2014,15844,330,159,171
24205,18756,2911,9109,2014,15845,330,159,171
24210,18761,2912,9113,2015,15849,330,159,171
24215,18763,2913,9113,2015,15850,330,159,171
24220,18771,2914,9115,2015,15857,330,159,171
24225,18774,2915,9117,2016,15859,330,159,171
24230,18779,2916,9118,2017,15863,331,159,172
24235,18783,2916,9118,2017,15867,331,159,172
24240,18786,2916,9120,2017,15870,331,159,172
24245,18787,2916,9121,2017,15871,331,159,172
24250,18792,2917,9123,2017,15875,331,159,172
24255,18794,2918,9125,2018,15876,331,159,172
24260,18802,2919,9132,2019,15883,331,159,172
24265,18805,2919,9132,2019,15886,331,159,172
24270,18810,2920,9135,2020,15890,331,159,172
24275,18814,2920,9136,2020,15894,331,159,172
24280,18817,2920,9137,2020,15897,331,159,172
24285,18818,2920,9137,2020,15898,331,159,172
24290,18823,2921,9139,2020,15902,331,159,172
24295,18825,2922,9139,2020,15903,331,159,172
24300,18833,2923,9142,2021,15910,331,159,172
24305,18836,2923,9144,2021,15913,331,159,172
24310,18841,2924,9148,2022,15917,331,159,172
24315,18845,2924,9151,2022,15921,331,159,172
24320,18848,2924,9153,2022,15924,331,159,172
24325,18849,2925,9154,2023,15924,331,159,172
24330,18854,2926,9156,2024,15928,331,159,172
24335,18856,2927,9158,2025,15929,331,159,172
24340,18864,2928,9162,2025,15936,331,159,172
24345,18867,2928,9164,2025,15939,331,159,172
24350,18872,2930,9167,2027,15942,332,160,172
24355,18876,2930,9170,2027,15945,332,160,172
24360,18879,2932,9173,2029,15947,332,160,172
24365,18880,2932,9173,2029,15948,332,160,172
24370,18885,2933,9176,2030,15952,332,160,172
24375,18887,2933,9178,2030,15954,332,160,172
24380,18895,2934,9179,2030,15961,332,160,172
24385,18898,2934,9180,2030,15964,332,160,172
24390,18903,2935,9185,2031,15968,333,161,172
24395,18907,2935,9188,2031,15971,333,161,172
24400,18910,2937,9189,2033,15973,333,161,172
24405,18911,2937,9189,2033,15974,333,161,172
24410,18916,2938,9191,2033,15978,333,161,172
24415,18918,2938,9192,2033,15980,333,161,172
24420,18926,2939,9195,2033,15987,333,161,172
24425,18929,2940,9197,2034,15989,333,161,172
24430,18934,2941,9199,2034,15993,333,161,172
24435,18938,2941,9201,2034,15996,333,161,172
24440,18941,2942,9201,2035,15999,333,161,172
24445,18942,2943,9202,2036,15999,333,161,172
24450,18947,2944,9206,2037,16003,333,161,172
24455,18949,2944,9207,2037,16005,333,161,172
24460,18957,2945,9209,2038,16012,333,161,172
24465,18960,2946,9210,2039,16014,333,161,172
24470,18965,2947,9211,2040,16018,333,161,172
24475,18969,2948,9215,2041,16020,333,161,172
24480,18972,2950,9217,2043,16022,333,161,172
24485,18973,2950,9217,2043,16023,333,161,172
24490,18978,2951,9221,2044,16026,333,161,172
24495,18980,2953,9222,2046,16027,333,161,172
24500,18988,2955,9226,2048,16033,333,161,172
24505,18991,2955,9227,2048,16036,333,161,172
24510,18996,2955,9228,2048,16041,334,161,173
24515,19000,2955,9229,2048,16045,334,161,173
24520,19003,2955,9230,2048,16048,334,161,173
24525,19004,2955,9230,2048,16049,334,161,173
24530,19009,2956,9232,2048,16052,334,161,173
24535,19011,2958,9232,2049,16053,334,161,173
24540,19019,2961,9236,2051,16058,334,161,173
24545,19022,2962,9238,2052,16060,334,161,173
24550,19027,2962,9240,2052,16065,334,161,173
24555,19031,2962,9241,2052,16069,334,161,173
24560,19034,2962,9244,2052,16072,334,161,173
24565,19035,2963,9245,2053,16072,334,161,173
24570,19040,2964,9247,2053,16075,334,161,173
24575,19042,2966,9248,2054,16076,334,161,173
24580,19050,2968,9252,2055,16082,334,161,173
24585,19053,2968,9254,2055,16085,334,161,173
24590,19058,2969,9254,2055,16089,334,161,173
24595,19062,2970,9256,2056,16091,334,161,173
24600,19065,2971,9256,2057,16094,334,161,173
24605,19066,2972,9257,2058,16094,334,161,173
24610,19071,2973,9259,2058,16098,334,161,173
24615,19073,2973,9261,2058,16100,334,161,173
24620,19081,2974,9266,2058,16107,334,161,173
24625,19084,2974,9266,2058,16110,334,161,173
24630,19089,2974,9270,2058,16115,334,161,173
24635,19093,2974,9274,2058,16118,334,161,173
24640,19096,2975,9276,2059,16121,334,161,173
24645,19097,2976,9277,2060,16121,334,161,173
24650,19102,2977,9279,2061,16125,334,161,173
24655,19104,2977,9280,2061,16127,334,161,173
24660,19112,2978,9283,2061,16134,334,161,173
24665,19115,2978,9283,2061,16137,334,161,173
24670,19120,2980,9287,2063,16140,335,161,174
24675,19124,2980,9290,2063,16143,335,161,174
24680,19127,2982,9292,2065,16145,335,161,174
24685,19128,2982,9293,2065,16146,335,161,174
24690,19133,2982,9296,2065,16151,335,161,174
24695,19135,2982,9297,2065,16153,335,161,174
24700,19143,2984,9302,2067,16159,335,161,174
24705,19146,2984,9303,2067,16162,335,161,174
24710,19151,2985,9304,2068,16166,336,161,175
24715,19155,2985,9305,2068,16170,336,161,175
24720,19158,2985,9306,2068,16173,336,161,175
24725,19159,2985,9306,2068,16174,336,161,175
24730,19164,2985,9309,2068,16179,336,161,175
24735,19166,2986,9310,2069,16180,336,161,175
24740,19174,2987,9312,2069,16187,336,161,175
24745,19177,2988,9314,2070,16189,336,161,175
24750,19182,2989,9317,2071,16193,336,161,175
24755,19186,2989,9319,2071,16197,336,161,175
24760,19189,2989,9321,2071,16200,336,161,175
24765,19190,2989,9322,2071,16201,336,161,175
24770,19195,2990,9326,2072,16205,336,161,175
24775,19197,2991,9328,2073,16206,336,161,175
24780,19205,2992,9333,2074,16213,336,161,175
24785,19208,2992,9334,2074,16216,336,161,175
24790,19213,2993,9336,2074,16220,336,161,175
24795,19217,2993,9337,2074,16224,336,161,175
24800,19220,2993,9340,2074,16227,336,161,175
24805,19221,2993,9340,2074,16228,336,161,175
24810,19226,2994,9342,2075,16232,336,161,175
24815,19228,2995,9342,2075,16233,336,161,175
24820,19236,2997,9346,2076,16239,336,161,175
24825,19239,2997,9346,2076,16242,336,161,175
24830,19244,2998,9348,2076,16246,337,162,175
24835,19248,2998,9350,2076,16250,337,162,175
24840,19251,2998,9350,2076,16253,337,162,175
24845,19252,2999,9351,2077,16253,337,162,175
24850,19257,3000,9353,2077,16257,337,162,175
24855,19259,3001,9355,2078,16258,337,162,175
24860,19267,3003,9358,2080,16264,337,162,175
24865,19270,3003,9360,2080,16267,337,162,175
24870,19275,3003,9363,2080,16272,338,163,175
24875,19279,3003,9365,2080,16275,338,163,175
24880,19282,3004,9366,2081,16278,338,163,175
24885,19283,3004,9366,2081,16279,338,163,175
24890,19288,3005,9368,2081,16283,338,163,175
24895,19290,3006,9368,2081,16284,338,163,175
24900,19298,3007,9371,2082,16291,338,163,175
24905,19301,3007,9373,2082,16294,338,163,175
24910,19306,3007,9374,2082,16299,338,163,175
24915,19310,3007,9376,2082,16303,338,163,175
24920,19313,3007,9377,2082,16306,338,163,175
24925,19314,3007,9377,2082,16307,338,163,175
24930,19319,3008,9380,2083,16311,338,163,175
24935,19321,3009,9381,2083,16312,338,163,175
24940,19329,3010,9385,2084,16319,338,163,175
24945,19332,3010,9387,2084,16322,338,163,175
24950,19337,3011,9391,2085,16326,338,163,175
24955,19341,3011,9392,2085,16330,338,163,175
24960,19344,3012,9394,2086,16332,338,163,175
24965,19345,3012,9394,2086,16333,338,163,175
24970,19350,3013,9397,2087,16337,338,163,175
24975,19352,3014,9398,2088,16338,338,163,175
24980,19360,3016,9402,2090,16344,338,163,175
24985,19363,3016,9402,2090,16347,338,163,175
24990,19368,3017,9406,2091,16351,339,163,176
24995,19372,3017,9409,2091,16354,339,163,176
25000,19375,3018,9409,2092,16357,339,163,176
25005,19376,3018,9409,2092,16358,339,163,176
25010,19381,3019,9413,2092,16361,339,163,176
25015,19383,3021,9414,2094,16362,339,163,176
25020,19391,3022,9417,2095,16369,339,163,176
25025,19394,3022,9417,2095,16372,339,163,176
25030,19399,3023,9420,2095,16376,339,163,176
25035,19403,3023,9422,2095,16380,339,163,176
25040,19406,3023,9423,2095,16383,339,163,176
25045,19407,3024,9424,2096,16383,339,163,176
25050,19412,3025,9426,2096,16387,339,163,176
25055,19414,3026,9428,2097,16388,339,163,176
25060,19422,3027,9433,2098,16395,339,163,176
25065,19425,3027,9434,2098,16398,339,163,176
25070,19430,3028,9435,2099,16402,339,163,176
25075,19434,3029,9439,2100,16405,339,163,176
25080,19437,3029,9440,2100,16408,339,163,176
25085,19438,3029,9440,2100,16409,339,163,176
25090,19443,3030,9443,2101,16413,339,163,176
25095,19445,3031,9444,2102,16414,339,163,176
25100,19453,3032,9449,2103,16421,339,163,176
25105,19456,3032,9451,2103,16424,339,163,176
25110,19461,3033,9454,2103,16428,339,163,176
25115,19465,3033,9455,2103,16432,339,163,176
25120,19468,3033,9456,2103,16435,339,163,176
25125,19469,3034,9457,2104,16435,339,163,176
25130,19474,3035,9460,2105,16439,339,163,176
25135,19476,3036,9460,2105,16440,339,163,176
25140,19484,3038,9464,2106,16446,339,163,176
25145,19487,3038,9466,2106,16449,339,163,176
25150,19492,3039,9470,2106,16453,339,163,176
25155,19496,3039,9471,2106,16457,339,163,176
25160,19499,3040,9472,2107,16459,339,163,176
25165,19500,3040,9472,2107,16460,339,163,176
25170,19505,3041,9473,2107,16464,339,163,176
25175,19507,3041,9475,2107,16466,339,163,176
25180,19515,3042,9478,2107,16473,339,163,176
25185,19518,3042,9480,2107,16476,339,163,176
25190,19523,3043,9484,2107,16480,339,163,176
25195,19527,3043,9486,2107,16483,339,163,176
25200,19530,3044,9488,2108,16486,339,163,176
25205,19531,3045,9489,2109,16486,339,163,176
25210,19536,3046,9490,2110,16490,339,163,176
25215,19538,3046,9490,2110,16492,339,163,176
25220,19546,3048,9496,2112,16498,339,163,176
25225,19549,3048,9499,2112,16501,339,163,176
25230,19554,3048,9500,2112,16506,339,163,176
25235,19558,3048,9501,2112,16510,339,163,176
25240,19561,3048,9502,2112,16513,339,163,176
25245,19562,3049,9503,2113,16513,339,163,176
25250,19567,3050,9505,2113,16517,339,163,176
25255,19569,3051,9506,2114,16518,339,163,176
25260,19577,3053,9510,2116,16524,339,163,176
25265,19580,3054,9512,2117,16526,339,163,176
25270,19585,3054,9514,2117,16531,339,163,176
25275,19589,3054,9517,2117,16535,339,163,176
25280,19592,3054,9517,2117,16538,339,163,176
25285,19593,3054,9518,2117,16539,339,163,176
25290,19598,3054,9521,2117,16543,339,163,176
25295,19600,3056,9523,2119,16544,339,163,176
25300,19608,3058,9525,2120,16550,339,163,176
25305,19611,3058,9526,2120,16553,339,163,176
25310,19616,3059,9528,2120,16557,340,164,176
25315,19620,3059,9529,2120,16561,340,164,176
25320,19623,3059,9530,2120,16564,340,164,176
25325,19624,3059,9531,2120,16565,340,164,176
25330,19629,3059,9533,2120,16570,340,164,176
25335,19631,3060,9534,2120,16571,340,164,176
25340,19639,3062,9540,2122,16577,340,164,176
25345,19642,3062,9541,2122,16580,340,164,176
25350,19647,3063,9542,2123,16584,341,164,177
25355,19651,3063,9543,2123,16587,341,164,177
25360,19654,3065,9544,2125,16589,341,164,177
25365,19655,3065,9545,2125,16590,341,164,177
25370,19660,3066,9549,2126,16593,341,164,177
25375,19662,3068,9549,2127,16594,341,164,177
25380,19670,3070,9554,2129,16600,341,164,177
25385,19673,3070,9555,2129,16603,341,164,177
25390,19678,3071,9557,2129,16607,342,165,177
25395,19682,3071,9559,2129,16611,342,165,177
25400,19685,3071,9560,2129,16614,342,165,177
25405,19686,3072,9561,2130,16614,342,165,177
25410,19691,3073,9564,2130,16618,342,165,177
25415,19693,3073,9565,2130,16620,342,165,177
25420,19701,3074,9570,2131,16627,342,165,177
25425,19704,3074,9571,2131,16630,342,165,177
25430,19709,3075,9573,2131,16634,343,166,177
25435,19713,3075,9575,2131,16638,343,166,177
25440,19716,3076,9577,2132,16640,343,166,177
25445,19717,3076,9577,2132,16641,343,166,177
25450,19722,3077,9578,2133,16645,343,166,177
25455,19724,3077,9579,2133,16647,343,166,177
25460,19732,3078,9585,2133,16654,343,166,177
25465,19735,3078,9587,2133,16657,343,166,177
25470,19740,3079,9590,2134,16661,343,166,177
25475,19744,3079,9594,2134,16665,343,166,177
25480,19747,3080,9596,2135,16667,343,166,177
25485,19748,3081,9597,2136,16667,343,166,177
25490,19753,3082,9599,2137,16671,343,166,177
25495,19755,3083,9600,2138,16672,343,166,177
25500,19763,3086,9604,2140,16677,343,166,177
25505,19766,3086,9604,2140,16680,343,166,177
25510,19771,3087,9607,2140,16684,343,166,177
25515,19775,3087,9608,2140,16688,343,166,177
25520,19778,3087,9611,2140,16691,343,166,177
25525,19779,3088,9612,2141,16691,343,166,177
25530,19784,3089,9613,2141,16695,343,166,177
25535,19786,3090,9614,2141,16696,343,166,177
25540,19794,3091,9617,2141,16703,343,166,177
25545,19797,3091,9619,2141,16706,343,166,177
25550,19802,3092,9621,2142,16710,344,166,178
25555,19806,3092,9625,2142,16713,344,166,178
25560,19809,3093,9628,2143,16716,344,166,178
25565,19810,3093,9628,2143,16717,344,166,178
25570,19815,3094,9630,2144,16721,344,166,178
25575,19817,3095,9631,2145,16722,344,166,178
25580,19825,3096,9634,2145,16729,344,166,178
25585,19828,3096,9636,2145,16732,344,166,178
25590,19833,3097,9637,2145,16736,344,166,178
25595,19837,3097,9640,2145,16739,344,166,178
25600,19840,3098,9641,2146,16742,344,166,178
25605,19841,3099,9642,2147,16742,344,166,178
25610,19846,3100,9646,2148,16745,344,166,178
25615,19848,3102,9646,2149,16746,344,166,178
25620,19856,3105,9651,2151,16751,344,166,178
25625,19859,3105,9652,2151,16754,344,166,178
25630,19864,3106,9657,2152,16758,344,166,178
25635,19868,3106,9658,2152,16762,344,166,178
25640,19871,3107,9660,2153,16764,344,166,178
25645,19872,3107,9661,2153,16765,344,166,178
25650,19877,3107,9663,2153,16769,344,166,178
25655,19879,3109,9663,2154,16770,344,166,178
25660,19887,3110,9666,2154,16777,344,166,178
25665,19890,3110,9668,2154,16780,344,166,178
25670,19895,3111,9670,2154,16784,345,167,178
25675,19899,3111,9673,2154,16788,345,167,178
25680,19902,3112,9674,2155,16790,345,167,178
25685,19903,3112,9674,2155,16791,345,167,178
25690,19908,3112,9676,2155,16796,345,167,178
25695,19910,3112,9677,2155,16798,345,167,178
25700,19918,3113,9680,2155,16805,345,167,178
25705,19921,3114,9682,2156,16807,345,167,178
25710,19926,3115,9684,2156,16811,345,167,178
25715,19930,3115,9686,2156,16815,345,167,178
25720,19933,3115,9687,2156,16818,345,167,178
25725,19934,3115,9688,2156,16819,345,167,178
25730,19939,3116,9690,2156,16823,345,167,178
25735,19941,3116,9691,2156,16825,345,167,178
25740,19949,3117,9693,2157,16832,345,167,178
25745,19952,3117,9695,2157,16835,345,167,178
25750,19957,3118,9697,2157,16839,345,167,178
25755,19961,3118,9697,2157,16843,345,167,178
25760,19964,3118,9699,2157,16846,345,167,178
25765,19965,3118,9699,2157,16847,345,167,178
25770,19970,3119,9702,2157,16851,345,167,178
25775,19972,3119,9703,2157,16853,345,167,178
25780,19980,3120,9707,2157,16860,345,167,178
25785,19983,3120,9708,2157,16863,345,167,178
25790,19988,3121,9709,2157,16867,345,167,178
25795,19992,3121,9710,2157,16871,345,167,178
25800,19995,3121,9712,2157,16874,345,167,178
25805,19996,3122,9713,2158,16874,345,167,178
25810,20001,3123,9715,2158,16877,345,167,178
25815,20003,3125,9716,2160,16878,345,167,178
25820,20011,3127,9720,2161,16884,345,167,178
25825,20014,3128,9721,2162,16886,345,167,178
25830,20019,3128,9725,2162,16891,346,167,179
25835,20023,3128,9728,2162,16895,346,167,179
25840,20026,3128,9729,2162,16898,346,167,179
25845,20027,3128,9729,2162,16899,346,167,179
25850,20032,3129,9730,2162,16903,346,167,179
25855,20034,3130,9731,2163,16904,346,167,179
25860,20042,3131,9735,2164,16911,346,167,179
25865,20045,3131,9736,2164,16914,346,167,179
25870,20050,3131,9738,2164,16919,346,167,179
25875,20054,3131,9741,2164,16923,346,167,179
25880,20057,3131,9743,2164,16926,346,167,179
25885,20058,3132,9744,2165,16926,346,167,179
25890,20063,3133,9749,2166,16929,346,167,179
25895,20065,3135,9749,2167,16930,346,167,179
25900,20073,3136,9754,2168,16937,346,167,179
25905,20076,3136,9756,2168,16940,346,167,179
25910,20081,3137,9758,2169,16944,346,167,179
25915,20085,3137,9760,2169,16948,346,167,179
25920,20088,3137,9762,2169,16951,346,167,179
25925,20089,3137,9762,2169,16952,346,167,179
25930,20094,3137,9765,2169,16957,346,167,179
25935,20096,3138,9767,2170,16958,346,167,179
25940,20104,3140,9772,2172,16964,346,167,179
25945,20107,3140,9773,2172,16967,346,167,179
25950,20112,3141,9774,2172,16971,346,167,179
25955,20116,3141,9774,2172,16975,346,167,179
25960,20119,3141,9775,2172,16978,346,167,179
25965,20120,3141,9776,2172,16979,346,167,179
25970,20125,3141,9777,2172,16984,346,167,179
25975,20127,3142,9777,2172,16985,346,167,179
25980,20135,3144,9781,2173,16991,346,167,179
25985,20138,3144,9783,2173,16994,346,167,179
25990,20143,3145,9786,2174,16998,346,167,179
25995,20147,3145,9787,2174,17002,346,167,179
26000,20150,3145,9788,2174,17005,346,167,179
26005,20151,3145,9788,2174,17006,346,167,179
26010,20156,3145,9790,2174,17011,346,167,179
26015,20158,3146,9791,2175,17012,346,167,179
26020,20166,3147,9794,2176,17019,346,167,179
26025,20169,3147,9794,2176,17022,346,167,179
26030,20174,3148,9795,2176,17026,346,167,179
26035,20178,3148,9798,2176,17029,346,167,179
26040,20181,3150,9800,2178,17031,346,167,179
26045,20182,3151,9801,2179,17031,346,167,179
26050,20187,3152,9802,2180,17035,346,167,179
26055,20189,3153,9803,2181,17036,346,167,179
26060,20197,3154,9808,2181,17043,346,167,179
26065,20200,3155,9810,2182,17045,346,167,179
26070,20205,3156,9811,2182,17049,346,167,179
26075,20209,3156,9813,2182,17053,346,167,179
26080,20212,3157,9815,2183,17055,346,167,179
26085,20213,3158,9816,2184,17055,346,167,179
26090,20218,3159,9819,2184,17058,346,167,179
26095,20220,3161,9820,2186,17059,346,167,179
26100,20228,3163,9822,2188,17065,346,167,179
26105,20231,3163,9823,2188,17068,346,167,179
26110,20236,3164,9827,2189,17072,346,167,179
26115,20240,3164,9829,2189,17076,346,167,179
26120,20243,3164,9829,2189,17079,346,167,179
26125,20244,3165,9830,2190,17079,346,167,179
26130,20249,3166,9831,2190,17083,346,167,179
26135,20251,3166,9833,2190,17085,346,167,179
26140,20259,3167,9836,2190,17092,346,167,179
26145,20262,3167,9836,2190,17095,346,167,179
26150,20267,3168,9839,2191,17099,347,168,179
26155,20271,3168,9841,2191,17102,347,168,179
26160,20274,3169,9842,2192,17105,347,168,179
26165,20275,3170,9843,2193,17105,347,168,179
26170,20280,3171,9845,2193,17109,347,168,179
26175,20282,3171,9845,2193,17111,347,168,179
26180,20290,3172,9846,2193,17118,347,168,179
26185,20293,3172,9846,2193,17121,347,168,179
26190,20298,3173,9848,2193,17125,348,169,179
26195,20302,3173,9850,2193,17128,348,169,179
26200,20305,3174,9852,2194,17131,348,169,179
26205,20306,3175,9853,2195,17131,348,169,179
26210,20311,3176,9855,2196,17135,348,169,179
26215,20313,3177,9856,2196,17136,348,169,179
26220,20321,3179,9858,2197,17142,348,169,179
26225,20324,3180,9860,2198,17144,348,169,179
26230,20329,3180,9863,2198,17149,348,169,179
26235,20333,3180,9866,2198,17152,348,169,179
26240,20336,3182,9867,2200,17154,348,169,179
26245,20337,3183,9868,2201,17154,348,169,179
26250,20342,3184,9870,2202,17157,348,169,179
26255,20344,3186,9870,2203,17158,348,169,179
26260,20352,3187,9873,2203,17165,348,169,179
26265,20355,3187,9874,2203,17168,348,169,179
26270,20360,3187,9875,2203,17173,348,169,179
26275,20364,3187,9878,2203,17176,348,169,179
26280,20367,3188,9880,2204,17179,348,169,179
26285,20368,3189,9881,2205,17179,348,169,179
26290,20373,3190,9883,2206,17183,348,169,179
26295,20375,3190,9884,2206,17185,348,169,179
26300,20383,3191,9890,2207,17192,348,169,179
26305,20386,3191,9892,2207,17195,348,169,179
26310,20391,3191,9894,2207,17200,348,169,179
26315,20395,3191,9897,2207,17203,348,169,179
26320,20398,3192,9899,2208,17206,348,169,179
26325,20399,3192,9899,2208,17207,348,169,179
26330,20404,3193,9900,2209,17211,348,169,179
26335,20406,3193,9900,2209,17213,348,169,179
26340,20414,3196,9906,2212,17218,348,169,179
26345,20417,3197,9907,2213,17220,348,169,179
26350,20422,3198,9909,2213,17224,348,169,179
26355,20426,3198,9911,2213,17227,348,169,179
26360,20429,3200,9912,2215,17229,348,169,179
26365,20430,3200,9912,2215,17230,348,169,179
26370,20435,3200,9915,2215,17235,348,169,179
26375,20437,3200,9915,2215,17237,348,169,179
26380,20445,3201,9920,2216,17244,348,169,179
26385,20448,3201,9922,2216,17247,348,169,179
26390,20453,3202,9924,2217,17251,348,169,179
26395,20457,3202,9924,2217,17255,348,169,179
26400,20460,3202,9924,2217,17258,348,169,179
26405,20461,3202,9925,2217,17259,348,169,179
26410,20466,3202,9930,2217,17263,348,169,179
26415,20468,3204,9932,2219,17264,348,169,179
26420,20476,3205,9934,2219,17271,348,169,179
26425,20479,3205,9936,2219,17274,348,169,179
26430,20484,3206,9939,2220,17278,348,169,179
26435,20488,3206,9940,2220,17282,348,169,179
26440,20491,3206,9942,2220,17285,348,169,179
26445,20492,3206,9943,2220,17286,348,169,179
26450,20497,3207,9946,2221,17290,348,169,179
26455,20499,3208,9947,2222,17291,348,169,179
26460,20507,3210,9951,2223,17297,348,169,179
26465,20510,3210,9952,2223,17300,348,169,179
26470,20515,3210,9956,2223,17305,348,169,179
26475,20519,3210,9958,2223,17308,348,169,179
26480,20522,3211,9959,2224,17311,348,169,179
26485,20523,3212,9960,2225,17311,348,169,179
26490,20528,3213,9962,2226,17315,348,169,179
26495,20530,3214,9963,2226,17316,348,169,179
26500,20538,3215,9964,2226,17323,348,169,179
26505,20541,3215,9966,2226,17326,348,169,179
26510,20546,3215,9968,2226,17331,348,169,179
26515,20550,3215,9970,2226,17334,348,169,179
26520,20553,3216,9972,2227,17337,348,169,179
26525,20554,3216,9972,2227,17338,348,169,179
26530,20559,3217,9974,2228,17341,348,169,179
26535,20561,3219,9974,2229,17342,348,169,179
26540,20569,3220,9978,2230,17349,348,169,179
26545,20572,3221,9979,2231,17351,348,169,179
26550,20577,3221,9982,2231,17356,348,169,179
26555,20581,3221,9984,2231,17359,348,169,179
26560,20584,3222,9984,2232,17362,348,169,179
26565,20585,3222,9985,2232,17363,348,169,179
26570,20590,3223,9986,2232,17366,348,169,179
26575,20592,3225,9988,2234,17367,348,169,179
26580,20600,3227,9992,2235,17373,348,169,179
26585,20603,3228,9994,2236,17375,348,169,179
26590,20608,3229,9999,2237,17379,348,169,179
26595,20612,3229,10003,2237,17383,348,169,179
26600,20615,3230,10006,2238,17385,348,169,179
26605,20616,3230,10006,2238,17386,348,169,179
26610,20621,3231,10010,2239,17389,348,169,179
26615,20623,3233,10011,2241,17390,348,169,179
26620,20631,3234,10016,2242,17397,348,169,179
26625,20634,3234,10017,2242,17400,348,169,179
26630,20639,3235,10019,2242,17404,348,169,179
26635,20643,3235,10021,2242,17408,348,169,179
26640,20646,3235,10022,2242,17411,348,169,179
26645,20647,3235,10022,2242,17412,348,169,179
26650,20652,3236,10024,2243,17416,348,169,179
26655,20654,3236,10025,2243,17418,348,169,179
26660,20662,3237,10029,2244,17425,348,169,179
26665,20665,3237,10030,2244,17428,348,169,179
26670,20670,3238,10033,2245,17432,348,169,179
26675,20674,3238,10036,2245,17436,348,169,179
26680,20677,3238,10036,2245,17439,348,169,179
26685,20678,3239,10037,2246,17439,348,169,179
26690,20683,3240,10039,2246,17443,348,169,179
26695,20685,3240,10040,2246,17445,348,169,179
26700,20693,3241,10043,2247,17452,348,169,179
26705,20696,3241,10044,2247,17455,348,169,179
26710,20701,3242,10047,2248,17459,348,169,179
26715,20705,3242,10049,2248,17463,348,169,179
26720,20708,3242,10049,2248,17466,348,169,179
26725,20709,3242,10049,2248,17467,348,169,179
26730,20714,3243,10051,2248,17471,348,169,179
26735,20716,3243,10051,2248,17473,348,169,179
26740,20724,3244,10054,2249,17480,348,169,179
26745,20727,3244,10055,2249,17483,348,169,179
26750,20732,3245,10058,2250,17487,348,169,179
26755,20736,3245,10061,2250,17490,348,169,179
26760,20739,3247,10063,2252,17492,348,169,179
26765,20740,3248,10064,2253,17492,348,169,179
26770,20745,3249,10068,2254,17495,348,169,179
26775,20747,3251,10068,2255,17496,348,169,179
26780,20755,3252,10070,2255,17503,348,169,179
26785,20758,3252,10072,2255,17506,348,169,179
26790,20763,3253,10076,2256,17510,348,169,179
26795,20767,3253,10077,2256,17514,348,169,179
26800,20770,3253,10078,2256,17517,348,169,179
26805,20771,3253,10078,2256,17518,348,169,179
26810,20776,3254,10079,2257,17522,348,169,179
26815,20778,3255,10080,2257,17523,348,169,179
26820,20786,3257,10083,2258,17529,348,169,179
26825,20789,3257,10084,2258,17532,348,169,179
26830,20794,3258,10087,2259,17536,349,169,180
26835,20798,3258,10089,2259,17539,349,169,180
26840,20801,3259,10092,2260,17542,349,169,180
26845,20802,3259,10092,2260,17543,349,169,180
26850,20807,3259,10095,2260,17547,349,169,180
26855,20809,3261,10096,2261,17548,349,169,180
26860,20817,3263,10101,2262,17554,349,169,180
26865,20820,3263,10102,2262,17557,349,169,180
26870,20825,3264,10105,2263,17561,350,170,180
26875,20829,3264,10106,2263,17565,350,170,180
26880,20832,3265,10109,2264,17567,350,170,180
26885,20833,3265,10109,2264,17568,350,170,180
26890,20838,3265,10113,2264,17572,350,170,180
26895,20840,3267,10113,2265,17573,350,170,180
26900,20848,3268,10119,2265,17580,350,170,180
26905,20851,3269,10120,2266,17582,350,170,180
26910,20856,3270,10124,2267,17586,350,170,180
26915,20860,3270,10124,2267,17590,350,170,180
26920,20863,3271,10127,2268,17592,350,170,180
26925,20864,3271,10128,2268,17593,350,170,180
26930,20869,3272,10130,2268,17596,350,170,180
26935,20871,3274,10130,2269,17597,350,170,180
26940,20879,3275,10133,2269,17604,350,170,180
26945,20882,3276,10134,2270,17606,350,170,180
26950,20887,3277,10136,2270,17610,350,170,180
26955,20891,3277,10138,2270,17614,350,170,180
26960,20894,3277,10138,2270,17617,350,170,180
26965,20895,3278,10139,2271,17617,350,170,180
26970,20900,3279,10142,2271,17620,350,170,180
26975,20902,3281,10144,2273,17621,350,170,180
26980,20910,3282,10149,2274,17628,350,170,180
26985,20913,3283,10151,2275,17630,350,170,180
26990,20918,3284,10152,2275,17634,351,170,181
26995,20922,3284,10154,2275,17638,351,170,181
27000,20925,3285,10155,2276,17640,351,170,181
27005,20926,3286,10156,2277,17640,351,170,181
27010,20931,3287,10158,2277,17644,351,170,181
27015,20933,3287,10160,2277,17646,351,170,181
27020,20941,3288,10163,2278,17653,351,170,181
27025,20944,3288,10163,2278,17656,351,170,181
27030,20949,3289,10164,2278,17660,351,170,181
27035,20953,3289,10166,2278,17664,351,170,181
27040,20956,3289,10168,2278,17667,351,170,181
27045,20957,3289,10168,2278,17668,351,170,181
27050,20962,3290,10169,2278,17672,351,170,181
27055,20964,3290,10169,2278,17674,351,170,181
27060,20972,3293,10175,2281,17679,351,170,181
27065,20975,3293,10176,2281,17682,351,170,181
27070,20980,3294,10178,2281,17686,351,170,181
27075,20984,3294,10181,2281,17689,351,170,181
27080,20987,3295,10181,2282,17692,351,170,181
27085,20988,3296,10182,2283,17692,351,170,181
27090,20993,3297,10185,2283,17696,351,170,181
27095,20995,3297,10186,2283,17698,351,170,181
27100,21003,3298,10189,2284,17705,351,170,181
27105,21006,3299,10192,2285,17707,351,170,181
27110,21011,3300,10193,2285,17711,352,170,182
27115,21015,3300,10193,2285,17715,352,170,182
27120,21018,3300,10193,2285,17718,352,170,182
27125,21019,3300,10193,2285,17719,352,170,182
27130,21024,3301,10196,2286,17723,352,170,182
27135,21026,3302,10197,2286,17724,352,170,182
27140,21034,3303,10200,2286,17731,352,170,182
27145,21037,3303,10201,2286,17734,352,170,182
27150,21042,3303,10203,2286,17739,352,170,182
27155,21046,3303,10205,2286,17743,352,170,182
27160,21049,3303,10208,2286,17746,352,170,182
27165,21050,3303,10208,2286,17747,352,170,182
27170,21055,3304,10212,2287,17750,352,170,182
27175,21057,3306,10212,2288,17751,352,170,182
27180,21065,3307,10216,2288,17758,352,170,182
27185,21068,3307,10216,2288,17761,352,170,182
27190,21073,3307,10218,2288,17766,352,170,182
27195,21077,3307,10220,2288,17770,352,170,182
27200,21080,3307,10221,2288,17773,352,170,182
27205,21081,3307,10221,2288,17774,352,170,182
27210,21086,3308,10226,2289,17777,352,170,182
27215,21088,3310,10227,2291,17778,352,170,182
27220,21096,3311,10230,2292,17785,352,170,182
27225,21099,3311,10230,2292,17788,352,170,182
27230,21104,3311,10234,2292,17793,353,171,182
27235,21108,3311,10234,2292,17797,353,171,182
27240,21111,3311,10236,2292,17800,353,171,182
27245,21112,3311,10237,2292,17801,353,171,182
27250,21117,3312,10239,2293,17805,353,171,182
27255,21119,3312,10239,2293,17807,353,171,182
27260,21127,3314,10244,2295,17813,353,171,182
27265,21130,3315,10247,2296,17815,353,171,182
27270,21135,3316,10250,2296,17819,353,171,182
27275,21139,3316,10252,2296,17822,353,171,182
27280,21142,3317,10252,2297,17825,353,171,182
27285,21143,3317,10252,2297,17826,353,171,182
27290,21148,3318,10254,2297,17830,353,171,182
27295,21150,3318,10255,2297,17832,353,171,182
27300,21158,3320,10259,2298,17838,353,171,182
27305,21161,3321,10260,2299,17840,353,171,182
27310,21166,3322,10262,2299,17844,353,171,182
27315,21170,3322,10263,2299,17848,353,171,182
27320,21173,3322,10263,2299,17851,353,171,182
27325,21174,3322,10263,2299,17852,353,171,182
27330,21179,3323,10267,2300,17856,353,171,182
27335,21181,3323,10268,2300,17858,353,171,182
27340,21189,3324,10272,2300,17865,353,171,182
27345,21192,3325,10272,2300,17867,353,171,182
27350,21197,3326,10273,2300,17871,354,171,183
27355,21201,3326,10276,2300,17874,354,171,183
27360,21204,3327,10277,2301,17877,354,171,183
27365,21205,3327,10277,2301,17878,354,171,183
27370,21210,3328,10279,2302,17882,354,171,183
27375,21212,3329,10281,2303,17883,354,171,183
27380,21220,3330,10286,2304,17890,354,171,183
27385,21223,3331,10288,2305,17892,354,171,183
27390,21228,3332,10292,2306,17896,354,171,183
27395,21232,3332,10294,2306,17900,354,171,183
27400,21235,3333,10297,2307,17902,354,171,183
27405,21236,3334,10298,2308,17902,354,171,183
27410,21241,3335,10300,2308,17905,354,171,183
27415,21243,3337,10301,2310,17906,354,171,183
27420,21251,3339,10306,2311,17912,354,171,183
27425,21254,3339,10308,2311,17915,354,171,183
27430,21259,3340,10312,2312,17919,354,171,183
27435,21263,3340,10312,2312,17923,354,171,183
27440,21266,3341,10314,2313,17925,354,171,183
27445,21267,3341,10314,2313,17926,354,171,183
27450,21272,3342,10316,2314,17930,354,171,183
27455,21274,3342,10316,2314,17932,354,171,183
27460,21282,3343,10317,2314,17939,354,171,183
27465,21285,3343,10319,2314,17942,354,171,183
27470,21290,3344,10323,2315,17946,355,172,183
27475,21294,3344,10325,2315,17950,355,172,183
27480,21297,3345,10327,2316,17952,355,172,183
27485,21298,3345,10327,2316,17953,355,172,183
27490,21303,3346,10328,2316,17957,355,172,183
27495,21305,3346,10329,2316,17959,355,172,183
27500,21313,3348,10333,2317,17965,355,172,183
27505,21316,3349,10333,2317,17967,355,172,183
27510,21321,3350,10333,2317,17971,356,172,184
27515,21325,3350,10335,2317,17975,356,172,184
27520,21328,3350,10336,2317,17978,356,172,184
27525,21329,3350,10336,2317,17979,356,172,184
27530,21334,3351,10339,2317,17983,356,172,184
27535,21336,3352,10341,2318,17984,356,172,184
27540,21344,3354,10346,2320,17990,356,172,184
27545,21347,3354,10348,2320,17993,356,172,184
27550,21352,3355,10350,2321,17997,356,172,184
27555,21356,3355,10350,2321,18001,356,172,184
27560,21359,3356,10352,2322,18003,356,172,184
27565,21360,3357,10353,2323,18003,356,172,184
27570,21365,3358,10355,2324,18007,356,172,184
27575,21367,3359,10356,2325,18008,356,172,184
27580,21375,3361,10360,2326,18014,356,172,184
27585,21378,3361,10361,2326,18017,356,172,184
27590,21383,3362,10365,2327,18021,356,172,184
27595,21387,3362,10367,2327,18024,356,172,184
27600,21390,3363,10368,2328,18027,356,172,184
27605,21391,3363,10369,2328,18028,356,172,184
27610,21396,3363,10371,2328,18033,356,172,184
27615,21398,3364,10373,2329,18034,356,172,184
27620,21406,3366,10377,2330,18040,356,172,184
27625,21409,3366,10377,2330,18043,356,172,184
27630,21414,3367,10380,2330,18047,356,172,184
27635,21418,3367,10381,2330,18051,356,172,184
27640,21421,3367,10382,2330,18054,356,172,184
27645,21422,3367,10382,2330,18055,356,172,184
27650,21427,3367,10383,2330,18060,356,172,184
27655,21429,3368,10385,2331,18061,356,172,184
27660,21437,3370,10391,2333,18067,356,172,184
27665,21440,3371,10391,2333,18069,356,172,184
27670,21445,3372,10393,2333,18073,356,172,184
27675,21449,3372,10396,2333,18077,356,172,184
27680,21452,3372,10399,2333,18080,356,172,184
27685,21453,3372,10400,2333,18081,356,172,184
27690,21458,3372,10401,2333,18086,356,172,184
27695,21460,3373,10403,2334,18087,356,172,184
27700,21468,3375,10409,2336,18093,356,172,184
27705,21471,3376,10411,2336,18095,356,172,184
27710,21476,3377,10416,2337,18099,356,172,184
27715,21480,3377,10418,2337,18102,356,172,184
27720,21483,3378,10420,2338,18105,356,172,184
27725,21484,3379,10421,2339,18105,356,172,184
27730,21489,3380,10421,2339,18109,356,172,184
27735,21491,3381,10422,2340,18110,356,172,184
27740,21499,3383,10424,2341,18116,356,172,184
27745,21502,3383,10426,2341,18119,356,172,184
27750,21507,3384,10427,2341,18123,356,172,184
27755,21511,3384,10429,2341,18126,356,172,184
27760,21514,3385,10429,2342,18129,356,172,184
27765,21515,3385,10429,2342,18130,356,172,184
27770,21520,3386,10432,2342,18133,356,172,184
27775,21522,3388,10433,2343,18134,356,172,184
27780,21530,3390,10438,2344,18140,356,172,184
27785,21533,3391,10439,2344,18142,356,172,184
27790,21538,3391,10440,2344,18147,356,172,184
27795,21542,3391,10443,2344,18151,356,172,184
27800,21545,3391,10444,2344,18154,356,172,184
27805,21546,3391,10444,2344,18155,356,172,184
27810,21551,3391,10447,2344,18160,356,172,184
27815,21553,3392,10449,2345,18161,356,172,184
27820,21561,3394,10452,2346,18167,356,172,184
27825,21564,3395,10453,2346,18169,356,172,184
27830,21569,3395,10458,2346,18174,356,172,184
27835,21573,3395,10461,2346,18178,356,172,184
27840,21576,3396,10463,2347,18180,356,172,184
27845,21577,3396,10463,2347,18181,356,172,184
27850,21582,3397,10466,2347,18184,356,172,184
27855,21584,3399,10468,2349,18185,356,172,184
27860,21592,3401,10472,2351,18191,356,172,184
27865,21595,3401,10472,2351,18194,356,172,184
27870,21600,3401,10475,2351,18199,356,172,184
27875,21604,3401,10477,2351,18203,356,172,184
27880,21607,3401,10480,2351,18206,356,172,184
27885,21608,3401,10481,2351,18207,356,172,184
27890,21613,3402,10485,2352,18210,356,172,184
27895,21615,3404,10487,2354,18211,356,172,184
27900,21623,3406,10490,2356,18217,356,172,184
27905,21626,3406,10490,2356,18220,356,172,184
27910,21631,3407,10494,2356,18224,357,173,184
27915,21635,3407,10494,2356,18228,357,173,184
27920,21638,3407,10495,2356,18231,357,173,184
27925,21639,3407,10496,2356,18232,357,173,184
27930,21644,3408,10500,2357,18235,357,173,184
27935,21646,3410,10501,2359,18236,357,173,184
27940,21654,3411,10506,2360,18243,357,173,184
27945,21657,3411,10507,2360,18246,357,173,184
27950,21662,3412,10511,2361,18250,358,173,185
27955,21666,3412,10513,2361,18253,358,173,185
27960,21669,3414,10515,2363,18255,358,173,185
27965,21670,3415,10516,2364,18255,358,173,185
27970,21675,3416,10516,2364,18259,358,173,185
27975,21677,3416,10517,2364,18261,358,173,185
27980,21685,3417,10521,2364,18268,358,173,185
27985,21688,3418,10523,2365,18270,358,173,185
27990,21693,3419,10526,2366,18274,358,173,185
27995,21697,3419,10527,2366,18278,358,173,185
28000,21700,3420,10529,2367,18280,358,173,185
28005,21701,3421,10530,2368,18280,358,173,185
28010,21706,3422,10534,2369,18284,358,173,185
28015,21708,3422,10535,2369,18286,358,173,185
28020,21716,3424,10537,2369,18292,358,173,185
28025,21719,3425,10539,2370,18294,358,173,185
28030,21724,3426,10541,2370,18298,358,173,185
28035,21728,3426,10542,2370,18302,358,173,185
28040,21731,3427,10543,2371,18304,358,173,185
28045,21732,3427,10543,2371,18305,358,173,185
28050,21737,3428,10545,2371,18309,358,173,185
28055,21739,3428,10546,2371,18311,358,173,185
28060,21747,3430,10550,2372,18317,358,173,185
28065,21750,3431,10550,2372,18319,358,173,185
28070,21755,3432,10553,2373,18323,358,173,185
28075,21759,3432,10555,2373,18326,358,173,185
28080,21762,3434,10557,2375,18328,358,173,185
28085,21763,3435,10558,2376,18328,358,173,185
28090,21768,3436,10560,2376,18331,358,173,185
28095,21770,3438,10561,2378,18332,358,173,185
28100,21778,3440,10565,2380,18338,358,173,185
28105,21781,3440,10566,2380,18341,358,173,185
28110,21786,3441,10568,2380,18345,358,173,185
28115,21790,3441,10570,2380,18349,358,173,185
28120,21793,3441,10571,2380,18352,358,173,185
28125,21794,3441,10571,2380,18353,358,173,185
28130,21799,3442,10572,2380,18357,358,173,185
28135,21801,3443,10572,2380,18358,358,173,185
28140,21809,3446,10575,2382,18363,358,173,185
28145,21812,3447,10575,2382,18365,358,173,185
28150,21817,3448,10578,2383,18369,358,173,185
28155,21821,3448,10581,2383,18372,358,173,185
28160,21824,3449,10582,2384,18375,358,173,185
28165,21825,3449,10582,2384,18376,358,173,185
28170,21830,3450,10586,2385,18379,358,173,185
28175,21832,3452,10587,2386,18380,358,173,185
28180,21840,3453,10593,2387,18387,358,173,185
28185,21843,3454,10596,2388,18389,358,173,185
28190,21848,3455,10600,2389,18393,358,173,185
28195,21852,3455,10601,2389,18397,358,173,185
28200,21855,3455,10603,2389,18400,358,173,185
28205,21856,3455,10603,2389,18401,358,173,185
28210,21861,3456,10606,2389,18405,358,173,185
28215,21863,3457,10607,2389,18406,358,173,185
28220,21871,3458,10612,2390,18413,358,173,185
28225,21874,3459,10612,2390,18415,358,173,185
28230,21879,3460,10615,2391,18419,358,173,185
28235,21883,3460,10618,2391,18423,358,173,185
28240,21886,3460,10619,2391,18426,358,173,185
28245,21887,3460,10619,2391,18427,358,173,185
28250,21892,3461,10624,2392,18430,358,173,185
28255,21894,3463,10625,2394,18431,358,173,185
28260,21902,3465,10629,2396,18437,358,173,185
28265,21905,3465,10629,2396,18440,358,173,185
28270,21910,3466,10630,2396,18444,358,173,185
28275,21914,3466,10633,2396,18448,358,173,185
28280,21917,3467,10636,2397,18450,358,173,185
28285,21918,3468,10637,2398,18450,358,173,185
28290,21923,3469,10640,2398,18453,358,173,185
28295,21925,3471,10640,2399,18454,358,173,185
28300,21933,3473,10645,2401,18460,358,173,185
28305,21936,3473,10648,2401,18463,358,173,185
28310,21941,3474,10650,2402,18467,358,173,185
28315,21945,3474,10653,2402,18470,358,173,185
28320,21948,3475,10654,2403,18473,358,173,185
28325,21949,3475,10654,2403,18474,358,173,185
28330,21954,3476,10657,2404,18478,358,173,185
28335,21956,3477,10658,2404,18479,358,173,185
28340,21964,3479,10661,2405,18485,358,173,185
28345,21967,3479,10663,2405,18488,358,173,185
28350,21972,3479,10665,2405,18493,358,173,185
28355,21976,3479,10666,2405,18497,358,173,185
28360,21979,3479,10668,2405,18500,358,173,185
28365,21980,3479,10669,2405,18501,358,173,185
28370,21985,3480,10672,2405,18504,358,173,185
28375,21987,3482,10673,2406,18505,358,173,185
28380,21995,3484,10675,2406,18511,358,173,185
28385,21998,3485,10675,2406,18513,358,173,185
28390,22003,3485,10678,2406,18518,358,173,185
28395,22007,3485,10680,2406,18522,358,173,185
28400,22010,3485,10681,2406,18525,358,173,185
28405,22011,3485,10681,2406,18526,358,173,185
28410,22016,3486,10685,2407,18530,358,173,185
28415,22018,3486,10686,2407,18532,358,173,185
28420,22026,3487,10689,2407,18539,358,173,185
28425,22029,3488,10691,2408,18541,358,173,185
28430,22034,3489,10693,2409,18545,358,173,185
28435,22038,3489,10694,2409,18548,358,173,185
28440,22041,3490,10695,2410,18551,358,173,185
28445,22042,3490,10695,2410,18552,358,173,185
28450,22047,3491,10697,2410,18556,358,173,185
28455,22049,3491,10699,2410,18558,358,173,185
28460,22057,3493,10703,2411,18564,358,173,185
28465,22060,3494,10705,2412,18566,358,173,185
28470,22065,3495,10707,2413,18570,358,173,185
28475,22069,3495,10708,2413,18573,358,173,185
28480,22072,3496,10709,2414,18576,358,173,185
28485,22073,3496,10709,2414,18577,358,173,185
28490,22078,3497,10710,2414,18581,358,173,185
28495,22080,3498,10711,2415,18582,358,173,185
28500,22088,3501,10715,2417,18587,358,173,185
28505,22091,3501,10717,2417,18590,358,173,185
28510,22096,3502,10720,2417,18594,359,174,185
28515,22100,3502,10721,2417,18597,359,174,185
28520,22103,3503,10722,2418,18600,359,174,185
28525,22104,3504,10723,2419,18600,359,174,185
28530,22109,3505,10724,2419,18604,359,174,185
28535,22111,3506,10726,2420,18605,359,174,185
28540,22119,3508,10731,2421,18611,359,174,185
28545,22122,3508,10732,2421,18614,359,174,185
28550,22127,3509,10733,2421,18618,360,174,186
28555,22131,3509,10735,2421,18622,360,174,186
28560,22134,3509,10736,2421,18625,360,174,186
28565,22135,3510,10737,2422,18625,360,174,186
28570,22140,3511,10738,2422,18629,360,174,186
28575,22142,3512,10738,2422,18630,360,174,186
28580,22150,3514,10741,2423,18636,360,174,186
28585,22153,3514,10742,2423,18639,360,174,186
28590,22158,3515,10745,2424,18643,360,174,186
28595,22162,3515,10746,2424,18647,360,174,186
28600,22165,3515,10747,2424,18650,360,174,186
28605,22166,3515,10747,2424,18651,360,174,186
28610,22171,3516,10749,2425,18655,360,174,186
28615,22173,3517,10750,2425,18656,360,174,186
28620,22181,3520,10754,2427,18661,360,174,186
28625,22184,3520,10756,2427,18664,360,174,186
28630,22189,3521,10757,2428,18668,360,174,186
28635,22193,3521,10759,2428,18672,360,174,186
28640,22196,3521,10759,2428,18675,360,174,186
28645,22197,3521,10759,2428,18676,360,174,186
28650,22202,3521,10761,2428,18681,360,174,186
28655,22204,3522,10763,2429,18682,360,174,186
28660,22212,3523,10768,2430,18689,360,174,186
28665,22215,3523,10768,2430,18692,360,174,186
28670,22220,3524,10770,2430,18696,360,174,186
28675,22224,3524,10772,2430,18700,360,174,186
28680,22227,3524,10773,2430,18703,360,174,186
28685,22228,3524,10773,2430,18704,360,174,186
28690,22233,3524,10776,2430,18709,360,174,186
28695,22235,3525,10777,2430,18710,360,174,186
28700,22243,3526,10779,2430,18717,360,174,186
28705,22246,3526,10781,2430,18720,360,174,186
28710,22251,3527,10782,2431,18724,360,174,186
28715,22255,3527,10784,2431,18728,360,174,186
28720,22258,3527,10785,2431,18731,360,174,186
28725,22259,3527,10785,2431,18732,360,174,186
28730,22264,3528,10788,2431,18735,360,174,186
28735,22266,3530,10789,2433,18736,360,174,186
28740,22274,3531,10793,2433,18743,360,174,186
28745,22277,3531,10795,2433,18746,360,174,186
28750,22282,3532,10798,2434,18750,360,174,186
28755,22286,3532,10799,2434,18754,360,174,186
28760,22289,3532,10801,2434,18757,360,174,186
28765,22290,3532,10801,2434,18758,360,174,186
28770,22295,3533,10802,2434,18761,360,174,186
28775,22297,3535,10802,2435,18762,360,174,186
28780,22305,3537,10805,2437,18768,360,174,186
28785,22308,3538,10807,2438,18770,360,174,186
28790,22313,3539,10808,2438,18774,360,174,186
28795,22317,3539,10811,2438,18778,360,174,186
28800,22320,3539,10813,2438,18781,360,174,186
28805,22321,3540,10814,2439,18781,360,174,186
28810,22326,3541,10816,2440,18785,360,174,186
28815,22328,3542,10817,2440,18786,360,174,186
28820,22336,3543,10821,2441,18793,360,174,186
28825,22339,3543,10821,2441,18796,360,174,186
28830,22344,3544,10824,2441,18800,360,174,186
28835,22348,3544,10826,2441,18804,360,174,186
28840,22351,3544,10827,2441,18807,360,174,186
28845,22352,3544,10827,2441,18808,360,174,186
28850,22357,3545,10829,2441,18811,360,174,186
28855,22359,3547,10829,2442,18812,360,174,186
28860,22367,3549,10832,2443,18818,360,174,186
28865,22370,3549,10834,2443,18821,360,174,186
28870,22375,3550,10837,2444,18825,360,174,186
28875,22379,3550,10839,2444,18829,360,174,186
28880,22382,3551,10841,2445,18831,360,174,186
28885,22383,3551,10841,2445,18832,360,174,186
28890,22388,3552,10845,2446,18836,360,174,186
28895,22390,3552,10847,2446,18838,360,174,186
28900,22398,3553,10852,2446,18845,360,174,186
28905,22401,3554,10854,2447,18847,360,174,186
28910,22406,3555,10855,2447,18851,360,174,186
28915,22410,3555,10858,2447,18855,360,174,186
28920,22413,3555,10859,2447,18858,360,174,186
28925,22414,3556,10860,2448,18858,360,174,186
28930,22419,3557,10862,2448,18862,360,174,186
28935,22421,3557,10863,2448,18864,360,174,186
28940,22429,3559,10867,2450,18870,360,174,186
28945,22432,3559,10868,2450,18873,360,174,186
28950,22437,3560,10871,2451,18877,360,174,186
28955,22441,3560,10872,2451,18881,360,174,186
28960,22444,3560,10874,2451,18884,360,174,186
28965,22445,3561,10875,2452,18884,360,174,186
28970,22450,3562,10877,2453,18888,360,174,186
28975,22452,3563,10878,2454,18889,360,174,186
28980,22460,3565,10882,2456,18895,360,174,186
28985,22463,3565,10883,2456,18898,360,174,186
28990,22468,3566,10886,2457,18902,360,174,186
28995,22472,3566,10887,2457,18906,360,174,186
29000,22475,3566,10888,2457,18909,360,174,186
29005,22476,3567,10889,2458,18909,360,174,186
29010,22481,3568,10890,2458,18913,360,174,186
29015,22483,3569,10890,2458,18914,360,174,186
29020,22491,3570,10894,2458,18921,360,174,186
29025,22494,3570,10895,2458,18924,360,174,186
29030,22499,3571,10897,2459,18928,360,174,186
29035,22503,3571,10899,2459,18932,360,174,186
29040,22506,3571,10899,2459,18935,360,174,186
29045,22507,3572,10900,2460,18935,360,174,186
29050,22512,3573,10903,2461,18939,360,174,186
29055,22514,3574,10904,2461,18940,360,174,186
29060,22522,3575,10908,2461,18947,360,174,186
29065,22525,3575,10908,2461,18950,360,174,186
29070,22530,3576,10909,2461,18954,360,174,186
29075,22534,3576,10911,2461,18958,360,174,186
29080,22537,3576,10913,2461,18961,360,174,186
29085,22538,3577,10914,2462,18961,360,174,186
29090,22543,3578,10918,2463,18964,360,174,186
29095,22545,3580,10919,2464,18965,360,174,186
29100,22553,3582,10923,2466,18971,360,174,186
29105,22556,3582,10923,2466,18974,360,174,186
29110,22561,3583,10926,2467,18978,360,174,186
29115,22565,3583,10929,2467,18981,360,174,186
29120,22568,3585,10930,2469,18983,360,174,186
29125,22569,3585,10930,2469,18984,360,174,186
29130,22574,3585,10935,2469,18988,360,174,186
29135,22576,3587,10935,2470,18989,360,174,186
29140,22584,3588,10940,2470,18996,360,174,186
29145,22587,3589,10943,2471,18998,360,174,186
29150,22592,3590,10945,2471,19002,360,174,186
29155,22596,3590,10947,2471,19005,360,174,186
29160,22599,3591,10948,2472,19008,360,174,186
29165,22600,3591,10948,2472,19009,360,174,186
29170,22605,3591,10950,2472,19014,360,174,186
29175,22607,3592,10951,2472,19015,360,174,186
29180,22615,3593,10953,2472,19022,360,174,186
29185,22618,3593,10955,2472,19025,360,174,186
29190,22623,3594,10958,2473,19029,360,174,186
29195,22627,3594,10961,2473,19033,360,174,186
29200,22630,3594,10963,2473,19036,360,174,186
29205,22631,3594,10963,2473,19037,360,174,186
29210,22636,3595,10966,2473,19041,360,174,186
29215,22638,3596,10968,2474,19042,360,174,186
29220,22646,3599,10972,2476,19047,360,174,186
29225,22649,3600,10974,2477,19049,360,174,186
29230,22654,3601,10975,2478,19053,360,174,186
29235,22658,3601,10976,2478,19057,360,174,186
29240,22661,3601,10977,2478,19060,360,174,186
29245,22662,3601,10977,2478,19061,360,174,186
29250,22667,3602,10982,2479,19064,360,174,186
29255,22669,3604,10982,2480,19065,360,174,186
29260,22677,3606,10987,2482,19071,360,174,186
29265,22680,3606,10987,2482,19074,360,174,186
29270,22685,3607,10992,2483,19078,360,174,186
29275,22689,3607,10992,2483,19082,360,174,186
29280,22692,3607,10993,2483,19085,360,174,186
29285,22693,3607,10993,2483,19086,360,174,186
29290,22698,3608,10996,2483,19089,360,174,186
29295,22700,3610,10997,2484,19090,360,174,186
29300,22708,3611,11001,2485,19097,360,174,186
29305,22711,3611,11002,2485,19100,360,174,186
29310,22716,3612,11005,2486,19104,360,174,186
29315,22720,3612,11007,2486,19108,360,174,186
29320,22723,3612,11008,2486,19111,360,174,186
29325,22724,3612,11008,2486,19112,360,174,186
29330,22729,3613,11009,2486,19116,360,174,186
29335,22731,3614,11011,2487,19117,360,174,186
29340,22739,3616,11015,2488,19123,360,174,186
29345,22742,3616,11017,2488,19126,360,174,186
29350,22747,3617,11019,2489,19130,360,174,186
29355,22751,3617,11020,2489,19134,360,174,186
29360,22754,3617,11023,2489,19137,360,174,186
29365,22755,3617,11023,2489,19138,360,174,186
29370,22760,3618,11026,2490,19142,360,174,186
29375,22762,3619,11026,2490,19143,360,174,186
29380,22770,3620,11032,2490,19150,360,174,186
29385,22773,3620,11033,2490,19153,360,174,186
29390,22778,3621,11036,2491,19157,360,174,186
29395,22782,3621,11036,2491,19161,360,174,186
29400,22785,3622,11038,2492,19163,360,174,186
29405,22786,3622,11038,2492,19164,360,174,186
29410,22791,3623,11041,2493,19168,360,174,186
29415,22793,3623,11041,2493,19170,360,174,186
29420,22801,3624,11046,2494,19177,360,174,186
29425,22804,3625,11047,2495,19179,360,174,186
29430,22809,3626,11049,2495,19183,360,174,186
29435,22813,3626,11053,2495,19186,360,174,186
29440,22816,3627,11053,2496,19189,360,174,186
29445,22817,3627,11053,2496,19190,360,174,186
29450,22822,3628,11056,2497,19194,360,174,186
29455,22824,3628,11057,2497,19196,360,174,186
29460,22832,3631,11062,2499,19201,360,174,186
29465,22835,3632,11065,2500,19203,360,174,186
29470,22840,3633,11066,2500,19207,360,174,186
29475,22844,3633,11067,2500,19211,360,174,186
29480,22847,3633,11067,2500,19214,360,174,186
29485,22848,3634,11068,2501,19214,360,174,186
29490,22853,3635,11072,2502,19218,360,174,186
29495,22855,3635,11073,2502,19220,360,174,186
29500,22863,3636,11078,2503,19227,360,174,186
29505,22866,3636,11079,2503,19230,360,174,186
29510,22871,3637,11083,2503,19234,361,175,186
29515,22875,3637,11085,2503,19238,361,175,186
29520,22878,3638,11087,2504,19240,361,175,186
29525,22879,3639,11088,2505,19240,361,175,186
29530,22884,3640,11092,2505,19243,361,175,186
29535,22886,3642,11093,2506,19244,361,175,186
29540,22894,3643,11096,2506,19251,361,175,186
29545,22897,3643,11098,2506,19254,361,175,186
29550,22902,3644,11101,2506,19258,361,175,186
29555,22906,3644,11102,2506,19262,361,175,186
29560,22909,3645,11104,2507,19264,361,175,186
29565,22910,3646,11105,2508,19264,361,175,186
29570,22915,3647,11107,2509,19267,361,175,186
29575,22917,3649,11107,2510,19268,361,175,186
29580,22925,3652,11112,2513,19273,361,175,186
29585,22928,3652,11114,2513,19276,361,175,186
29590,22933,3653,11115,2513,19280,361,175,186
29595,22937,3653,11118,2513,19284,361,175,186
29600,22940,3653,11121,2513,19287,361,175,186
29605,22941,3654,11122,2514,19287,361,175,186
29610,22946,3655,11124,2514,19291,361,175,186
29615,22948,3656,11126,2515,19292,361,175,186
29620,22956,3658,11131,2516,19298,361,175,186
29625,22959,3658,11133,2516,19301,361,175,186
29630,22964,3659,11133,2516,19305,362,175,187
29635,22968,3659,11133,2516,19309,362,175,187
29640,22971,3659,11136,2516,19312,362,175,187
29645,22972,3659,11136,2516,19313,362,175,187
29650,22977,3660,11139,2517,19316,362,175,187
29655,22979,3662,11140,2519,19317,362,175,187
29660,22987,3663,11145,2519,19324,362,175,187
29665,22990,3664,11147,2520,19326,362,175,187
29670,22995,3665,11151,2521,19330,363,176,187
29675,22999,3665,11151,2521,19334,363,176,187
29680,23002,3665,11152,2521,19337,363,176,187
29685,23003,3665,11152,2521,19338,363,176,187
29690,23008,3666,11154,2521,19341,363,176,187
29695,23010,3668,11156,2523,19342,363,176,187
29700,23018,3670,11161,2525,19348,363,176,187
29705,23021,3670,11163,2525,19351,363,176,187
29710,23026,3671,11167,2526,19355,363,176,187
29715,23030,3671,11168,2526,19359,363,176,187
29720,23033,3671,11169,2526,19362,363,176,187
29725,23034,3671,11169,2526,19363,363,176,187
29730,23039,3671,11172,2526,19368,363,176,187
29735,23041,3671,11173,2526,19370,363,176,187
29740,23049,3672,11175,2526,19377,363,176,187
29745,23052,3672,11177,2526,19380,363,176,187
29750,23057,3673,11180,2527,19384,363,176,187
29755,23061,3673,11182,2527,19388,363,176,187
29760,23064,3673,11182,2527,19391,363,176,187
29765,23065,3673,11182,2527,19392,363,176,187
29770,23070,3673,11185,2527,19397,363,176,187
29775,23072,3673,11186,2527,19399,363,176,187
29780,23080,3674,11190,2528,19406,363,176,187
29785,23083,3674,11190,2528,19409,363,176,187
29790,23088,3675,11192,2529,19413,363,176,187
29795,23092,3675,11195,2529,19417,363,176,187
29800,23095,3675,11196,2529,19420,363,176,187
29805,23096,3675,11197,2529,19421,363,176,187
29810,23101,3676,11199,2529,19425,363,176,187
29815,23103,3677,11201,2530,19426,363,176,187
29820,23111,3680,11207,2533,19431,363,176,187
29825,23114,3680,11208,2533,19434,363,176,187
29830,23119,3681,11209,2533,19438,363,176,187
29835,23123,3681,11212,2533,19441,363,176,187
29840,23126,3682,11213,2534,19444,363,176,187
29845,23127,3682,11213,2534,19445,363,176,187
29850,23132,3683,11215,2535,19448,363,176,187
29855,23134,3685,11217,2537,19449,363,176,187
29860,23142,3686,11219,2537,19456,363,176,187
29865,23145,3686,11220,2537,19459,363,176,187
29870,23150,3687,11223,2537,19463,363,176,187
29875,23154,3687,11225,2537,19467,363,176,187
29880,23157,3687,11226,2537,19470,363,176,187
29885,23158,3687,11227,2537,19471,363,176,187
29890,23163,3688,11231,2538,19475,363,176,187
29895,23165,3688,11232,2538,19477,363,176,187
29900,23173,3689,11234,2539,19484,363,176,187
29905,23176,3689,11235,2539,19487,363,176,187
29910,23181,3690,11238,2540,19491,363,176,187
29915,23185,3690,11238,2540,19495,363,176,187
29920,23188,3690,11239,2540,19498,363,176,187
29925,23189,3690,11239,2540,19499,363,176,187
29930,23194,3691,11241,2540,19503,363,176,187
29935,23196,3691,11241,2540,19505,363,176,187
29940,23204,3692,11243,2540,19512,363,176,187
29945,23207,3693,11245,2541,19514,363,176,187
29950,23212,3694,11248,2542,19518,363,176,187
29955,23216,3694,11251,2542,19522,363,176,187
29960,23219,3695,11252,2543,19524,363,176,187
29965,23220,3696,11253,2544,19524,363,176,187
29970,23225,3697,11257,2545,19528,363,176,187
29975,23227,3697,11257,2545,19530,363,176,187
29980,23235,3698,11259,2546,19537,363,176,187
29985,23238,3698,11259,2546,19540,363,176,187
29990,23243,3699,11259,2546,19544,363,176,187
29995,23247,3699,11261,2546,19548,363,176,187
30000,23250,3699,11262,2546,19551,363,176,187
30005,23251,3700,11263,2547,19551,363,176,187
30010,23256,3701,11265,2548,19555,363,176,187
30015,23258,3702,11266,2549,19556,363,176,187
30020,23266,3703,11273,2550,19563,363,176,187
30025,23269,3703,11275,2550,19566,363,176,187
30030,23274,3704,11278,2551,19570,363,176,187
30035,23278,3704,11280,2551,19574,363,176,187
30040,23281,3704,11282,2551,19577,363,176,187
30045,23282,3705,11283,2552,19577,363,176,187
30050,23287,3706,11287,2553,19580,363,176,187
30055,23289,3708,11287,2554,19581,363,176,187
30060,23297,3710,11291,2556,19587,363,176,187
30065,23300,3710,11294,2556,19590,363,176,187
30070,23305,3711,11296,2557,19594,364,177,187
30075,23309,3711,11296,2557,19598,364,177,187
30080,23312,3711,11296,2557,19601,364,177,187
30085,23313,3711,11296,2557,19602,364,177,187
30090,23318,3712,11298,2557,19605,364,177,187
30095,23320,3714,11299,2558,19606,364,177,187
30100,23328,3715,11304,2559,19613,364,177,187
30105,23331,3715,11306,2559,19616,364,177,187
30110,23336,3716,11310,2560,19620,365,177,188
30115,23340,3716,11311,2560,19623,365,177,188
30120,23343,3717,11312,2561,19626,365,177,188
30125,23344,3718,11313,2562,19626,365,177,188
30130,23349,3719,11315,2563,19630,365,177,188
30135,23351,3720,11315,2563,19631,365,177,188
30140,23359,3721,11319,2564,19638,365,177,188
30145,23362,3721,11320,2564,19641,365,177,188
30150,23367,3722,11322,2564,19645,365,177,188
30155,23371,3722,11323,2564,19649,365,177,188
30160,23374,3722,11324,2564,19652,365,177,188
30165,23375,3722,11324,2564,19653,365,177,188
30170,23380,3723,11325,2564,19657,365,177,188
30175,23382,3724,11326,2565,19658,365,177,188
30180,23390,3726,11331,2566,19664,365,177,188
30185,23393,3726,11332,2566,19667,365,177,188
30190,23398,3727,11333,2566,19671,365,177,188
30195,23402,3727,11334,2566,19675,365,177,188
30200,23405,3727,11336,2566,19678,365,177,188
30205,23406,3728,11337,2567,19678,365,177,188
30210,23411,3729,11338,2568,19682,365,177,188
30215,23413,3730,11339,2568,19683,365,177,188
30220,23421,3731,11345,2569,19690,365,177,188
30225,23424,3731,11346,2569,19693,365,177,188
30230,23429,3732,11350,2570,19697,366,178,188
30235,23433,3732,11351,2570,19701,366,178,188
30240,23436,3732,11353,2570,19704,366,178,188
30245,23437,3733,11354,2571,19704,366,178,188
30250,23442,3734,11357,2572,19708,366,178,188
30255,23444,3735,11358,2573,19709,366,178,188
30260,23452,3736,11363,2574,19716,366,178,188
30265,23455,3736,11364,2574,19719,366,178,188
30270,23460,3737,11365,2574,19723,367,179,188
30275,23464,3737,11366,2574,19727,367,179,188
30280,23467,3737,11368,2574,19730,367,179,188
30285,23468,3737,11368,2574,19731,367,179,188
30290,23473,3738,11371,2575,19734,367,179,188
30295,23475,3740,11371,2576,19735,367,179,188
30300,23483,3743,11376,2578,19740,367,179,188
30305,23486,3743,11377,2578,19743,367,179,188
30310,23491,3744,11380,2579,19747,367,179,188
30315,23495,3744,11383,2579,19750,367,179,188
30320,23498,3745,11385,2580,19753,367,179,188
30325,23499,3745,11385,2580,19754,367,179,188
30330,23504,3745,11387,2580,19758,367,179,188
30335,23506,3747,11387,2581,19759,367,179,188
30340,23514,3748,11392,2582,19766,367,179,188
30345,23517,3749,11395,2583,19768,367,179,188
30350,23522,3750,11396,2584,19772,367,179,188
30355,23526,3750,11400,2584,19775,367,179,188
30360,23529,3751,11400,2585,19778,367,179,188
30365,23530,3751,11401,2585,19779,367,179,188
30370,23535,3751,11404,2585,19784,367,179,188
30375,23537,3751,11404,2585,19786,367,179,188
30380,23545,3752,11409,2585,19793,367,179,188
30385,23548,3752,11411,2585,19796,367,179,188
30390,23553,3753,11413,2586,19800,367,179,188
30395,23557,3753,11416,2586,19803,367,179,188
30400,23560,3755,11418,2588,19805,367,179,188
30405,23561,3755,11418,2588,19806,367,179,188
30410,23566,3756,11421,2588,19810,367,179,188
30415,23568,3756,11421,2588,19812,367,179,188
30420,23576,3758,11424,2589,19818,367,179,188
30425,23579,3758,11425,2589,19821,367,179,188
30430,23584,3758,11427,2589,19826,367,179,188
30435,23588,3758,11428,2589,19830,367,179,188
30440,23591,3758,11431,2589,19833,367,179,188
30445,23592,3758,11432,2589,19834,367,179,188
30450,23597,3759,11436,2590,19838,367,179,188
30455,23599,3759,11436,2590,19840,367,179,188
30460,23607,3762,11439,2592,19845,367,179,188
30465,23610,3762,11440,2592,19848,367,179,188
30470,23615,3762,11442,2592,19853,367,179,188
30475,23619,3762,11445,2592,19856,367,179,188
30480,23622,3763,11446,2593,19859,367,179,188
30485,23623,3764,11447,2594,19859,367,179,188
30490,23628,3765,11448,2595,19863,367,179,188
30495,23630,3766,11450,2596,19864,367,179,188
30500,23638,3767,11454,2596,19871,367,179,188
30505,23641,3767,11457,2596,19874,367,179,188
30510,23646,3767,11459,2596,19879,367,179,188
30515,23650,3767,11461,2596,19882,367,179,188
30520,23653,3768,11463,2597,19885,367,179,188
30525,23654,3768,11463,2597,19886,367,179,188
30530,23659,3769,11463,2597,19890,367,179,188
30535,23661,3770,11464,2597,19891,367,179,188
30540,23669,3772,11468,2598,19897,367,179,188
30545,23672,3772,11470,2598,19900,367,179,188
30550,23677,3773,11472,2599,19904,368,180,188
30555,23681,3773,11473,2599,19908,368,180,188
30560,23684,3773,11474,2599,19911,368,180,188
30565,23685,3774,11475,2600,19911,368,180,188
30570,23690,3775,11476,2600,19914,368,180,188
30575,23692,3777,11477,2601,19915,368,180,188
30580,23700,3779,11481,2602,19921,368,180,188
30585,23703,3779,11482,2602,19924,368,180,188
30590,23708,3780,11485,2603,19928,369,181,188
30595,23712,3780,11487,2603,19932,369,181,188
30600,23715,3780,11488,2603,19935,369,181,188
30605,23716,3781,11489,2604,19935,369,181,188
30610,23721,3782,11492,2605,19938,369,181,188
30615,23723,3784,11493,2606,19939,369,181,188
30620,23731,3785,11495,2606,19946,369,181,188
30625,23734,3785,11495,2606,19949,369,181,188
30630,23739,3786,11498,2607,19953,369,181,188
30635,23743,3786,11500,2607,19957,369,181,188
30640,23746,3786,11500,2607,19960,369,181,188
30645,23747,3786,11500,2607,19961,369,181,188
30650,23752,3787,11503,2608,19964,369,181,188
30655,23754,3789,11503,2609,19965,369,181,188
30660,23762,3790,11506,2609,19972,369,181,188
30665,23765,3790,11507,2609,19975,369,181,188
30670,23770,3791,11507,2609,19979,369,181,188
30675,23774,3791,11508,2609,19983,369,181,188
30680,23777,3791,11508,2609,19986,369,181,188
30685,23778,3791,11508,2609,19987,369,181,188
30690,23783,3792,11511,2610,19990,369,181,188
30695,23785,3794,11511,2611,19991,369,181,188
30700,23793,3795,11514,2612,19998,369,181,188
30705,23796,3796,11516,2613,20000,369,181,188
30710,23801,3797,11518,2613,20004,370,181,189
30715,23805,3797,11521,2613,20007,370,181,189
30720,23808,3798,11522,2614,20010,370,181,189
30725,23809,3799,11523,2615,20010,370,181,189
30730,23814,3800,11527,2615,20013,370,181,189
30735,23816,3802,11529,2617,20014,370,181,189
30740,23824,3804,11534,2618,20020,370,181,189
30745,23827,3805,11535,2619,20022,370,181,189
30750,23832,3806,11537,2620,20026,370,181,189
30755,23836,3806,11541,2620,20029,370,181,189
30760,23839,3807,11544,2621,20032,370,181,189
30765,23840,3807,11544,2621,20033,370,181,189
30770,23845,3808,11546,2621,20036,370,181,189
30775,23847,3810,11546,2622,20037,370,181,189
30780,23855,3812,11551,2624,20043,370,181,189
30785,23858,3812,11552,2624,20046,370,181,189
30790,23863,3813,11556,2625,20050,370,181,189
30795,23867,3813,11558,2625,20053,370,181,189
30800,23870,3814,11560,2626,20056,370,181,189
30805,23871,3814,11560,2626,20057,370,181,189
30810,23876,3814,11564,2626,20062,370,181,189
30815,23878,3815,11566,2627,20063,370,181,189
30820,23886,3816,11571,2627,20070,370,181,189
30825,23889,3816,11571,2627,20073,370,181,189
30830,23894,3817,11572,2627,20077,371,181,190
30835,23898,3817,11574,2627,20081,371,181,190
30840,23901,3817,11576,2627,20084,371,181,190
30845,23902,3817,11577,2627,20085,371,181,190
30850,23907,3817,11581,2627,20089,371,181,190
30855,23909,3819,11583,2629,20090,371,181,190
30860,23917,3821,11586,2631,20096,371,181,190
30865,23920,3822,11588,2632,20098,371,181,190
30870,23925,3823,11592,2633,20102,371,181,190
30875,23929,3823,11593,2633,20106,371,181,190
30880,23932,3824,11595,2634,20108,371,181,190
30885,23933,3824,11595,2634,20109,371,181,190
30890,23938,3825,11599,2635,20112,371,181,190
30895,23940,3827,11600,2637,20113,371,181,190
30900,23948,3829,11604,2638,20119,371,181,190
30905,23951,3829,11605,2638,20122,371,181,190
30910,23956,3830,11607,2639,20126,371,181,190
30915,23960,3830,11609,2639,20130,371,181,190
30920,23963,3830,11609,2639,20133,371,181,190
30925,23964,3831,11610,2640,20133,371,181,190
30930,23969,3832,11612,2640,20137,371,181,190
30935,23971,3832,11612,2640,20139,371,181,190
30940,23979,3833,11615,2640,20146,371,181,190
30945,23982,3833,11617,2640,20149,371,181,190
30950,23987,3834,11622,2641,20153,371,181,190
30955,23991,3834,11625,2641,20157,371,181,190
30960,23994,3834,11627,2641,20160,371,181,190
30965,23995,3834,11627,2641,20161,371,181,190
30970,24000,3835,11631,2642,20165,371,181,190
30975,24002,3835,11631,2642,20167,371,181,190
30980,24010,3836,11634,2643,20174,371,181,190
30985,24013,3836,11634,2643,20177,371,181,190
30990,24018,3837,11637,2643,20181,371,181,190
30995,24022,3837,11640,2643,20185,371,181,190
31000,24025,3837,11641,2643,20188,371,181,190
31005,24026,3837,11642,2643,20189,371,181,190
31010,24031,3838,11645,2644,20193,371,181,190
31015,24033,3838,11647,2644,20195,371,181,190
31020,24041,3841,11653,2647,20200,371,181,190
31025,24044,3841,11656,2647,20203,371,181,190
31030,24049,3842,11657,2647,20207,371,181,190
31035,24053,3842,11659,2647,20210,371,181,190
31040,24056,3843,11660,2648,20213,371,181,190
31045,24057,3843,11660,2648,20214,371,181,190
31050,24062,3844,11660,2648,20218,371,181,190
31055,24064,3845,11661,2649,20219,371,181,190
31060,24072,3846,11664,2650,20226,371,181,190
31065,24075,3846,11665,2650,20229,371,181,190
31070,24080,3847,11666,2651,20233,371,181,190
31075,24084,3847,11669,2651,20236,371,181,190
31080,24087,3848,11670,2652,20239,371,181,190
31085,24088,3848,11670,2652,20240,371,181,190
31090,24093,3849,11672,2652,20243,371,181,190
31095,24095,3851,11674,2654,20244,371,181,190
31100,24103,3852,11677,2655,20251,371,181,190
31105,24106,3852,11678,2655,20254,371,181,190
31110,24111,3853,11681,2656,20258,371,181,190
31115,24115,3853,11682,2656,20262,371,181,190
31120,24118,3853,11684,2656,20265,371,181,190
31125,24119,3853,11684,2656,20266,371,181,190
31130,24124,3854,11685,2656,20270,371,181,190
31135,24126,3855,11686,2657,20271,371,181,190
31140,24134,3857,11690,2659,20277,371,181,190
31145,24137,3857,11690,2659,20280,371,181,190
31150,24142,3858,11693,2659,20284,371,181,190
31155,24146,3858,11694,2659,20288,371,181,190
31160,24149,3858,11696,2659,20291,371,181,190
31165,24150,3858,11696,2659,20292,371,181,190
31170,24155,3859,11697,2659,20296,371,181,190
31175,24157,3860,11698,2660,20297,371,181,190
31180,24165,3861,11700,2660,20304,371,181,190
31185,24168,3861,11700,2660,20307,371,181,190
31190,24173,3862,11702,2661,20311,371,181,190
31195,24177,3862,11705,2661,20314,371,181,190
31200,24180,3864,11707,2663,20316,371,181,190
31205,24181,3864,11707,2663,20317,371,181,190
31210,24186,3865,11708,2663,20321,371,181,190
31215,24188,3865,11710,2663,20323,371,181,190
31220,24196,3866,11715,2663,20330,371,181,190
31225,24199,3866,11716,2663,20333,371,181,190
31230,24204,3867,11716,2663,20337,371,181,190
31235,24208,3867,11718,2663,20341,371,181,190
31240,24211,3868,11721,2664,20343,371,181,190
31245,24212,3868,11721,2664,20344,371,181,190
31250,24217,3869,11724,2664,20348,371,181,190
31255,24219,3869,11725,2664,20350,371,181,190
31260,24227,3870,11728,2664,20357,371,181,190
31265,24230,3870,11729,2664,20360,371,181,190
31270,24235,3871,11729,2664,20364,371,181,190
31275,24239,3871,11732,2664,20368,371,181,190
31280,24242,3871,11732,2664,20371,371,181,190
31285,24243,3872,11733,2665,20371,371,181,190
31290,24248,3873,11736,2666,20375,371,181,190
31295,24250,3873,11737,2666,20377,371,181,190
31300,24258,3874,11741,2667,20384,371,181,190
31305,24261,3874,11742,2667,20387,371,181,190
31310,24266,3875,11744,2668,20391,372,182,190
31315,24270,3875,11748,2668,20394,372,182,190
31320,24273,3876,11748,2669,20397,372,182,190
31325,24274,3876,11748,2669,20398,372,182,190
31330,24279,3877,11751,2670,20401,372,182,190
31335,24281,3879,11751,2671,20402,372,182,190
31340,24289,3881,11754,2671,20408,372,182,190
31345,24292,3882,11754,2671,20410,372,182,190
31350,24297,3883,11758,2672,20414,372,182,190
31355,24301,3883,11761,2672,20418,372,182,190
31360,24304,3883,11763,2672,20421,372,182,190
31365,24305,3884,11764,2673,20421,372,182,190
31370,24310,3885,11767,2674,20425,372,182,190
31375,24312,3886,11767,2674,20426,372,182,190
31380,24320,3888,11771,2675,20432,372,182,190
31385,24323,3888,11773,2675,20435,372,182,190
31390,24328,3889,11776,2675,20439,372,182,190
31395,24332,3889,11779,2675,20442,372,182,190
31400,24335,3890,11782,2676,20445,372,182,190
31405,24336,3890,11782,2676,20446,372,182,190
31410,24341,3891,11784,2676,20449,372,182,190
31415,24343,3893,11785,2677,20450,372,182,190
31420,24351,3894,11788,2677,20457,372,182,190
31425,24354,3894,11788,2677,20460,372,182,190
31430,24359,3895,11791,2677,20464,373,183,190
31435,24363,3895,11793,2677,20468,373,183,190
31440,24366,3896,11795,2678,20470,373,183,190
31445,24367,3897,11796,2679,20470,373,183,190
31450,24372,3898,11799,2680,20473,373,183,190
31455,24374,3900,11800,2682,20474,373,183,190
31460,24382,3902,11806,2683,20480,373,183,190
31465,24385,3903,11808,2684,20482,373,183,190
31470,24390,3904,11810,2685,20486,373,183,190
31475,24394,3904,11812,2685,20490,373,183,190
31480,24397,3905,11815,2686,20492,373,183,190
31485,24398,3906,11816,2687,20492,373,183,190
31490,24403,3907,11818,2687,20495,373,183,190
31495,24405,3909,11818,2688,20496,373,183,190
31500,24413,3912,11819,2689,20501,373,183,190
31505,24416,3913,11821,2690,20503,373,183,190
31510,24421,3914,11822,2690,20507,373,183,190
31515,24425,3914,11824,2690,20511,373,183,190
31520,24428,3914,11824,2690,20514,373,183,190
31525,24429,3914,11824,2690,20515,373,183,190
31530,24434,3915,11827,2691,20519,373,183,190
31535,24436,3915,11827,2691,20521,373,183,190
31540,24444,3916,11831,2692,20528,373,183,190
31545,24447,3917,11832,2692,20530,373,183,190
31550,24452,3918,11834,2692,20534,374,184,190
31555,24456,3918,11836,2692,20537,374,184,190
31560,24459,3919,11837,2693,20540,374,184,190
31565,24460,3920,11838,2694,20540,374,184,190
31570,24465,3921,11840,2694,20544,374,184,190
31575,24467,3921,11841,2694,20546,374,184,190
31580,24475,3922,11846,2695,20553,374,184,190
31585,24478,3923,11846,2695,20555,374,184,190
31590,24483,3924,11847,2695,20559,374,184,190
31595,24487,3924,11848,2695,20562,374,184,190
31600,24490,3925,11851,2696,20565,374,184,190
31605,24491,3926,11852,2697,20565,374,184,190
31610,24496,3927,11855,2698,20569,374,184,190
31615,24498,3928,11856,2698,20570,374,184,190
31620,24506,3931,11863,2701,20575,374,184,190
31625,24509,3931,11864,2701,20578,374,184,190
31630,24514,3932,11866,2701,20582,375,185,190
31635,24518,3932,11869,2701,20585,375,185,190
31640,24521,3933,11869,2702,20588,375,185,190
31645,24522,3933,11869,2702,20589,375,185,190
31650,24527,3933,11873,2702,20594,375,185,190
31655,24529,3934,11874,2703,20595,375,185,190
31660,24537,3935,11878,2703,20602,375,185,190
31665,24540,3935,11880,2703,20605,375,185,190
31670,24545,3936,11883,2704,20609,376,186,190
31675,24549,3936,11886,2704,20612,376,186,190
31680,24552,3937,11886,2705,20615,376,186,190
31685,24553,3937,11886,2705,20616,376,186,190
31690,24558,3937,11890,2705,20620,376,186,190
31695,24560,3939,11891,2706,20621,376,186,190
31700,24568,3940,11892,2707,20628,376,186,190
31705,24571,3940,11894,2707,20631,376,186,190
31710,24576,3941,11896,2708,20635,377,186,191
31715,24580,3941,11898,2708,20638,377,186,191
31720,24583,3942,11899,2709,20641,377,186,191
31725,24584,3942,11900,2709,20642,377,186,191
31730,24589,3943,11902,2710,20645,377,186,191
31735,24591,3945,11903,2711,20646,377,186,191
31740,24599,3947,11905,2711,20652,377,186,191
31745,24602,3948,11907,2712,20654,377,186,191
31750,24607,3948,11907,2712,20659,378,186,192
31755,24611,3948,11910,2712,20663,378,186,192
31760,24614,3949,11912,2713,20665,378,186,192
31765,24615,3949,11912,2713,20666,378,186,192
31770,24620,3950,11914,2713,20670,378,186,192
31775,24622,3951,11915,2714,20671,378,186,192
31780,24630,3953,11918,2715,20677,378,186,192
31785,24633,3954,11918,2715,20679,378,186,192
31790,24638,3954,11919,2715,20684,379,186,193
31795,24642,3954,11921,2715,20688,379,186,193
31800,24645,3954,11923,2715,20691,379,186,193
31805,24646,3954,11923,2715,20692,379,186,193
31810,24651,3955,11927,2716,20696,379,186,193
31815,24653,3955,11928,2716,20698,379,186,193
31820,24661,3957,11931,2717,20704,379,186,193
31825,24664,3958,11931,2717,20706,379,186,193
31830,24669,3958,11932,2717,20711,379,186,193
31835,24673,3958,11935,2717,20715,379,186,193
31840,24676,3958,11935,2717,20718,379,186,193
31845,24677,3958,11935,2717,20719,379,186,193
31850,24682,3959,11937,2717,20723,379,186,193
31855,24684,3959,11938,2717,20725,379,186,193
31860,24692,3962,11941,2719,20730,379,186,193
31865,24695,3963,11943,2720,20732,379,186,193
31870,24700,3964,11948,2721,20736,379,186,193
31875,24704,3964,11951,2721,20739,379,186,193
31880,24707,3965,11952,2722,20742,379,186,193
31885,24708,3965,11953,2722,20743,379,186,193
31890,24713,3966,11955,2722,20747,379,186,193
31895,24715,3966,11956,2722,20749,379,186,193
31900,24723,3967,11961,2723,20756,379,186,193
31905,24726,3968,11962,2723,20758,379,186,193
31910,24731,3969,11965,2724,20762,380,186,194
31915,24735,3969,11967,2724,20766,380,186,194
31920,24738,3969,11969,2724,20769,380,186,194
31925,24739,3969,11969,2724,20770,380,186,194
31930,24744,3970,11970,2725,20774,380,186,194
31935,24746,3971,11971,2726,20775,380,186,194
31940,24754,3972,11977,2727,20782,380,186,194
31945,24757,3972,11979,2727,20785,380,186,194
31950,24762,3973,11981,2727,20789,380,186,194
31955,24766,3973,11982,2727,20793,380,186,194
31960,24769,3973,11982,2727,20796,380,186,194
31965,24770,3973,11982,2727,20797,380,186,194
31970,24775,3974,11984,2727,20801,380,186,194
31975,24777,3975,11986,2728,20802,380,186,194
31980,24785,3978,11991,2730,20807,380,186,194
31985,24788,3978,11994,2730,20810,380,186,194
31990,24793,3979,11997,2730,20814,381,186,195
31995,24797,3979,11999,2730,20817,381,186,195
32000,24800,3980,12000,2731,20820,381,186,195
32005,24801,3981,12001,2732,20820,381,186,195
32010,24806,3982,12003,2732,20823,381,186,195
32015,24808,3984,12004,2734,20824,381,186,195
32020,24816,3986,12009,2736,20830,381,186,195
32025,24819,3986,12011,2736,20833,381,186,195
32030,24824,3987,12013,2736,20837,382,186,196
32035,24828,3987,12015,2736,20841,382,186,196
32040,24831,3987,12018,2736,20844,382,186,196
32045,24832,3987,12018,2736,20845,382,186,196
32050,24837,3988,12021,2736,20849,382,186,196
32055,24839,3989,12022,2737,20850,382,186,196
32060,24847,3990,12026,2737,20857,382,186,196
32065,24850,3991,12029,2738,20859,382,186,196
32070,24855,3992,12031,2738,20863,382,186,196
32075,24859,3992,12031,2738,20867,382,186,196
32080,24862,3992,12033,2738,20870,382,186,196
32085,24863,3993,12034,2739,20870,382,186,196
32090,24868,3994,12038,2739,20873,382,186,196
32095,24870,3996,12039,2741,20874,382,186,196
32100,24878,3997,12041,2741,20881,382,186,196
32105,24881,3997,12041,2741,20884,382,186,196
32110,24886,3998,12042,2741,20888,382,186,196
32115,24890,3998,12045,2741,20892,382,186,196
32120,24893,3999,12046,2742,20894,382,186,196
32125,24894,3999,12046,2742,20895,382,186,196
32130,24899,4000,12047,2742,20898,382,186,196
32135,24901,4002,12048,2743,20899,382,186,196
32140,24909,4003,12054,2744,20906,382,186,196
32145,24912,4003,12055,2744,20909,382,186,196
32150,24917,4004,12057,2744,20913,382,186,196
32155,24921,4004,12059,2744,20917,382,186,196
32160,24924,4004,12060,2744,20920,382,186,196
32165,24925,4004,12060,2744,20921,382,186,196
32170,24930,4005,12062,2744,20924,382,186,196
32175,24932,4007,12062,2745,20925,382,186,196
32180,24940,4008,12066,2746,20932,382,186,196
32185,24943,4008,12067,2746,20935,382,186,196
32190,24948,4009,12069,2746,20939,382,186,196
32195,24952,4009,12071,2746,20942,382,186,196
32200,24955,4011,12074,2748,20944,382,186,196
32205,24956,4011,12074,2748,20945,382,186,196
32210,24961,4012,12077,2749,20948,382,186,196
32215,24963,4014,12077,2750,20949,382,186,196
32220,24971,4016,12081,2751,20955,382,186,196
32225,24974,4017,12082,2751,20957,382,186,196
32230,24979,4017,12083,2751,20962,382,186,196
32235,24983,4017,12084,2751,20966,382,186,196
32240,24986,4017,12085,2751,20969,382,186,196
32245,24987,4018,12086,2752,20969,382,186,196
32250,24992,4019,12087,2752,20973,382,186,196
32255,24994,4019,12087,2752,20975,382,186,196
32260,25002,4020,12089,2752,20982,382,186,196
32265,25005,4021,12090,2753,20984,382,186,196
32270,25010,4021,12090,2753,20989,382,186,196
32275,25014,4021,12091,2753,20993,382,186,196
32280,25017,4021,12092,2753,20996,382,186,196
32285,25018,4021,12092,2753,20997,382,186,196
32290,25023,4022,12094,2754,21001,382,186,196
32295,25025,4022,12095,2754,21003,382,186,196
32300,25033,4023,12098,2754,21010,382,186,196
32305,25036,4024,12099,2755,21012,382,186,196
32310,25041,4024,12102,2755,21017,382,186,196
32315,25045,4024,12104,2755,21020,382,186,196
32320,25048,4025,12107,2756,21023,382,186,196
32325,25049,4025,12107,2756,21024,382,186,196
32330,25054,4026,12109,2756,21027,382,186,196
32335,25056,4028,12111,2758,21028,382,186,196
32340,25064,4030,12113,2758,21034,382,186,196
32345,25067,4030,12114,2758,21037,382,186,196
32350,25072,4031,12116,2759,21041,382,186,196
32355,25076,4031,12117,2759,21045,382,186,196
32360,25079,4032,12120,2760,21047,382,186,196
32365,25080,4032,12120,2760,21048,382,186,196
32370,25085,4033,12123,2761,21052,382,186,196
32375,25087,4033,12123,2761,21054,382,186,196
32380,25095,4035,12128,2763,21060,382,186,196
32385,25098,4035,12129,2763,21063,382,186,196
32390,25103,4036,12131,2764,21067,382,186,196
32395,25107,4036,12133,2764,21071,382,186,196
32400,25110,4037,12136,2765,21073,382,186,196
32405,25111,4038,12137,2766,21073,382,186,196
32410,25116,4039,12139,2766,21077,382,186,196
32415,25118,4039,12141,2766,21079,382,186,196
32420,25126,4041,12146,2768,21085,382,186,196
32425,25129,4041,12147,2768,21088,382,186,196
32430,25134,4042,12149,2768,21092,382,186,196
32435,25138,4042,12150,2768,21096,382,186,196
32440,25141,4042,12151,2768,21099,382,186,196
32445,25142,4042,12151,2768,21100,382,186,196
32450,25147,4043,12154,2769,21104,382,186,196
32455,25149,4044,12155,2770,21105,382,186,196
32460,25157,4047,12159,2772,21110,382,186,196
32465,25160,4048,12161,2773,21112,382,186,196
32470,25165,4049,12165,2774,21116,382,186,196
32475,25169,4049,12167,2774,21120,382,186,196
32480,25172,4049,12168,2774,21123,382,186,196
32485,25173,4049,12169,2774,21124,382,186,196
32490,25178,4050,12173,2775,21127,382,186,196
32495,25180,4052,12173,2776,21128,382,186,196
32500,25188,4053,12176,2776,21135,382,186,196
32505,25191,4054,12177,2776,21137,382,186,196
32510,25196,4055,12178,2776,21141,382,186,196
32515,25200,4055,12180,2776,21144,382,186,196
32520,25203,4056,12182,2777,21147,382,186,196
32525,25204,4056,12183,2777,21148,382,186,196
32530,25209,4057,12185,2777,21151,382,186,196
32535,25211,4059,12185,2778,21152,382,186,196
32540,25219,4060,12189,2779,21159,382,186,196
32545,25222,4060,12191,2779,21162,382,186,196
32550,25227,4061,12194,2779,21166,382,186,196
32555,25231,4061,12196,2779,21170,382,186,196
32560,25234,4061,12197,2779,21173,382,186,196
32565,25235,4061,12197,2779,21174,382,186,196
32570,25240,4062,12199,2779,21177,382,186,196
32575,25242,4064,12200,2780,21178,382,186,196
32580,25250,4066,12205,2781,21184,382,186,196
32585,25253,4066,12206,2781,21187,382,186,196
32590,25258,4067,12208,2781,21191,382,186,196
32595,25262,4067,12209,2781,21195,382,186,196
32600,25265,4068,12211,2782,21197,382,186,196
32605,25266,4068,12211,2782,21198,382,186,196
32610,25271,4068,12213,2782,21203,382,186,196
32615,25273,4069,12214,2783,21204,382,186,196
32620,25281,4070,12219,2784,21211,382,186,196
32625,25284,4070,12219,2784,21214,382,186,196
32630,25289,4071,12219,2784,21218,382,186,196
32635,25293,4071,12221,2784,21222,382,186,196
32640,25296,4071,12222,2784,21225,382,186,196
32645,25297,4071,12223,2784,21226,382,186,196
32650,25302,4071,12224,2784,21231,382,186,196
32655,25304,4071,12225,2784,21233,382,186,196
32660,25312,4072,12227,2784,21240,382,186,196
32665,25315,4073,12230,2785,21242,382,186,196
32670,25320,4074,12232,2785,21246,382,186,196
32675,25324,4074,12233,2785,21250,382,186,196
32680,25327,4074,12235,2785,21253,382,186,196
32685,25328,4074,12235,2785,21254,382,186,196
32690,25333,4075,12236,2785,21258,382,186,196
32695,25335,4075,12237,2785,21260,382,186,196
32700,25343,4077,12243,2787,21266,382,186,196
32705,25346,4077,12243,2787,21269,382,186,196
32710,25351,4078,12245,2787,21273,383,186,197
32715,25355,4078,12247,2787,21276,383,186,197
32720,25358,4080,12249,2789,21278,383,186,197
32725,25359,4081,12250,2790,21278,383,186,197
32730,25364,4082,12251,2791,21282,383,186,197
32735,25366,4082,12252,2791,21284,383,186,197
32740,25374,4083,12256,2792,21291,383,186,197
32745,25377,4083,12256,2792,21294,383,186,197
32750,25382,4084,12259,2793,21298,384,187,197
32755,25386,4084,12260,2793,21302,384,187,197
32760,25389,4084,12262,2793,21305,384,187,197
32765,25390,4084,12262,2793,21306,384,187,197
32770,25395,4085,12263,2793,21310,384,187,197
32775,25397,4086,12263,2793,21311,384,187,197
32780,25405,4087,12268,2793,21318,384,187,197
32785,25408,4087,12270,2793,21321,384,187,197
32790,25413,4088,12273,2793,21325,384,187,197
32795,25417,4088,12274,2793,21328,384,187,197
32800,25420,4089,12274,2794,21331,384,187,197
32805,25421,4089,12274,2794,21332,384,187,197
32810,25426,4090,12275,2795,21336,384,187,197
32815,25428,4091,12277,2796,21337,384,187,197
32820,25436,4093,12280,2797,21343,384,187,197
32825,25439,4094,12280,2797,21345,384,187,197
32830,25444,4095,12282,2797,21349,384,187,197
32835,25448,4095,12283,2797,21353,384,187,197
32840,25451,4095,12285,2797,21356,384,187,197
32845,25452,4095,12285,2797,21357,384,187,197
32850,25457,4095,12287,2797,21362,384,187,197
32855,25459,4096,12288,2798,21363,384,187,197
32860,25467,4097,12290,2798,21370,384,187,197
32865,25470,4098,12293,2799,21372,384,187,197
32870,25475,4099,12296,2799,21376,385,188,197
32875,25479,4099,12300,2799,21380,385,188,197
32880,25482,4099,12300,2799,21383,385,188,197
32885,25483,4099,12300,2799,21384,385,188,197
32890,25488,4099,12301,2799,21388,385,188,197
32895,25490,4101,12301,2800,21389,385,188,197
32900,25498,4102,12305,2801,21396,385,188,197
32905,25501,4103,12306,2802,21398,385,188,197
32910,25506,4104,12308,2803,21402,385,188,197
32915,25510,4104,12311,2803,21406,385,188,197
32920,25513,4104,12312,2803,21409,385,188,197
32925,25514,4104,12313,2803,21410,385,188,197
32930,25519,4105,12314,2803,21414,385,188,197
32935,25521,4106,12315,2803,21415,385,188,197
32940,25529,4109,12319,2805,21420,385,188,197
32945,25532,4109,12321,2805,21423,385,188,197
32950,25537,4110,12323,2805,21427,385,188,197
32955,25541,4110,12326,2805,21430,385,188,197
32960,25544,4111,12326,2806,21433,385,188,197
32965,25545,4112,12327,2807,21433,385,188,197
32970,25550,4113,12328,2808,21437,385,188,197
32975,25552,4114,12329,2808,21438,385,188,197
32980,25560,4116,12333,2810,21444,385,188,197
32985,25563,4116,12334,2810,21447,385,188,197
32990,25568,4117,12336,2811,21451,386,188,198
32995,25572,4117,12337,2811,21454,386,188,198
33000,25575,4119,12338,2813,21456,386,188,198
33005,25576,4120,12339,2814,21456,386,188,198
33010,25581,4121,12340,2814,21459,386,188,198
33015,25583,4123,12342,2816,21460,386,188,198
33020,25591,4124,12347,2817,21467,386,188,198
33025,25594,4124,12349,2817,21470,386,188,198
33030,25599,4124,12351,2817,21475,387,188,199
33035,25603,4124,12352,2817,21479,387,188,199
33040,25606,4124,12354,2817,21482,387,188,199
33045,25607,4125,12355,2818,21482,387,188,199
33050,25612,4126,12358,2819,21485,387,188,199
33055,25614,4128,12359,2821,21486,387,188,199
33060,25622,4129,12362,2822,21493,387,188,199
33065,25625,4130,12363,2822,21495,387,188,199
33070,25630,4130,12368,2822,21500,387,188,199
33075,25634,4130,12370,2822,21504,387,188,199
33080,25637,4130,12372,2822,21507,387,188,199
33085,25638,4130,12373,2822,21508,387,188,199
33090,25643,4130,12375,2822,21513,387,188,199
33095,25645,4131,12376,2823,21514,387,188,199
33100,25653,4133,12381,2824,21520,387,188,199
33105,25656,4134,12383,2824,21522,387,188,199
33110,25661,4135,12386,2825,21526,387,188,199
33115,25665,4135,12388,2825,21530,387,188,199
33120,25668,4135,12390,2825,21533,387,188,199
33125,25669,4135,12391,2825,21534,387,188,199
33130,25674,4135,12393,2825,21538,387,188,199
33135,25676,4137,12394,2827,21539,387,188,199
33140,25684,4139,12400,2828,21545,387,188,199
33145,25687,4139,12402,2828,21548,387,188,199
33150,25692,4140,12404,2829,21552,387,188,199
33155,25696,4140,12407,2829,21555,387,188,199
33160,25699,4141,12408,2830,21558,387,188,199
33165,25700,4141,12409,2830,21559,387,188,199
33170,25705,4142,12412,2830,21562,387,188,199
33175,25707,4144,12413,2832,21563,387,188,199
33180,25715,4146,12418,2834,21569,387,188,199
33185,25718,4146,12418,2834,21572,387,188,199
33190,25723,4146,12420,2834,21577,388,188,200
33195,25727,4146,12423,2834,21581,388,188,200
33200,25730,4146,12425,2834,21584,388,188,200
33205,25731,4146,12425,2834,21585,388,188,200
33210,25736,4147,12427,2834,21589,388,188,200
33215,25738,4148,12427,2834,21590,388,188,200
33220,25746,4151,12428,2834,21595,388,188,200
33225,25749,4151,12429,2834,21598,388,188,200
33230,25754,4151,12431,2834,21603,389,189,200
33235,25758,4151,12433,2834,21607,389,189,200
33240,25761,4151,12434,2834,21610,389,189,200
33245,25762,4152,12435,2835,21610,389,189,200
33250,25767,4153,12437,2836,21614,389,189,200
33255,25769,4153,12438,2836,21616,389,189,200
33260,25777,4155,12441,2838,21622,389,189,200
33265,25780,4156,12443,2838,21624,389,189,200
33270,25785,4156,12447,2838,21629,389,189,200
33275,25789,4156,12449,2838,21633,389,189,200
33280,25792,4156,12451,2838,21636,389,189,200
33285,25793,4156,12451,2838,21637,389,189,200
33290,25798,4157,12455,2838,21641,389,189,200
33295,25800,4157,12455,2838,21643,389,189,200
33300,25808,4159,12462,2840,21649,389,189,200
33305,25811,4160,12464,2840,21651,389,189,200
33310,25816,4161,12466,2841,21655,389,189,200
33315,25820,4161,12467,2841,21659,389,189,200
33320,25823,4161,12468,2841,21662,389,189,200
33325,25824,4161,12468,2841,21663,389,189,200
33330,25829,4162,12470,2841,21667,389,189,200
33335,25831,4162,12472,2841,21669,389,189,200
33340,25839,4164,12477,2843,21675,389,189,200
33345,25842,4165,12477,2843,21677,389,189,200
33350,25847,4166,12480,2844,21681,390,189,201
33355,25851,4166,12482,2844,21685,390,189,201
33360,25854,4166,12483,2844,21688,390,189,201
33365,25855,4167,12484,2845,21688,390,189,201
33370,25860,4168,12487,2845,21691,390,189,201
33375,25862,4170,12487,2846,21692,390,189,201
33380,25870,4171,12490,2847,21699,390,189,201
33385,25873,4171,12491,2847,21702,390,189,201
33390,25878,4172,12494,2848,21706,390,189,201
33395,25882,4172,12494,2848,21710,390,189,201
33400,25885,4172,12494,2848,21713,390,189,201
33405,25886,4173,12495,2849,21713,390,189,201
33410,25891,4174,12497,2849,21717,390,189,201
33415,25893,4175,12498,2850,21718,390,189,201
33420,25901,4176,12502,2850,21725,390,189,201
33425,25904,4176,12503,2850,21728,390,189,201
33430,25909,4177,12505,2851,21732,390,189,201
33435,25913,4177,12507,2851,21736,390,189,201
33440,25916,4177,12508,2851,21739,390,189,201
33445,25917,4178,12509,2852,21739,390,189,201
33450,25922,4179,12512,2853,21743,390,189,201
33455,25924,4180,12514,2854,21744,390,189,201
33460,25932,4181,12518,2854,21751,390,189,201
33465,25935,4181,12519,2854,21754,390,189,201
33470,25940,4182,12520,2854,21758,391,190,201
33475,25944,4182,12523,2854,21762,391,190,201
33480,25947,4182,12524,2854,21765,391,190,201
33485,25948,4183,12525,2855,21765,391,190,201
33490,25953,4184,12527,2856,21769,391,190,201
33495,25955,4184,12529,2856,21771,391,190,201
33500,25963,4185,12532,2856,21778,391,190,201
33505,25966,4186,12533,2857,21780,391,190,201
33510,25971,4187,12536,2857,21784,391,190,201
33515,25975,4187,12537,2857,21788,391,190,201
33520,25978,4187,12539,2857,21791,391,190,201
33525,25979,4187,12540,2857,21792,391,190,201
33530,25984,4188,12542,2857,21796,391,190,201
33535,25986,4188,12542,2857,21798,391,190,201
33540,25994,4189,12546,2858,21805,391,190,201
33545,25997,4190,12549,2859,21807,391,190,201
33550,26002,4191,12551,2859,21811,391,190,201
33555,26006,4191,12552,2859,21815,391,190,201
33560,26009,4191,12554,2859,21818,391,190,201
33565,26010,4191,12555,2859,21819,391,190,201
33570,26015,4192,12558,2860,21823,391,190,201
33575,26017,4192,12560,2860,21825,391,190,201
33580,26025,4193,12564,2861,21832,391,190,201
33585,26028,4193,12565,2861,21835,391,190,201
33590,26033,4194,12569,2862,21839,392,191,201
33595,26037,4194,12570,2862,21843,392,191,201
33600,26040,4194,12572,2862,21846,392,191,201
33605,26041,4195,12573,2863,21846,392,191,201
33610,26046,4196,12576,2863,21849,392,191,201
33615,26048,4198,12578,2865,21850,392,191,201
33620,26056,4200,12582,2866,21856,392,191,201
33625,26059,4200,12582,2866,21859,392,191,201
33630,26064,4201,12584,2866,21863,392,191,201
33635,26068,4201,12586,2866,21867,392,191,201
33640,26071,4201,12588,2866,21870,392,191,201
33645,26072,4202,12589,2867,21870,392,191,201
33650,26077,4203,12590,2868,21874,392,191,201
33655,26079,4204,12591,2869,21875,392,191,201
33660,26087,4205,12594,2870,21882,392,191,201
33665,26090,4205,12596,2870,21885,392,191,201
33670,26095,4206,12599,2871,21889,392,191,201
33675,26099,4206,12601,2871,21893,392,191,201
33680,26102,4206,12602,2871,21896,392,191,201
33685,26103,4206,12602,2871,21897,392,191,201
33690,26108,4207,12605,2871,21900,392,191,201
33695,26110,4209,12606,2873,21901,392,191,201
33700,26118,4210,12608,2873,21908,392,191,201
33705,26121,4210,12609,2873,21911,392,191,201
33710,26126,4211,12611,2874,21915,393,192,201
33715,26130,4211,12613,2874,21919,393,192,201
33720,26133,4211,12613,2874,21922,393,192,201
33725,26134,4211,12613,2874,21923,393,192,201
33730,26139,4212,12614,2874,21927,393,192,201
33735,26141,4212,12615,2874,21929,393,192,201
33740,26149,4214,12619,2876,21935,393,192,201
33745,26152,4215,12620,2877,21937,393,192,201
33750,26157,4216,12624,2878,21941,393,192,201
33755,26161,4216,12624,2878,21945,393,192,201
33760,26164,4217,12625,2879,21947,393,192,201
33765,26165,4217,12625,2879,21948,393,192,201
33770,26170,4218,12627,2879,21952,393,192,201
33775,26172,4218,12627,2879,21954,393,192,201
33780,26180,4221,12633,2881,21959,393,192,201
33785,26183,4221,12634,2881,21962,393,192,201
33790,26188,4222,12638,2882,21966,393,192,201
33795,26192,4222,12640,2882,21969,393,192,201
33800,26195,4223,12642,2883,21972,393,192,201
33805,26196,4224,12643,2884,21972,393,192,201
33810,26201,4225,12647,2884,21976,393,192,201
33815,26203,4225,12648,2884,21978,393,192,201
33820,26211,4227,12652,2885,21984,393,192,201
33825,26214,4228,12655,2886,21986,393,192,201
33830,26219,4229,12658,2887,21990,394,192,202
33835,26223,4229,12660,2887,21994,394,192,202
33840,26226,4229,12661,2887,21997,394,192,202
33845,26227,4230,12662,2888,21997,394,192,202
33850,26232,4231,12664,2888,22001,394,192,202
33855,26234,4232,12666,2889,22002,394,192,202
33860,26242,4233,12671,2889,22009,394,192,202
33865,26245,4233,12672,2889,22012,394,192,202
33870,26250,4234,12674,2889,22016,395,192,203
33875,26254,4234,12676,2889,22019,395,192,203
33880,26257,4235,12678,2890,22022,395,192,203
33885,26258,4235,12678,2890,22023,395,192,203
33890,26263,4236,12681,2890,22026,395,192,203
33895,26265,4238,12683,2892,22027,395,192,203
33900,26273,4240,12687,2894,22033,395,192,203
33905,26276,4240,12688,2894,22036,395,192,203
33910,26281,4241,12691,2895,22040,396,193,203
33915,26285,4241,12693,2895,22043,396,193,203
33920,26288,4242,12693,2896,22046,396,193,203
33925,26289,4242,12694,2896,22047,396,193,203
33930,26294,4242,12697,2896,22051,396,193,203
33935,26296,4244,12699,2898,22052,396,193,203
33940,26304,4246,12703,2900,22058,396,193,203
33945,26307,4246,12704,2900,22061,396,193,203
33950,26312,4247,12707,2901,22065,397,193,204
33955,26316,4247,12709,2901,22069,397,193,204
33960,26319,4247,12710,2901,22072,397,193,204
33965,26320,4247,12711,2901,22073,397,193,204
33970,26325,4247,12712,2901,22077,397,193,204
33975,26327,4249,12713,2903,22078,397,193,204
33980,26335,4250,12718,2904,22085,397,193,204
33985,26338,4250,12720,2904,22088,397,193,204
33990,26343,4251,12723,2905,22092,397,193,204
33995,26347,4251,12724,2905,22096,397,193,204
34000,26350,4251,12726,2905,22099,397,193,204
34005,26351,4251,12727,2905,22100,397,193,204
34010,26356,4252,12729,2906,22104,397,193,204
34015,26358,4253,12730,2907,22105,397,193,204
34020,26366,4254,12733,2908,22112,397,193,204
34025,26369,4254,12735,2908,22115,397,193,204
34030,26374,4255,12736,2908,22119,397,193,204
34035,26378,4255,12738,2908,22123,397,193,204
34040,26381,4255,12740,2908,22126,397,193,204
34045,26382,4255,12740,2908,22127,397,193,204
34050,26387,4256,12742,2909,22131,397,193,204
34055,26389,4256,12742,2909,22133,397,193,204
34060,26397,4257,12746,2909,22140,397,193,204
34065,26400,4257,12749,2909,22143,397,193,204
34070,26405,4258,12752,2909,22147,398,194,204
34075,26409,4258,12755,2909,22151,398,194,204
34080,26412,4258,12755,2909,22154,398,194,204
34085,26413,4259,12756,2910,22154,398,194,204
34090,26418,4260,12758,2910,22158,398,194,204
34095,26420,4261,12760,2911,22159,398,194,204
34100,26428,4263,12765,2913,22165,398,194,204
34105,26431,4264,12767,2914,22167,398,194,204
34110,26436,4265,12770,2914,22171,398,194,204
34115,26440,4265,12771,2914,22175,398,194,204
34120,26443,4265,12771,2914,22178,398,194,204
34125,26444,4265,12772,2914,22179,398,194,204
34130,26449,4266,12774,2914,22183,398,194,204
34135,26451,4267,12775,2915,22184,398,194,204
34140,26459,4269,12781,2917,22190,398,194,204
34145,26462,4269,12781,2917,22193,398,194,204
34150,26467,4270,12782,2918,22197,398,194,204
34155,26471,4270,12784,2918,22200,398,194,204
34160,26474,4271,12785,2919,22203,398,194,204
34165,26475,4272,12786,2920,22203,398,194,204
34170,26480,4273,12790,2921,22206,398,194,204
34175,26482,4275,12791,2922,22207,398,194,204
34180,26490,4276,12795,2922,22214,398,194,204
34185,26493,4276,12797,2922,22217,398,194,204
34190,26498,4277,12801,2923,22221,398,194,204
34195,26502,4277,12802,2923,22225,398,194,204
34200,26505,4277,12803,2923,22228,398,194,204
34205,26506,4278,12804,2924,22228,398,194,204
34210,26511,4279,12806,2925,22232,398,194,204
34215,26513,4280,12807,2926,22233,398,194,204
34220,26521,4281,12809,2927,22240,398,194,204
34225,26524,4281,12811,2927,22243,398,194,204
34230,26529,4282,12815,2928,22247,398,194,204
34235,26533,4282,12818,2928,22250,398,194,204
34240,26536,4283,12819,2929,22253,398,194,204
34245,26537,4283,12819,2929,22254,398,194,204
34250,26542,4284,12821,2930,22257,398,194,204
34255,26544,4286,12823,2932,22258,398,194,204
34260,26552,4289,12828,2935,22263,398,194,204
34265,26555,4289,12828,2935,22266,398,194,204
34270,26560,4290,12830,2935,22270,398,194,204
34275,26564,4290,12831,2935,22274,398,194,204
34280,26567,4290,12833,2935,22277,398,194,204
34285,26568,4291,12834,2936,22277,398,194,204
34290,26573,4292,12836,2936,22281,398,194,204
34295,26575,4292,12836,2936,22283,398,194,204
34300,26583,4293,12839,2936,22290,398,194,204
34305,26586,4294,12841,2937,22292,398,194,204
34310,26591,4295,12845,2938,22296,398,194,204
34315,26595,4295,12846,2938,22300,398,194,204
34320,26598,4295,12847,2938,22303,398,194,204
34325,26599,4295,12847,2938,22304,398,194,204
34330,26604,4296,12850,2939,22308,398,194,204
34335,26606,4296,12851,2939,22310,398,194,204
34340,26614,4297,12854,2940,22317,398,194,204
34345,26617,4298,12856,2941,22319,398,194,204
34350,26622,4299,12859,2942,22323,398,194,204
34355,26626,4299,12862,2942,22327,398,194,204
34360,26629,4299,12864,2942,22330,398,194,204
34365,26630,4299,12864,2942,22331,398,194,204
34370,26635,4300,12865,2942,22334,398,194,204
34375,26637,4302,12866,2944,22335,398,194,204
34380,26645,4304,12870,2946,22341,398,194,204
34385,26648,4304,12871,2946,22344,398,194,204
34390,26653,4305,12875,2947,22348,398,194,204
34395,26657,4305,12875,2947,22352,398,194,204
34400,26660,4305,12876,2947,22355,398,194,204
34405,26661,4305,12877,2947,22356,398,194,204
34410,26666,4306,12879,2948,22360,398,194,204
34415,26668,4307,12880,2948,22361,398,194,204
34420,26676,4308,12885,2949,22368,398,194,204
34425,26679,4308,12887,2949,22371,398,194,204
34430,26684,4309,12890,2949,22375,398,194,204
34435,26688,4309,12891,2949,22379,398,194,204
34440,26691,4309,12892,2949,22382,398,194,204
34445,26692,4309,12893,2949,22383,398,194,204
34450,26697,4310,12895,2950,22386,398,194,204
34455,26699,4312,12897,2952,22387,398,194,204
34460,26707,4313,12900,2953,22394,398,194,204
34465,26710,4313,12901,2953,22397,398,194,204
34470,26715,4314,12904,2953,22401,398,194,204
34475,26719,4314,12905,2953,22405,398,194,204
34480,26722,4314,12907,2953,22408,398,194,204
34485,26723,4314,12907,2953,22409,398,194,204
34490,26728,4315,12910,2953,22412,398,194,204
34495,26730,4317,12911,2954,22413,398,194,204
34500,26738,4320,12915,2957,22418,398,194,204
34505,26741,4321,12917,2958,22420,398,194,204
34510,26746,4322,12919,2958,22424,398,194,204
34515,26750,4322,12922,2958,22428,398,194,204
34520,26753,4322,12923,2958,22431,398,194,204
34525,26754,4322,12923,2958,22432,398,194,204
34530,26759,4323,12926,2959,22436,398,194,204
34535,26761,4323,12928,2959,22438,398,194,204
34540,26769,4324,12934,2960,22445,398,194,204
34545,26772,4325,12936,2961,22447,398,194,204
34550,26777,4326,12938,2961,22451,398,194,204
34555,26781,4326,12941,2961,22455,398,194,204
34560,26784,4326,12943,2961,22458,398,194,204
34565,26785,4326,12943,2961,22459,398,194,204
34570,26790,4327,12944,2961,22463,398,194,204
34575,26792,4327,12945,2961,22465,398,194,204
34580,26800,4328,12952,2962,22472,398,194,204
34585,26803,4329,12954,2963,22474,398,194,204
34590,26808,4330,12957,2963,22478,398,194,204
34595,26812,4330,12958,2963,22482,398,194,204
34600,26815,4331,12960,2964,22484,398,194,204
34605,26816,4331,12960,2964,22485,398,194,204
34610,26821,4332,12961,2964,22488,398,194,204
34615,26823,4334,12962,2966,22489,398,194,204
34620,26831,4337,12967,2968,22494,398,194,204
34625,26834,4337,12969,2968,22497,398,194,204
34630,26839,4338,12973,2969,22501,398,194,204
34635,26843,4338,12977,2969,22504,398,194,204
34640,26846,4339,12980,2970,22507,398,194,204
34645,26847,4340,12981,2971,22507,398,194,204
34650,26852,4341,12985,2972,22510,398,194,204
34655,26854,4343,12987,2974,22511,398,194,204
34660,26862,4344,12991,2974,22518,398,194,204
34665,26865,4344,12992,2974,22521,398,194,204
34670,26870,4345,12995,2975,22525,398,194,204
34675,26874,4345,12996,2975,22529,398,194,204
34680,26877,4345,12997,2975,22532,398,194,204
34685,26878,4345,12997,2975,22533,398,194,204
34690,26883,4346,12999,2975,22537,398,194,204
34695,26885,4347,12999,2975,22538,398,194,204
34700,26893,4348,13002,2976,22545,398,194,204
34705,26896,4348,13002,2976,22548,398,194,204
34710,26901,4349,13006,2977,22552,398,194,204
34715,26905,4349,13008,2977,22556,398,194,204
34720,26908,4349,13010,2977,22559,398,194,204
34725,26909,4349,13010,2977,22560,398,194,204
34730,26914,4350,13012,2977,22564,398,194,204
34735,26916,4351,13012,2977,22565,398,194,204
34740,26924,4353,13017,2979,22571,398,194,204
34745,26927,4353,13018,2979,22574,398,194,204
34750,26932,4354,13021,2980,22578,398,194,204
34755,26936,4354,13023,2980,22582,398,194,204
34760,26939,4355,13025,2981,22584,398,194,204
34765,26940,4355,13025,2981,22585,398,194,204
34770,26945,4356,13026,2981,22589,398,194,204
34775,26947,4356,13028,2981,22591,398,194,204
34780,26955,4357,13034,2982,22598,398,194,204
34785,26958,4358,13036,2983,22600,398,194,204
34790,26963,4359,13037,2983,22604,398,194,204
34795,26967,4359,13039,2983,22608,398,194,204
34800,26970,4360,13041,2984,22610,398,194,204
34805,26971,4360,13041,2984,22611,398,194,204
34810,26976,4361,13044,2985,22615,398,194,204
34815,26978,4361,13045,2985,22617,398,194,204
34820,26986,4363,13049,2987,22623,398,194,204
34825,26989,4364,13051,2988,22625,398,194,204
34830,26994,4365,13052,2988,22629,399,195,204
34835,26998,4365,13054,2988,22633,399,195,204
34840,27001,4366,13057,2989,22635,399,195,204
34845,27002,4367,13058,2990,22635,399,195,204
34850,27007,4368,13060,2990,22639,399,195,204
34855,27009,4369,13061,2990,22640,399,195,204
34860,27017,4371,13065,2992,22646,399,195,204
34865,27020,4371,13067,2992,22649,399,195,204
34870,27025,4372,13069,2992,22653,399,195,204
34875,27029,4372,13070,2992,22657,399,195,204
34880,27032,4372,13072,2992,22660,399,195,204
34885,27033,4373,13073,2993,22660,399,195,204
34890,27038,4374,13077,2994,22663,399,195,204
34895,27040,4376,13078,2995,22664,399,195,204
34900,27048,4377,13084,2996,22671,399,195,204
34905,27051,4377,13085,2996,22674,399,195,204
34910,27056,4378,13089,2997,22678,399,195,204
34915,27060,4378,13092,2997,22682,399,195,204
34920,27063,4378,13093,2997,22685,399,195,204
34925,27064,4379,13094,2998,22685,399,195,204
34930,27069,4380,13096,2999,22689,399,195,204
34935,27071,4381,13098,3000,22690,399,195,204
34940,27079,4382,13103,3001,22697,399,195,204
34945,27082,4382,13104,3001,22700,399,195,204
34950,27087,4383,13106,3001,22704,399,195,204
34955,27091,4383,13108,3001,22707,399,195,204
34960,27094,4384,13109,3002,22710,399,195,204
34965,27095,4385,13110,3003,22710,399,195,204
34970,27100,4386,13113,3004,22714,399,195,204
34975,27102,4387,13115,3005,22715,399,195,204
34980,27110,4389,13120,3006,22721,399,195,204
34985,27113,4389,13123,3006,22724,399,195,204
34990,27118,4390,13124,3006,22728,399,195,204
34995,27122,4390,13127,3006,22731,399,195,204
35000,27125,4391,13129,3007,22734,399,195,204
35005,27126,4391,13129,3007,22735,399,195,204
35010,27131,4391,13132,3007,22740,399,195,204
35015,27133,4391,13133,3007,22742,399,195,204
35020,27141,4392,13138,3007,22749,399,195,204
35025,27144,4392,13138,3007,22752,399,195,204
35030,27149,4393,13140,3008,22756,399,195,204
35035,27153,4393,13143,3008,22759,399,195,204
35040,27156,4395,13144,3010,22761,399,195,204
35045,27157,4395,13145,3010,22762,399,195,204
35050,27162,4395,13147,3010,22767,399,195,204
35055,27164,4395,13149,3010,22769,399,195,204
35060,27172,4396,13154,3011,22776,399,195,204
35065,27175,4396,13157,3011,22779,399,195,204
35070,27180,4397,13158,3011,22783,399,195,204
35075,27184,4397,13158,3011,22787,399,195,204
35080,27187,4397,13159,3011,22790,399,195,204
35085,27188,4397,13159,3011,22791,399,195,204
35090,27193,4398,13161,3011,22794,399,195,204
35095,27195,4400,13162,3012,22795,399,195,204
35100,27203,4401,13163,3012,22802,399,195,204
35105,27206,4401,13166,3012,22805,399,195,204
35110,27211,4401,13169,3012,22810,399,195,204
35115,27215,4401,13171,3012,22813,399,195,204
35120,27218,4402,13172,3013,22816,399,195,204
35125,27219,4402,13172,3013,22817,399,195,204
35130,27224,4403,13174,3013,22820,399,195,204
35135,27226,4405,13175,3015,22821,399,195,204
35140,27234,4407,13182,3016,22827,399,195,204
35145,27237,4407,13183,3016,22830,399,195,204
35150,27242,4407,13186,3016,22835,399,195,204
35155,27246,4407,13188,3016,22839,399,195,204
35160,27249,4407,13189,3016,22842,399,195,204
35165,27250,4407,13189,3016,22843,399,195,204
35170,27255,4408,13193,3017,22846,399,195,204
35175,27257,4410,13194,3019,22847,399,195,204
35180,27265,4411,13199,3020,22854,399,195,204
35185,27268,4411,13201,3020,22857,399,195,204
35190,27273,4411,13202,3020,22862,399,195,204
35195,27277,4411,13206,3020,22865,399,195,204
35200,27280,4412,13208,3021,22868,399,195,204
35205,27281,4412,13209,3021,22869,399,195,204
35210,27286,4413,13213,3022,22872,399,195,204
35215,27288,4415,13213,3023,22873,399,195,204
35220,27296,4416,13215,3023,22880,399,195,204
35225,27299,4417,13217,3024,22882,399,195,204
35230,27304,4418,13220,3025,22886,399,195,204
35235,27308,4418,13221,3025,22890,399,195,204
35240,27311,4418,13223,3025,22893,399,195,204
35245,27312,4418,13224,3025,22894,399,195,204
35250,27317,4419,13226,3025,22897,399,195,204
35255,27319,4421,13228,3027,22898,399,195,204
35260,27327,4422,13229,3028,22905,399,195,204
35265,27330,4423,13230,3029,22907,399,195,204
35270,27335,4424,13231,3029,22911,399,195,204
35275,27339,4424,13234,3029,22915,399,195,204
35280,27342,4424,13236,3029,22918,399,195,204
35285,27343,4424,13236,3029,22919,399,195,204
35290,27348,4425,13237,3029,22923,399,195,204
35295,27350,4426,13238,3030,22924,399,195,204
35300,27358,4427,13242,3031,22931,399,195,204
35305,27361,4427,13244,3031,22934,399,195,204
35310,27366,4428,13247,3031,22938,399,195,204
35315,27370,4428,13249,3031,22942,399,195,204
35320,27373,4428,13250,3031,22945,399,195,204
35325,27374,4428,13250,3031,22946,399,195,204
35330,27379,4429,13255,3032,22949,399,195,204
35335,27381,4431,13256,3033,22950,399,195,204
35340,27389,4432,13258,3034,22957,399,195,204
35345,27392,4432,13259,3034,22960,399,195,204
35350,27397,4433,13262,3035,22964,399,195,204
35355,27401,4433,13263,3035,22968,399,195,204
35360,27404,4434,13265,3036,22970,399,195,204
35365,27405,4434,13265,3036,22971,399,195,204
35370,27410,4435,13268,3036,22974,399,195,204
35375,27412,4437,13268,3037,22975,399,195,204
35380,27420,4438,13269,3038,22982,399,195,204
35385,27423,4438,13270,3038,22985,399,195,204
35390,27428,4439,13272,3038,22989,399,195,204
35395,27432,4439,13275,3038,22993,399,195,204
35400,27435,4439,13275,3038,22996,399,195,204
35405,27436,4440,13276,3039,22996,399,195,204
35410,27441,4441,13279,3040,23000,399,195,204
35415,27443,4441,13280,3040,23002,399,195,204
35420,27451,4442,13283,3040,23009,399,195,204
35425,27454,4442,13284,3040,23012,399,195,204
35430,27459,4443,13286,3041,23016,399,195,204
35435,27463,4443,13286,3041,23020,399,195,204
35440,27466,4443,13287,3041,23023,399,195,204
35445,27467,4444,13288,3042,23023,399,195,204
35450,27472,4445,13290,3042,23027,399,195,204
35455,27474,4445,13291,3042,23029,399,195,204
35460,27482,4446,13294,3042,23036,399,195,204
35465,27485,4447,13295,3043,23038,399,195,204
35470,27490,4448,13298,3043,23042,399,195,204
35475,27494,4448,13300,3043,23046,399,195,204
35480,27497,4448,13301,3043,23049,399,195,204
35485,27498,4449,13302,3044,23049,399,195,204
35490,27503,4450,13304,3045,23053,399,195,204
35495,27505,4450,13305,3045,23055,399,195,204
35500,27513,4451,13310,3045,23062,399,195,204
35505,27516,4451,13312,3045,23065,399,195,204
35510,27521,4452,13314,3045,23069,399,195,204
35515,27525,4452,13316,3045,23073,399,195,204
35520,27528,4452,13316,3045,23076,399,195,204
35525,27529,4453,13317,3046,23076,399,195,204
35530,27534,4454,13318,3046,23080,399,195,204
35535,27536,4455,13318,3046,23081,399,195,204
35540,27544,4457,13322,3047,23087,399,195,204
35545,27547,4458,13323,3048,23089,399,195,204
35550,27552,4459,13326,3049,23093,399,195,204
35555,27556,4459,13328,3049,23097,399,195,204
35560,27559,4459,13329,3049,23100,399,195,204
35565,27560,4459,13329,3049,23101,399,195,204
35570,27565,4460,13333,3050,23104,399,195,204
35575,27567,4462,13333,3051,23105,399,195,204
35580,27575,4463,13334,3051,23112,399,195,204
35585,27578,4463,13334,3051,23115,399,195,204
35590,27583,4464,13336,3051,23119,399,195,204
35595,27587,4464,13340,3051,23123,399,195,204
35600,27590,4464,13340,3051,23126,399,195,204
35605,27591,4465,13341,3052,23126,399,195,204
35610,27596,4466,13343,3052,23129,399,195,204
35615,27598,4468,13344,3054,23130,399,195,204
35620,27606,4469,13347,3055,23137,399,195,204
35625,27609,4469,13347,3055,23140,399,195,204
35630,27614,4470,13348,3055,23144,400,195,205
35635,27618,4470,13350,3055,23148,400,195,205
35640,27621,4471,13352,3056,23150,400,195,205
35645,27622,4472,13353,3057,23150,400,195,205
35650,27627,4473,13354,3057,23154,400,195,205
35655,27629,4473,13354,3057,23156,400,195,205
35660,27637,4474,13355,3058,23163,400,195,205
35665,27640,4474,13356,3058,23166,400,195,205
35670,27645,4475,13358,3058,23170,400,195,205
35675,27649,4475,13361,3058,23174,400,195,205
35680,27652,4476,13363,3059,23176,400,195,205
35685,27653,4476,13363,3059,23177,400,195,205
35690,27658,4477,13365,3059,23181,400,195,205
35695,27660,4477,13366,3059,23183,400,195,205
35700,27668,4479,13370,3061,23189,400,195,205
35705,27671,4479,13373,3061,23192,400,195,205
35710,27676,4480,13375,3062,23196,400,195,205
35715,27680,4480,13376,3062,23200,400,195,205
35720,27683,4481,13379,3063,23202,400,195,205
35725,27684,4481,13380,3063,23203,400,195,205
35730,27689,4481,13384,3063,23208,400,195,205
35735,27691,4481,13384,3063,23210,400,195,205
35740,27699,4482,13387,3063,23217,400,195,205
35745,27702,4482,13388,3063,23220,400,195,205
35750,27707,4483,13390,3063,23224,401,196,205
35755,27711,4483,13391,3063,23227,401,196,205
35760,27714,4484,13392,3064,23230,401,196,205
35765,27715,4484,13393,3064,23231,401,196,205
35770,27720,4484,13394,3064,23236,401,196,205
35775,27722,4485,13395,3064,23237,401,196,205
35780,27730,4487,13396,3065,23243,401,196,205
35785,27733,4488,13398,3066,23245,401,196,205
35790,27738,4489,13399,3066,23249,401,196,205
35795,27742,4489,13401,3066,23253,401,196,205
35800,27745,4489,13402,3066,23256,401,196,205
35805,27746,4489,13403,3066,23257,401,196,205
35810,27751,4490,13406,3066,23261,401,196,205
35815,27753,4491,13406,3066,23262,401,196,205
35820,27761,4492,13408,3066,23269,401,196,205
35825,27764,4492,13410,3066,23272,401,196,205
35830,27769,4493,13415,3067,23276,401,196,205
35835,27773,4493,13419,3067,23279,401,196,205
35840,27776,4494,13421,3068,23282,401,196,205
35845,27777,4495,13422,3069,23282,401,196,205
35850,27782,4496,13425,3070,23286,401,196,205
35855,27784,4497,13426,3071,23287,401,196,205
35860,27792,4498,13427,3072,23294,401,196,205
35865,27795,4498,13429,3072,23297,401,196,205
35870,27800,4499,13430,3072,23301,402,196,206
35875,27804,4499,13430,3072,23305,402,196,206
35880,27807,4499,13432,3072,23308,402,196,206
35885,27808,4499,13432,3072,23309,402,196,206
35890,27813,4500,13434,3072,23313,402,196,206
35895,27815,4501,13436,3073,23314,402,196,206
35900,27823,4502,13439,3073,23321,402,196,206
35905,27826,4502,13440,3073,23324,402,196,206
35910,27831,4503,13442,3073,23328,403,197,206
35915,27835,4503,13445,3073,23332,403,197,206
35920,27838,4504,13447,3074,23334,403,197,206
35925,27839,4505,13448,3075,23334,403,197,206
35930,27844,4506,13450,3076,23337,403,197,206
35935,27846,4508,13450,3077,23338,403,197,206
35940,27854,4510,13454,3079,23344,403,197,206
35945,27857,4511,13455,3079,23346,403,197,206
35950,27862,4512,13457,3079,23350,403,197,206
35955,27866,4512,13459,3079,23354,403,197,206
35960,27869,4512,13461,3079,23357,403,197,206
35965,27870,4512,13461,3079,23358,403,197,206
35970,27875,4513,13462,3079,23362,403,197,206
35975,27877,4513,13464,3079,23364,403,197,206
35980,27885,4515,13469,3080,23370,403,197,206
35985,27888,4516,13471,3080,23372,403,197,206
35990,27893,4517,13474,3081,23376,403,197,206
35995,27897,4517,13478,3081,23379,403,197,206
36000,27900,4518,13479,3082,23382,403,197,206
36005,27901,4518,13480,3082,23383,403,197,206
36010,27906,4519,13481,3082,23387,403,197,206
36015,27908,4519,13483,3082,23389,403,197,206
36020,27916,4521,13488,3084,23395,403,197,206
36025,27919,4522,13489,3084,23397,403,197,206
36030,27924,4523,13490,3084,23401,403,197,206
36035,27928,4523,13494,3084,23404,403,197,206
36040,27931,4524,13494,3085,23407,403,197,206
36045,27932,4525,13495,3086,23407,403,197,206
36050,27937,4526,13499,3087,23410,403,197,206
36055,27939,4528,13500,3088,23411,403,197,206
36060,27947,4531,13503,3090,23416,403,197,206
36065,27950,4531,13505,3090,23419,403,197,206
36070,27955,4532,13508,3091,23423,403,197,206
36075,27959,4532,13509,3091,23426,403,197,206
36080,27962,4534,13511,3093,23428,403,197,206
36085,27963,4535,13512,3094,23428,403,197,206
36090,27968,4536,13514,3094,23431,403,197,206
36095,27970,4538,13515,3095,23432,403,197,206
36100,27978,4539,13520,3095,23439,403,197,206
36105,27981,4539,13521,3095,23442,403,197,206
36110,27986,4540,13522,3095,23446,403,197,206
36115,27990,4540,13524,3095,23450,403,197,206
36120,27993,4540,13525,3095,23453,403,197,206
36125,27994,4540,13525,3095,23454,403,197,206
36130,27999,4541,13526,3095,23458,403,197,206
36135,28001,4542,13527,3096,23459,403,197,206
36140,28009,4543,13531,3097,23466,403,197,206
36145,28012,4543,13532,3097,23469,403,197,206
36150,28017,4544,13536,3098,23473,403,197,206
36155,28021,4544,13537,3098,23477,403,197,206
36160,28024,4544,13538,3098,23480,403,197,206
36165,28025,4545,13539,3099,23480,403,197,206
36170,28030,4546,13541,3099,23483,403,197,206
36175,28032,4548,13542,3101,23484,403,197,206
36180,28040,4550,13545,3102,23490,403,197,206
36185,28043,4551,13548,3103,23492,403,197,206
36190,28048,4552,13551,3104,23496,403,197,206
36195,28052,4552,13554,3104,23500,403,197,206
36200,28055,4552,13556,3104,23503,403,197,206
36205,28056,4552,13556,3104,23504,403,197,206
36210,28061,4552,13558,3104,23508,403,197,206
36215,28063,4554,13559,3106,23509,403,197,206
36220,28071,4556,13561,3106,23515,403,197,206
36225,28074,4557,13562,3106,23517,403,197,206
36230,28079,4558,13564,3106,23521,403,197,206
36235,28083,4558,13564,3106,23525,403,197,206
36240,28086,4559,13565,3107,23527,403,197,206
36245,28087,4559,13566,3107,23528,403,197,206
36250,28092,4559,13569,3107,23532,403,197,206
36255,28094,4561,13570,3109,23533,403,197,206
36260,28102,4562,13574,3109,23540,403,197,206
36265,28105,4562,13576,3109,23543,403,197,206
36270,28110,4563,13577,3109,23547,404,197,207
36275,28114,4563,13578,3109,23551,404,197,207
36280,28117,4563,13578,3109,23554,404,197,207
36285,28118,4563,13579,3109,23555,404,197,207
36290,28123,4564,13580,3109,23559,404,197,207
36295,28125,4565,13580,3109,23560,404,197,207
36300,28133,4567,13584,3110,23566,404,197,207
36305,28136,4567,13586,3110,23569,404,197,207
36310,28141,4568,13588,3111,23573,404,197,207
36315,28145,4568,13589,3111,23576,404,197,207
36320,28148,4569,13591,3112,23579,404,197,207
36325,28149,4570,13592,3113,23579,404,197,207
36330,28154,4571,13594,3113,23583,404,197,207
36335,28156,4571,13595,3113,23585,404,197,207
36340,28164,4572,13599,3113,23592,404,197,207
36345,28167,4572,13599,3113,23595,404,197,207
36350,28172,4573,13602,3114,23599,404,197,207
36355,28176,4573,13603,3114,23602,404,197,207
36360,28179,4574,13604,3115,23605,404,197,207
36365,28180,4574,13604,3115,23606,404,197,207
36370,28185,4575,13607,3115,23609,404,197,207
36375,28187,4577,13609,3117,23610,404,197,207
36380,28195,4579,13617,3119,23616,404,197,207
36385,28198,4580,13619,3120,23618,404,197,207
36390,28203,4581,13621,3121,23622,405,197,208
36395,28207,4581,13623,3121,23626,405,197,208
36400,28210,4581,13624,3121,23629,405,197,208
36405,28211,4581,13624,3121,23630,405,197,208
36410,28216,4582,13626,3121,23633,405,197,208
36415,28218,4584,13626,3122,23634,405,197,208
36420,28226,4586,13628,3122,23640,405,197,208
36425,28229,4587,13629,3122,23642,405,197,208
36430,28234,4588,13633,3123,23646,406,197,209
36435,28238,4588,13635,3123,23650,406,197,209
36440,28241,4589,13637,3124,23652,406,197,209
36445,28242,4590,13638,3125,23652,406,197,209
36450,28247,4591,13642,3125,23656,406,197,209
36455,28249,4591,13643,3125,23658,406,197,209
36460,28257,4593,13645,3126,23664,406,197,209
36465,28260,4594,13645,3126,23666,406,197,209
36470,28265,4595,13647,3127,23670,407,197,210
36475,28269,4595,13648,3127,23673,407,197,210
36480,28272,4596,13649,3128,23676,407,197,210
36485,28273,4597,13650,3129,23676,407,197,210
36490,28278,4598,13654,3130,23680,407,197,210
36495,28280,4598,13654,3130,23682,407,197,210
36500,28288,4599,13660,3131,23689,407,197,210
36505,28291,4600,13661,3131,23691,407,197,210
36510,28296,4600,13665,3131,23696,407,197,210
36515,28300,4600,13667,3131,23700,407,197,210
36520,28303,4600,13669,3131,23703,407,197,210
36525,28304,4600,13669,3131,23704,407,197,210
36530,28309,4601,13671,3132,23708,407,197,210
36535,28311,4602,13672,3133,23709,407,197,210
36540,28319,4604,13674,3135,23715,407,197,210
36545,28322,4604,13676,3135,23718,407,197,210
36550,28327,4604,13677,3135,23723,407,197,210
36555,28331,4604,13677,3135,23727,407,197,210
36560,28334,4604,13679,3135,23730,407,197,210
36565,28335,4604,13679,3135,23731,407,197,210
36570,28340,4605,13679,3135,23735,407,197,210
36575,28342,4606,13679,3135,23736,407,197,210
36580,28350,4607,13683,3136,23743,407,197,210
36585,28353,4607,13684,3136,23746,407,197,210
36590,28358,4608,13687,3136,23750,407,197,210
36595,28362,4608,13688,3136,23754,407,197,210
36600,28365,4608,13688,3136,23757,407,197,210
36605,28366,4608,13688,3136,23758,407,197,210
36610,28371,4609,13690,3137,23762,407,197,210
36615,28373,4610,13692,3138,23763,407,197,210
36620,28381,4612,13696,3140,23769,407,197,210
36625,28384,4612,13697,3140,23772,407,197,210
36630,28389,4613,13700,3140,23776,408,198,210
36635,28393,4613,13700,3140,23780,408,198,210
36640,28396,4613,13700,3140,23783,408,198,210
36645,28397,4613,13700,3140,23784,408,198,210
36650,28402,4614,13703,3141,23788,408,198,210
36655,28404,4615,13705,3142,23789,408,198,210
36660,28412,4618,13708,3143,23794,408,198,210
36665,28415,4619,13710,3143,23796,408,198,210
36670,28420,4620,13711,3143,23800,409,198,211
36675,28424,4620,13712,3143,23804,409,198,211
36680,28427,4621,13715,3144,23806,409,198,211
36685,28428,4621,13715,3144,23807,409,198,211
36690,28433,4622,13717,3145,23811,409,198,211
36695,28435,4623,13719,3146,23812,409,198,211
36700,28443,4624,13723,3146,23819,409,198,211
36705,28446,4625,13725,3146,23821,409,198,211
36710,28451,4626,13726,3146,23825,410,198,212
36715,28455,4626,13729,3146,23829,410,198,212
36720,28458,4627,13731,3147,23831,410,198,212
36725,28459,4628,13732,3148,23831,410,198,212
36730,28464,4629,13734,3149,23835,410,198,212
36735,28466,4630,13735,3150,23836,410,198,212
36740,28474,4631,13740,3151,23843,410,198,212
36745,28477,4632,13741,3151,23845,410,198,212
36750,28482,4633,13743,3151,23849,410,198,212
36755,28486,4633,13744,3151,23853,410,198,212
36760,28489,4634,13745,3152,23855,410,198,212
36765,28490,4635,13746,3153,23855,410,198,212
36770,28495,4636,13749,3154,23858,410,198,212
36775,28497,4638,13751,3156,23859,410,198,212
36780,28505,4640,13754,3157,23865,410,198,212
36785,28508,4641,13756,3158,23867,410,198,212
36790,28513,4641,13759,3158,23872,410,198,212
36795,28517,4641,13762,3158,23875,410,198,212
36800,28520,4642,13764,3159,23878,410,198,212
36805,28521,4643,13765,3160,23878,410,198,212
36810,28526,4644,13767,3160,23882,410,198,212
36815,28528,4644,13769,3160,23884,410,198,212
36820,28536,4645,13773,3161,23891,410,198,212
36825,28539,4646,13775,3162,23893,410,198,212
36830,28544,4646,13778,3162,23898,410,198,212
36835,28548,4646,13779,3162,23902,410,198,212
36840,28551,4646,13780,3162,23905,410,198,212
36845,28552,4646,13780,3162,23906,410,198,212
36850,28557,4647,13783,3162,23910,410,198,212
36855,28559,4647,13784,3162,23912,410,198,212
36860,28567,4648,13787,3162,23919,410,198,212
36865,28570,4649,13787,3162,23921,410,198,212
36870,28575,4649,13789,3162,23926,410,198,212
36875,28579,4649,13790,3162,23930,410,198,212
36880,28582,4649,13792,3162,23933,410,198,212
36885,28583,4649,13792,3162,23934,410,198,212
36890,28588,4650,13794,3162,23937,410,198,212
36895,28590,4652,13795,3163,23938,410,198,212
36900,28598,4654,13798,3164,23944,410,198,212
36905,28601,4654,13800,3164,23947,410,198,212
36910,28606,4655,13804,3165,23951,410,198,212
36915,28610,4655,13806,3165,23955,410,198,212
36920,28613,4655,13808,3165,23958,410,198,212
36925,28614,4655,13809,3165,23959,410,198,212
36930,28619,4655,13812,3165,23963,410,198,212
36935,28621,4657,13814,3167,23964,410,198,212
36940,28629,4659,13816,3168,23970,410,198,212
36945,28632,4659,13817,3168,23973,410,198,212
36950,28637,4660,13819,3169,23977,410,198,212
36955,28641,4660,13820,3169,23981,410,198,212
36960,28644,4660,13820,3169,23984,410,198,212
36965,28645,4660,13820,3169,23985,410,198,212
36970,28650,4660,13823,3169,23990,410,198,212
36975,28652,4661,13823,3169,23991,410,198,212
36980,28660,4663,13825,3170,23997,410,198,212
36985,28663,4663,13827,3170,24000,410,198,212
36990,28668,4663,13829,3170,24005,410,198,212
36995,28672,4663,13831,3170,24009,410,198,212
37000,28675,4663,13831,3170,24012,410,198,212
37005,28676,4663,13831,3170,24013,410,198,212
37010,28681,4664,13836,3171,24016,410,198,212
37015,28683,4666,13836,3172,24017,410,198,212
37020,28691,4669,13840,3174,24022,410,198,212
37025,28694,4670,13841,3175,24024,410,198,212
37030,28699,4670,13845,3175,24029,410,198,212
37035,28703,4670,13846,3175,24033,410,198,212
37040,28706,4670,13847,3175,24036,410,198,212
37045,28707,4670,13848,3175,24037,410,198,212
37050,28712,4671,13852,3176,24041,410,198,212
37055,28714,4671,13853,3176,24043,410,198,212
37060,28722,4672,13857,3176,24050,410,198,212
37065,28725,4673,13860,3177,24052,410,198,212
37070,28730,4674,13863,3177,24056,410,198,212
37075,28734,4674,13865,3177,24060,410,198,212
37080,28737,4674,13868,3177,24063,410,198,212
37085,28738,4674,13868,3177,24064,410,198,212
37090,28743,4675,13870,3178,24068,410,198,212
37095,28745,4675,13871,3178,24070,410,198,212
37100,28753,4676,13874,3179,24077,410,198,212
37105,28756,4677,13877,3180,24079,410,198,212
37110,28761,4678,13879,3181,24083,410,198,212
37115,28765,4678,13881,3181,24087,410,198,212
37120,28768,4678,13883,3181,24090,410,198,212
37125,28769,4678,13883,3181,24091,410,198,212
37130,28774,4679,13885,3182,24095,410,198,212
37135,28776,4680,13887,3183,24096,410,198,212
37140,28784,4681,13890,3183,24103,410,198,212
37145,28787,4681,13892,3183,24106,410,198,212
37150,28792,4682,13896,3184,24110,410,198,212
37155,28796,4682,13898,3184,24114,410,198,212
37160,28799,4682,13900,3184,24117,410,198,212
37165,28800,4683,13901,3185,24117,410,198,212
37170,28805,4684,13902,3185,24121,410,198,212
37175,28807,4685,13902,3185,24122,410,198,212
37180,28815,4686,13906,3185,24129,410,198,212
37185,28818,4686,13907,3185,24132,410,198,212
37190,28823,4687,13909,3186,24136,410,198,212
37195,28827,4687,13912,3186,24139,410,198,212
37200,28830,4688,13913,3187,24142,410,198,212
37205,28831,4689,13914,3188,24142,410,198,212
37210,28836,4690,13915,3189,24146,410,198,212
37215,28838,4691,13915,3189,24147,410,198,212
37220,28846,4692,13918,3189,24154,410,198,212
37225,28849,4692,13920,3189,24157,410,198,212
37230,28854,4693,13922,3189,24161,410,198,212
37235,28858,4693,13922,3189,24165,410,198,212
37240,28861,4693,13924,3189,24168,410,198,212
37245,28862,4694,13925,3190,24168,410,198,212
37250,28867,4695,13928,3191,24172,410,198,212
37255,28869,4696,13929,3192,24173,410,198,212
37260,28877,4698,13935,3194,24179,410,198,212
37265,28880,4698,13935,3194,24182,410,198,212
37270,28885,4699,13937,3195,24186,410,198,212
37275,28889,4699,13938,3195,24190,410,198,212
37280,28892,4699,13939,3195,24193,410,198,212
37285,28893,4699,13939,3195,24194,410,198,212
37290,28898,4700,13940,3195,24198,410,198,212
37295,28900,4701,13941,3196,24199,410,198,212
37300,28908,4702,13945,3196,24206,410,198,212
37305,28911,4702,13947,3196,24209,410,198,212
37310,28916,4703,13948,3196,24213,410,198,212
37315,28920,4703,13950,3196,24217,410,198,212
37320,28923,4704,13951,3197,24219,410,198,212
37325,28924,4705,13952,3198,24219,410,198,212
37330,28929,4706,13954,3198,24223,410,198,212
37335,28931,4707,13955,3199,24224,410,198,212
37340,28939,4708,13960,3200,24231,410,198,212
37345,28942,4708,13961,3200,24234,410,198,212
37350,28947,4709,13963,3200,24238,410,198,212
37355,28951,4709,13966,3200,24242,410,198,212
37360,28954,4710,13969,3201,24244,410,198,212
37365,28955,4710,13969,3201,24245,410,198,212
37370,28960,4711,13972,3201,24248,410,198,212
37375,28962,4713,13972,3202,24249,410,198,212
37380,28970,4716,13976,3205,24254,410,198,212
37385,28973,4716,13977,3205,24257,410,198,212
37390,28978,4717,13977,3205,24261,410,198,212
37395,28982,4717,13979,3205,24264,410,198,212
37400,28985,4718,13979,3206,24267,410,198,212
37405,28986,4719,13980,3207,24267,410,198,212
37410,28991,4720,13984,3207,24271,410,198,212
37415,28993,4720,13985,3207,24273,410,198,212
37420,29001,4721,13986,3207,24280,410,198,212
37425,29004,4721,13986,3207,24283,410,198,212
37430,29009,4722,13989,3207,24287,410,198,212
37435,29013,4722,13990,3207,24290,410,198,212
37440,29016,4723,13990,3208,24293,410,198,212
37445,29017,4723,13990,3208,24294,410,198,212
37450,29022,4724,13992,3208,24298,410,198,212
37455,29024,4724,13993,3208,24300,410,198,212
37460,29032,4725,13995,3208,24307,410,198,212
37465,29035,4725,13995,3208,24310,410,198,212
37470,29040,4726,13996,3208,24314,410,198,212
37475,29044,4726,13997,3208,24318,410,198,212
37480,29047,4726,13998,3208,24321,410,198,212
37485,29048,4727,13999,3209,24321,410,198,212
37490,29053,4728,14004,3210,24324,410,198,212
37495,29055,4730,14005,3211,24325,410,198,212
37500,29063,4732,14010,3213,24331,410,198,212
37505,29066,4732,14012,3213,24334,410,198,212
37510,29071,4733,14014,3213,24338,410,198,212
37515,29075,4733,14016,3213,24341,410,198,212
37520,29078,4734,14017,3214,24344,410,198,212
37525,29079,4734,14017,3214,24345,410,198,212
37530,29084,4734,14020,3214,24349,410,198,212
37535,29086,4736,14022,3216,24350,410,198,212
37540,29094,4737,14024,3216,24357,410,198,212
37545,29097,4737,14024,3216,24360,410,198,212
37550,29102,4738,14027,3216,24364,410,198,212
37555,29106,4738,14029,3216,24368,410,198,212
37560,29109,4738,14031,3216,24371,410,198,212
37565,29110,4738,14032,3216,24372,410,198,212
37570,29115,4738,14036,3216,24376,410,198,212
37575,29117,4740,14037,3218,24377,410,198,212
37580,29125,4741,14041,3219,24384,410,198,212
37585,29128,4741,14043,3219,24387,410,198,212
37590,29133,4742,14047,3220,24391,411,199,212
37595,29137,4742,14048,3220,24395,411,199,212
37600,29140,4742,14049,3220,24398,411,199,212
37605,29141,4742,14049,3220,24399,411,199,212
37610,29146,4743,14051,3220,24403,411,199,212
37615,29148,4744,14052,3221,24404,411,199,212
37620,29156,4745,14054,3222,24411,411,199,212
37625,29159,4746,14057,3223,24413,411,199,212
37630,29164,4747,14060,3223,24417,411,199,212
37635,29168,4747,14062,3223,24421,411,199,212
37640,29171,4747,14063,3223,24424,411,199,212
37645,29172,4748,14064,3224,24424,411,199,212
37650,29177,4749,14067,3225,24428,411,199,212
37655,29179,4750,14069,3226,24429,411,199,212
37660,29187,4751,14072,3226,24436,411,199,212
37665,29190,4751,14072,3226,24439,411,199,212
37670,29195,4752,14075,3227,24443,411,199,212
37675,29199,4752,14078,3227,24447,411,199,212
37680,29202,4753,14080,3228,24449,411,199,212
37685,29203,4753,14080,3228,24450,411,199,212
37690,29208,4754,14082,3228,24454,411,199,212
37695,29210,4754,14084,3228,24456,411,199,212
37700,29218,4756,14091,3230,24462,411,199,212
37705,29221,4757,14092,3231,24464,411,199,212
37710,29226,4758,14096,3231,24468,411,199,212
37715,29230,4758,14099,3231,24472,411,199,212
37720,29233,4758,14100,3231,24475,411,199,212
37725,29234,4759,14101,3232,24475,411,199,212
37730,29239,4760,14103,3233,24479,411,199,212
37735,29241,4760,14105,3233,24481,411,199,212
37740,29249,4761,14108,3234,24488,411,199,212
37745,29252,4762,14111,3235,24490,411,199,212
37750,29257,4763,14113,3235,24494,411,199,212
37755,29261,4763,14115,3235,24498,411,199,212
37760,29264,4763,14116,3235,24501,411,199,212
37765,29265,4764,14117,3236,24501,411,199,212
37770,29270,4765,14119,3236,24505,411,199,212
37775,29272,4765,14121,3236,24507,411,199,212
37780,29280,4766,14125,3237,24514,411,199,212
37785,29283,4766,14127,3237,24517,411,199,212
37790,29288,4767,14130,3238,24521,412,199,213
37795,29292,4767,14131,3238,24524,412,199,213
37800,29295,4768,14132,3239,24527,412,199,213
37805,29296,4769,14133,3240,24527,412,199,213
37810,29301,4769,14136,3240,24531,412,199,213
37815,29303,4771,14136,3241,24532,412,199,213
37820,29311,4772,14139,3241,24539,412,199,213
37825,29314,4772,14140,3241,24542,412,199,213
37830,29319,4773,14141,3241,24546,412,199,213
37835,29323,4773,14143,3241,24549,412,199,213
37840,29326,4775,14146,3243,24551,412,199,213
37845,29327,4775,14146,3243,24552,412,199,213
37850,29332,4775,14148,3243,24557,412,199,213
37855,29334,4776,14148,3243,24558,412,199,213
37860,29342,4777,14152,3243,24565,412,199,213
37865,29345,4777,14153,3243,24568,412,199,213
37870,29350,4778,14155,3243,24572,412,199,213
37875,29354,4778,14156,3243,24575,412,199,213
37880,29357,4779,14157,3244,24578,412,199,213
37885,29358,4779,14158,3244,24579,412,199,213
37890,29363,4779,14160,3244,24583,412,199,213
37895,29365,4781,14161,3245,24584,412,199,213
37900,29373,4782,14167,3245,24591,412,199,213
37905,29376,4782,14167,3245,24594,412,199,213
37910,29381,4783,14168,3245,24598,413,200,213
37915,29385,4783,14170,3245,24602,413,200,213
37920,29388,4784,14171,3246,24604,413,200,213
37925,29389,4785,14172,3247,24604,413,200,213
37930,29394,4786,14174,3247,24608,413,200,213
37935,29396,4786,14174,3247,24610,413,200,213
37940,29404,4788,14179,3249,24616,413,200,213
37945,29407,4788,14179,3249,24619,413,200,213
37950,29412,4789,14181,3249,24623,413,200,213
37955,29416,4789,14182,3249,24627,413,200,213
37960,29419,4789,14184,3249,24630,413,200,213
37965,29420,4790,14185,3250,24630,413,200,213
37970,29425,4791,14187,3250,24634,413,200,213
37975,29427,4791,14188,3250,24636,413,200,213
37980,29435,4793,14194,3252,24642,413,200,213
37985,29438,4793,14196,3252,24645,413,200,213
37990,29443,4794,14199,3252,24649,413,200,213
37995,29447,4794,14200,3252,24653,413,200,213
38000,29450,4794,14203,3252,24656,413,200,213
38005,29451,4794,14203,3252,24657,413,200,213
38010,29456,4795,14206,3253,24661,413,200,213
38015,29458,4795,14208,3253,24663,413,200,213
38020,29466,4796,14213,3254,24670,413,200,213
38025,29469,4796,14214,3254,24673,413,200,213
38030,29474,4797,14216,3255,24677,414,201,213
38035,29478,4797,14218,3255,24681,414,201,213
38040,29481,4797,14220,3255,24684,414,201,213
38045,29482,4797,14220,3255,24685,414,201,213
38050,29487,4798,14222,3255,24689,414,201,213
38055,29489,4799,14223,3256,24690,414,201,213
38060,29497,4800,14227,3256,24697,414,201,213
38065,29500,4800,14229,3256,24700,414,201,213
38070,29505,4801,14232,3256,24704,415,202,213
38075,29509,4801,14235,3256,24707,415,202,213
38080,29512,4803,14236,3258,24709,415,202,213
38085,29513,4803,14236,3258,24710,415,202,213
38090,29518,4804,14239,3258,24713,415,202,213
38095,29520,4806,14241,3260,24714,415,202,213
38100,29528,4809,14248,3263,24719,415,202,213
38105,29531,4809,14250,3263,24722,415,202,213
38110,29536,4810,14254,3264,24726,415,202,213
38115,29540,4810,14256,3264,24730,415,202,213
38120,29543,4810,14257,3264,24733,415,202,213
38125,29544,4810,14257,3264,24734,415,202,213
38130,29549,4810,14258,3264,24738,415,202,213
38135,29551,4812,14260,3266,24739,415,202,213
38140,29559,4813,14265,3266,24746,415,202,213
38145,29562,4813,14266,3266,24749,415,202,213
38150,29567,4814,14268,3267,24753,415,202,213
38155,29571,4814,14268,3267,24757,415,202,213
38160,29574,4814,14270,3267,24760,415,202,213
38165,29575,4814,14271,3267,24761,415,202,213
38170,29580,4814,14274,3267,24765,415,202,213
38175,29582,4816,14275,3269,24766,415,202,213
38180,29590,4818,14277,3270,24772,415,202,213
38185,29593,4818,14278,3270,24775,415,202,213
38190,29598,4819,14281,3270,24779,415,202,213
38195,29602,4819,14283,3270,24783,415,202,213
38200,29605,4819,14284,3270,24786,415,202,213
38205,29606,4819,14285,3270,24787,415,202,213
38210,29611,4820,14288,3271,24791,415,202,213
38215,29613,4821,14288,3271,24792,415,202,213
38220,29621,4824,14292,3273,24797,415,202,213
38225,29624,4824,14293,3273,24800,415,202,213
38230,29629,4825,14296,3274,24804,415,202,213
38235,29633,4825,14299,3274,24807,415,202,213
38240,29636,4826,14300,3275,24810,415,202,213
38245,29637,4827,14301,3276,24810,415,202,213
38250,29642,4828,14303,3276,24814,415,202,213
38255,29644,4828,14305,3276,24816,415,202,213
38260,29652,4829,14309,3277,24823,415,202,213
38265,29655,4829,14312,3277,24826,415,202,213
38270,29660,4830,14315,3277,24830,415,202,213
38275,29664,4830,14318,3277,24833,415,202,213
38280,29667,4832,14321,3279,24835,415,202,213
38285,29668,4833,14322,3280,24835,415,202,213
38290,29673,4834,14324,3280,24839,415,202,213
38295,29675,4834,14326,3280,24841,415,202,213
38300,29683,4835,14330,3280,24848,415,202,213
38305,29686,4835,14330,3280,24851,415,202,213
38310,29691,4836,14331,3280,24855,416,202,214
38315,29695,4836,14334,3280,24858,416,202,214
38320,29698,4838,14337,3282,24860,416,202,214
38325,29699,4838,14337,3282,24861,416,202,214
38330,29704,4839,14339,3283,24865,416,202,214
38335,29706,4840,14340,3284,24866,416,202,214
38340,29714,4841,14343,3285,24873,416,202,214
38345,29717,4842,14345,3286,24875,416,202,214
38350,29722,4842,14346,3286,24880,416,202,214
38355,29726,4842,14349,3286,24884,416,202,214
38360,29729,4843,14350,3287,24886,416,202,214
38365,29730,4843,14350,3287,24887,416,202,214
38370,29735,4843,14353,3287,24891,416,202,214
38375,29737,4845,14354,3289,24892,416,202,214
38380,29745,4846,14359,3290,24899,416,202,214
38385,29748,4846,14359,3290,24902,416,202,214
38390,29753,4846,14362,3290,24907,416,202,214
38395,29757,4846,14365,3290,24911,416,202,214
38400,29760,4847,14367,3291,24913,416,202,214
38405,29761,4847,14368,3291,24914,416,202,214
38410,29766,4847,14370,3291,24919,416,202,214
38415,29768,4848,14371,3291,24920,416,202,214
38420,29776,4849,14376,3291,24927,416,202,214
38425,29779,4850,14379,3292,24929,416,202,214
38430,29784,4850,14382,3292,24934,417,203,214
38435,29788,4850,14385,3292,24938,417,203,214
38440,29791,4851,14387,3293,24940,417,203,214
38445,29792,4851,14387,3293,24941,417,203,214
38450,29797,4852,14390,3293,24944,417,203,214
38455,29799,4854,14391,3295,24945,417,203,214
38460,29807,4856,14396,3297,24951,417,203,214
38465,29810,4856,14396,3297,24954,417,203,214
38470,29815,4857,14398,3298,24958,417,203,214
38475,29819,4857,14400,3298,24962,417,203,214
38480,29822,4857,14401,3298,24965,417,203,214
38485,29823,4857,14401,3298,24966,417,203,214
38490,29828,4858,14405,3299,24970,417,203,214
38495,29830,4858,14406,3299,24972,417,203,214
38500,29838,4859,14411,3300,24979,417,203,214
38505,29841,4860,14414,3301,24981,417,203,214
38510,29846,4861,14417,3301,24985,417,203,214
38515,29850,4861,14419,3301,24989,417,203,214
38520,29853,4861,14419,3301,24992,417,203,214
38525,29854,4861,14420,3301,24993,417,203,214
38530,29859,4862,14421,3302,24997,417,203,214
38535,29861,4862,14423,3302,24999,417,203,214
38540,29869,4863,14426,3302,25006,417,203,214
38545,29872,4864,14428,3303,25008,417,203,214
38550,29877,4865,14429,3303,25012,418,204,214
38555,29881,4865,14430,3303,25016,418,204,214
38560,29884,4865,14430,3303,25019,418,204,214
38565,29885,4865,14430,3303,25020,418,204,214
38570,29890,4866,14434,3304,25024,418,204,214
38575,29892,4867,14435,3305,25025,418,204,214
38580,29900,4870,14440,3308,25030,418,204,214
38585,29903,4870,14441,3308,25033,418,204,214
38590,29908,4871,14444,3309,25037,418,204,214
38595,29912,4871,14446,3309,25041,418,204,214
38600,29915,4872,14448,3310,25043,418,204,214
38605,29916,4872,14448,3310,25044,418,204,214
38610,29921,4873,14451,3311,25048,418,204,214
38615,29923,4874,14453,3312,25049,418,204,214
38620,29931,4875,14456,3312,25056,418,204,214
38625,29934,4875,14457,3312,25059,418,204,214
38630,29939,4876,14459,3312,25063,418,204,214
38635,29943,4876,14460,3312,25066,418,204,214
38640,29946,4878,14461,3314,25068,418,204,214
38645,29947,4879,14462,3315,25068,418,204,214
38650,29952,4880,14465,3315,25071,418,204,214
38655,29954,4882,14466,3317,25072,418,204,214
38660,29962,4883,14472,3318,25079,418,204,214
38665,29965,4883,14474,3318,25082,418,204,214
38670,29970,4884,14475,3318,25086,418,204,214
38675,29974,4884,14476,3318,25090,418,204,214
38680,29977,4884,14479,3318,25093,418,204,214
38685,29978,4885,14480,3319,25093,418,204,214
38690,29983,4886,14483,3320,25096,418,204,214
38695,29985,4888,14484,3321,25097,418,204,214
38700,29993,4890,14487,3323,25103,418,204,214
38705,29996,4891,14490,3324,25105,418,204,214
38710,30001,4892,14492,3325,25109,418,204,214
38715,30005,4892,14495,3325,25113,418,204,214
38720,30008,4892,14496,3325,25116,418,204,214
38725,30009,4893,14497,3326,25116,418,204,214
38730,30014,4894,14500,3327,25120,418,204,214
38735,30016,4895,14500,3327,25121,418,204,214
38740,30024,4897,14506,3328,25127,418,204,214
38745,30027,4898,14508,3329,25129,418,204,214
38750,30032,4899,14512,3330,25133,418,204,214
38755,30036,4899,14515,3330,25137,418,204,214
38760,30039,4899,14515,3330,25140,418,204,214
38765,30040,4900,14516,3331,25140,418,204,214
38770,30045,4901,14516,3331,25144,418,204,214
38775,30047,4901,14517,3331,25146,418,204,214
38780,30055,4902,14518,3331,25153,418,204,214
38785,30058,4902,14520,3331,25156,418,204,214
38790,30063,4903,14524,3331,25160,418,204,214
38795,30067,4903,14526,3331,25164,418,204,214
38800,30070,4903,14528,3331,25167,418,204,214
38805,30071,4903,14528,3331,25168,418,204,214
38810,30076,4904,14529,3331,25172,418,204,214
38815,30078,4904,14529,3331,25174,418,204,214
38820,30086,4905,14533,3331,25181,418,204,214
38825,30089,4905,14533,3331,25184,418,204,214
38830,30094,4906,14537,3332,25188,418,204,214
38835,30098,4906,14539,3332,25192,418,204,214
38840,30101,4907,14542,3333,25194,418,204,214
38845,30102,4908,14543,3334,25194,418,204,214
38850,30107,4909,14545,3335,25198,418,204,214
38855,30109,4909,14547,3335,25200,418,204,214
38860,30117,4910,14552,3336,25207,418,204,214
38865,30120,4910,14552,3336,25210,418,204,214
38870,30125,4911,14552,3336,25214,418,204,214
38875,30129,4911,14555,3336,25217,418,204,214
38880,30132,4912,14556,3337,25220,418,204,214
38885,30133,4913,14557,3338,25220,418,204,214
38890,30138,4914,14558,3338,25224,418,204,214
38895,30140,4915,14559,3338,25225,418,204,214
38900,30148,4916,14563,3339,25232,418,204,214
38905,30151,4916,14564,3339,25235,418,204,214
38910,30156,4917,14565,3339,25239,419,204,215
38915,30160,4917,14567,3339,25243,419,204,215
38920,30163,4917,14567,3339,25246,419,204,215
38925,30164,4917,14567,3339,25247,419,204,215
38930,30169,4918,14569,3339,25251,419,204,215
38935,30171,4919,14570,3340,25252,419,204,215
38940,30179,4921,14574,3342,25258,419,204,215
38945,30182,4921,14577,3342,25261,419,204,215
38950,30187,4922,14579,3342,25265,419,204,215
38955,30191,4922,14582,3342,25269,419,204,215
38960,30194,4922,14583,3342,25272,419,204,215
38965,30195,4922,14583,3342,25273,419,204,215
38970,30200,4923,14586,3343,25277,419,204,215
38975,30202,4923,14587,3343,25279,419,204,215
38980,30210,4924,14591,3344,25286,419,204,215
38985,30213,4924,14592,3344,25289,419,204,215
38990,30218,4925,14593,3345,25293,419,204,215
38995,30222,4925,14594,3345,25297,419,204,215
39000,30225,4925,14595,3345,25300,419,204,215
39005,30226,4925,14595,3345,25301,419,204,215
39010,30231,4926,14598,3345,25305,419,204,215
39015,30233,4926,14599,3345,25307,419,204,215
39020,30241,4927,14604,3345,25314,419,204,215
39025,30244,4927,14605,3345,25317,419,204,215
39030,30249,4928,14606,3345,25321,420,204,216
39035,30253,4928,14609,3345,25324,420,204,216
39040,30256,4929,14611,3346,25327,420,204,216
39045,30257,4930,14612,3347,25327,420,204,216
39050,30262,4931,14615,3348,25330,420,204,216
39055,30264,4933,14616,3350,25331,420,204,216
39060,30272,4934,14617,3350,25338,420,204,216
39065,30275,4934,14620,3350,25341,420,204,216
39070,30280,4935,14620,3350,25345,420,204,216
39075,30284,4935,14622,3350,25349,420,204,216
39080,30287,4936,14624,3351,25351,420,204,216
39085,30288,4936,14625,3351,25352,420,204,216
39090,30293,4936,14628,3351,25356,420,204,216
39095,30295,4938,14629,3352,25357,420,204,216
39100,30303,4939,14631,3352,25364,420,204,216
39105,30306,4939,14632,3352,25367,420,204,216
39110,30311,4940,14634,3353,25371,420,204,216
39115,30315,4940,14636,3353,25375,420,204,216
39120,30318,4941,14637,3354,25377,420,204,216
39125,30319,4941,14638,3354,25378,420,204,216
39130,30324,4941,14641,3354,25382,420,204,216
39135,30326,4943,14642,3355,25383,420,204,216
39140,30334,4945,14647,3357,25389,420,204,216
39145,30337,4945,14649,3357,25392,420,204,216
39150,30342,4946,14650,3357,25396,421,204,217
39155,30346,4946,14652,3357,25400,421,204,217
39160,30349,4946,14652,3357,25403,421,204,217
39165,30350,4946,14653,3357,25404,421,204,217
39170,30355,4947,14656,3357,25407,421,204,217
39175,30357,4949,14657,3359,25408,421,204,217
39180,30365,4952,14662,3361,25413,421,204,217
39185,30368,4952,14662,3361,25416,421,204,217
39190,30373,4953,14664,3361,25420,421,204,217
39195,30377,4953,14666,3361,25424,421,204,217
39200,30380,4953,14667,3361,25427,421,204,217
39205,30381,4953,14667,3361,25428,421,204,217
39210,30386,4954,14670,3362,25432,421,204,217
39215,30388,4955,14671,3363,25433,421,204,217
39220,30396,4957,14676,3364,25439,421,204,217
39225,30399,4957,14676,3364,25442,421,204,217
39230,30404,4958,14679,3364,25446,421,204,217
39235,30408,4958,14682,3364,25449,421,204,217
39240,30411,4959,14684,3365,25452,421,204,217
39245,30412,4959,14684,3365,25453,421,204,217
39250,30417,4960,14687,3365,25456,421,204,217
39255,30419,4962,14688,3366,25457,421,204,217
39260,30427,4963,14693,3366,25464,421,204,217
39265,30430,4964,14695,3367,25466,421,204,217
39270,30435,4965,14698,3368,25470,421,204,217
39275,30439,4965,14699,3368,25474,421,204,217
39280,30442,4966,14700,3369,25476,421,204,217
39285,30443,4966,14700,3369,25477,421,204,217
39290,30448,4967,14702,3369,25481,421,204,217
39295,30450,4968,14703,3370,25482,421,204,217
39300,30458,4969,14707,3370,25489,421,204,217
39305,30461,4969,14707,3370,25492,421,204,217
39310,30466,4970,14707,3370,25496,421,204,217
39315,30470,4970,14709,3370,25500,421,204,217
39320,30473,4971,14711,3371,25502,421,204,217
39325,30474,4971,14711,3371,25503,421,204,217
39330,30479,4972,14715,3372,25507,421,204,217
39335,30481,4972,14715,3372,25509,421,204,217
39340,30489,4973,14720,3373,25516,421,204,217
39345,30492,4973,14722,3373,25519,421,204,217
39350,30497,4974,14724,3374,25523,421,204,217
39355,30501,4974,14727,3374,25526,421,204,217
39360,30504,4975,14728,3375,25529,421,204,217
39365,30505,4975,14728,3375,25530,421,204,217
39370,30510,4976,14730,3375,25534,421,204,217
39375,30512,4976,14730,3375,25536,421,204,217
39380,30520,4977,14733,3375,25543,421,204,217
39385,30523,4978,14735,3376,25545,421,204,217
39390,30528,4978,14740,3376,25550,421,204,217
39395,30532,4978,14741,3376,25554,421,204,217
39400,30535,4978,14743,3376,25557,421,204,217
39405,30536,4978,14744,3376,25558,421,204,217
39410,30541,4979,14744,3376,25562,421,204,217
39415,30543,4980,14746,3377,25563,421,204,217
39420,30551,4981,14748,3378,25570,421,204,217
39425,30554,4981,14749,3378,25573,421,204,217
39430,30559,4981,14752,3378,25578,421,204,217
39435,30563,4981,14754,3378,25582,421,204,217
39440,30566,4981,14756,3378,25585,421,204,217
39445,30567,4981,14756,3378,25586,421,204,217
39450,30572,4982,14761,3379,25589,421,204,217
39455,30574,4984,14763,3381,25590,421,204,217
39460,30582,4986,14768,3382,25596,421,204,217
39465,30585,4986,14771,3382,25599,421,204,217
39470,30590,4987,14774,3383,25603,421,204,217
39475,30594,4987,14777,3383,25606,421,204,217
39480,30597,4988,14779,3384,25609,421,204,217
39485,30598,4989,14780,3385,25609,421,204,217
39490,30603,4990,14784,3386,25612,421,204,217
39495,30605,4992,14785,3387,25613,421,204,217
39500,30613,4994,14789,3389,25619,421,204,217
39505,30616,4994,14790,3389,25622,421,204,217
39510,30621,4995,14792,3389,25626,422,204,218
39515,30625,4995,14795,3389,25629,422,204,218
39520,30628,4996,14796,3390,25632,422,204,218
39525,30629,4996,14796,3390,25633,422,204,218
39530,30634,4997,14800,3391,25636,422,204,218
39535,30636,4999,14801,3393,25637,422,204,218
39540,30644,5001,14805,3394,25643,422,204,218
39545,30647,5001,14806,3394,25646,422,204,218
39550,30652,5002,14808,3395,25650,422,204,218
39555,30656,5002,14812,3395,25654,422,204,218
39560,30659,5002,14812,3395,25657,422,204,218
39565,30660,5003,14813,3396,25657,422,204,218
39570,30665,5004,14817,3396,25660,422,204,218
39575,30667,5006,14818,3398,25661,422,204,218
39580,30675,5007,14823,3399,25668,422,204,218
39585,30678,5008,14825,3400,25670,422,204,218
39590,30683,5009,14828,3400,25674,422,204,218
39595,30687,5009,14831,3400,25678,422,204,218
39600,30690,5009,14832,3400,25681,422,204,218
39605,30691,5009,14832,3400,25682,422,204,218
39610,30696,5010,14835,3401,25686,422,204,218
39615,30698,5010,14836,3401,25688,422,204,218
39620,30706,5011,14840,3401,25695,422,204,218
39625,30709,5011,14842,3401,25698,422,204,218
39630,30714,5012,14843,3402,25702,422,204,218
39635,30718,5012,14843,3402,25706,422,204,218
39640,30721,5012,14844,3402,25709,422,204,218
39645,30722,5012,14844,3402,25710,422,204,218
39650,30727,5013,14846,3403,25714,422,204,218
39655,30729,5013,14847,3403,25716,422,204,218
39660,30737,5015,14850,3404,25722,422,204,218
39665,30740,5015,14850,3404,25725,422,204,218
39670,30745,5016,14851,3404,25729,422,204,218
39675,30749,5016,14852,3404,25732,422,204,218
39680,30752,5017,14854,3405,25735,422,204,218
39685,30753,5017,14854,3405,25736,422,204,218
39690,30758,5018,14857,3405,25740,422,204,218
39695,30760,5018,14859,3405,25742,422,204,218
39700,30768,5019,14866,3405,25749,422,204,218
39705,30771,5019,14868,3405,25752,422,204,218
39710,30776,5020,14869,3405,25756,422,204,218
39715,30780,5020,14870,3405,25760,422,204,218
39720,30783,5020,14872,3405,25763,422,204,218
39725,30784,5021,14873,3406,25763,422,204,218
39730,30789,5022,14876,3407,25767,422,204,218
39735,30791,5023,14878,3408,25768,422,204,218
39740,30799,5024,14882,3409,25775,422,204,218
39745,30802,5024,14884,3409,25778,422,204,218
39750,30807,5025,14887,3410,25782,422,204,218
39755,30811,5025,14888,3410,25785,422,204,218
39760,30814,5027,14889,3412,25787,422,204,218
39765,30815,5028,14890,3413,25787,422,204,218
39770,30820,5029,14893,3414,25791,422,204,218
39775,30822,5030,14894,3414,25792,422,204,218
39780,30830,5032,14898,3416,25798,422,204,218
39785,30833,5032,14898,3416,25801,422,204,218
39790,30838,5032,14902,3416,25806,422,204,218
39795,30842,5032,14903,3416,25810,422,204,218
39800,30845,5032,14905,3416,25813,422,204,218
39805,30846,5032,14906,3416,25814,422,204,218
39810,30851,5032,14907,3416,25819,422,204,218
39815,30853,5033,14908,3416,25820,422,204,218
39820,30861,5035,14911,3417,25826,422,204,218
39825,30864,5035,14913,3417,25829,422,204,218
39830,30869,5035,14916,3417,25834,422,204,218
39835,30873,5035,14917,3417,25838,422,204,218
39840,30876,5035,14918,3417,25841,422,204,218
39845,30877,5035,14918,3417,25842,422,204,218
39850,30882,5035,14921,3417,25846,422,204,218
39855,30884,5037,14922,3418,25847,422,204,218
39860,30892,5039,14924,3419,25853,422,204,218
39865,30895,5039,14926,3419,25856,422,204,218
39870,30900,5039,14928,3419,25861,423,204,219
39875,30904,5039,14931,3419,25865,423,204,219
39880,30907,5039,14933,3419,25868,423,204,219
39885,30908,5039,14933,3419,25869,423,204,219
39890,30913,5040,14935,3419,25872,423,204,219
39895,30915,5042,14937,3421,25873,423,204,219
39900,30923,5045,14942,3423,25878,423,204,219
39905,30926,5045,14942,3423,25881,423,204,219
39910,30931,5046,14946,3423,25885,423,204,219
39915,30935,5046,14949,3423,25889,423,204,219
39920,30938,5046,14951,3423,25892,423,204,219
39925,30939,5046,14951,3423,25893,423,204,219
39930,30944,5047,14954,3423,25896,423,204,219
39935,30946,5049,14954,3424,25897,423,204,219
39940,30954,5050,14956,3424,25904,423,204,219
39945,30957,5050,14958,3424,25907,423,204,219
39950,30962,5051,14961,3424,25911,423,204,219
39955,30966,5051,14962,3424,25915,423,204,219
39960,30969,5051,14962,3424,25918,423,204,219
39965,30970,5052,14963,3425,25918,423,204,219
39970,30975,5053,14966,3426,25922,423,204,219
39975,30977,5054,14968,3427,25923,423,204,219
39980,30985,5055,14971,3428,25930,423,204,219
39985,30988,5055,14974,3428,25933,423,204,219
39990,30993,5056,14978,3429,25937,423,204,219
39995,30997,5056,14981,3429,25941,423,204,219
40000,31000,5056,14983,3429,25944,423,204,219
40005,31001,5057,14984,3430,25944,423,204,219
40010,31006,5058,14986,3430,25947,423,204,219
40015,31008,5060,14988,3432,25948,423,204,219
40020,31016,5062,14993,3434,25954,423,204,219
40025,31019,5063,14996,3435,25956,423,204,219
40030,31024,5064,14997,3436,25960,423,204,219
40035,31028,5064,15000,3436,25963,423,204,219
40040,31031,5065,15001,3437,25966,423,204,219
40045,31032,5065,15001,3437,25967,423,204,219
40050,31037,5066,15003,3437,25971,423,204,219
40055,31039,5066,15003,3437,25973,423,204,219
40060,31047,5067,15007,3437,25980,423,204,219
40065,31050,5068,15007,3437,25982,423,204,219
40070,31055,5069,15010,3437,25986,423,204,219
40075,31059,5069,15012,3437,25990,423,204,219
40080,31062,5070,15013,3438,25992,423,204,219
40085,31063,5071,15014,3439,25992,423,204,219
40090,31068,5072,15018,3440,25996,423,204,219
40095,31070,5072,15019,3440,25998,423,204,219
40100,31078,5073,15020,3440,26005,423,204,219
40105,31081,5074,15022,3441,26007,423,204,219
40110,31086,5075,15024,3441,26011,424,205,219
40115,31090,5075,15026,3441,26014,424,205,219
40120,31093,5077,15028,3443,26016,424,205,219
40125,31094,5077,15028,3443,26017,424,205,219
40130,31099,5078,15029,3443,26021,424,205,219
40135,31101,5079,15030,3444,26022,424,205,219
40140,31109,5082,15034,3446,26027,424,205,219
40145,31112,5082,15036,3446,26030,424,205,219
40150,31117,5083,15038,3446,26034,424,205,219
40155,31121,5083,15040,3446,26038,424,205,219
40160,31124,5083,15041,3446,26041,424,205,219
40165,31125,5084,15042,3447,26041,424,205,219
40170,31130,5085,15045,3447,26044,424,205,219
40175,31132,5087,15046,3449,26045,424,205,219
40180,31140,5089,15048,3449,26051,424,205,219
40185,31143,5089,15049,3449,26054,424,205,219
40190,31148,5090,15051,3449,26058,424,205,219
40195,31152,5090,15053,3449,26062,424,205,219
40200,31155,5090,15055,3449,26065,424,205,219
40205,31156,5091,15056,3450,26065,424,205,219
40210,31161,5092,15058,3450,26069,424,205,219
40215,31163,5093,15058,3450,26070,424,205,219
40220,31171,5095,15060,3450,26076,424,205,219
40225,31174,5095,15060,3450,26079,424,205,219
40230,31179,5096,15062,3450,26083,424,205,219
40235,31183,5096,15064,3450,26087,424,205,219
40240,31186,5096,15064,3450,26090,424,205,219
40245,31187,5096,15064,3450,26091,424,205,219
40250,31192,5097,15066,3450,26094,424,205,219
40255,31194,5099,15068,3452,26095,424,205,219
40260,31202,5101,15071,3453,26101,424,205,219
40265,31205,5102,15071,3453,26103,424,205,219
40270,31210,5103,15073,3453,26107,424,205,219
40275,31214,5103,15073,3453,26111,424,205,219
40280,31217,5103,15073,3453,26114,424,205,219
40285,31218,5103,15074,3453,26115,424,205,219
40290,31223,5103,15074,3453,26120,424,205,219
40295,31225,5104,15075,3454,26121,424,205,219
40300,31233,5105,15079,3454,26128,424,205,219
40305,31236,5106,15079,3454,26130,424,205,219
40310,31241,5107,15083,3455,26134,424,205,219
40315,31245,5107,15086,3455,26137,424,205,219
40320,31248,5108,15088,3456,26140,424,205,219
40325,31249,5108,15089,3456,26141,424,205,219
40330,31254,5108,15092,3456,26146,424,205,219
40335,31256,5108,15092,3456,26148,424,205,219
40340,31264,5109,15098,3456,26155,424,205,219
40345,31267,5109,15100,3456,26158,424,205,219
40350,31272,5110,15101,3456,26162,424,205,219
40355,31276,5110,15104,3456,26165,424,205,219
40360,31279,5112,15106,3458,26167,424,205,219
40365,31280,5112,15107,3458,26168,424,205,219
40370,31285,5113,15110,3458,26172,424,205,219
40375,31287,5113,15112,3458,26174,424,205,219
40380,31295,5116,15117,3459,26179,424,205,219
40385,31298,5117,15118,3460,26181,424,205,219
40390,31303,5117,15120,3460,26186,424,205,219
40395,31307,5117,15121,3460,26190,424,205,219
40400,31310,5117,15124,3460,26193,424,205,219
40405,31311,5117,15124,3460,26194,424,205,219
40410,31316,5118,15126,3460,26198,424,205,219
40415,31318,5118,15126,3460,26200,424,205,219
40420,31326,5119,15131,3460,26207,424,205,219
40425,31329,5120,15132,3461,26209,424,205,219
40430,31334,5120,15135,3461,26214,424,205,219
40435,31338,5120,15136,3461,26218,424,205,219
40440,31341,5121,15138,3462,26220,424,205,219
40445,31342,5121,15139,3462,26221,424,205,219
40450,31347,5122,15139,3462,26225,424,205,219
40455,31349,5123,15140,3462,26226,424,205,219
40460,31357,5124,15145,3463,26233,424,205,219
40465,31360,5124,15147,3463,26236,424,205,219
40470,31365,5124,15149,3463,26241,424,205,219
40475,31369,5124,15151,3463,26245,424,205,219
40480,31372,5124,15152,3463,26248,424,205,219
40485,31373,5124,15152,3463,26249,424,205,219
40490,31378,5125,15155,3464,26253,424,205,219
40495,31380,5126,15155,3464,26254,424,205,219
40500,31388,5128,15157,3464,26260,424,205,219
40505,31391,5128,15158,3464,26263,424,205,219
40510,31396,5129,15163,3465,26267,424,205,219
40515,31400,5129,15165,3465,26271,424,205,219
40520,31403,5130,15167,3466,26273,424,205,219
40525,31404,5130,15167,3466,26274,424,205,219
40530,31409,5131,15170,3467,26278,424,205,219
40535,31411,5132,15170,3467,26279,424,205,219
40540,31419,5134,15173,3467,26285,424,205,219
40545,31422,5134,15173,3467,26288,424,205,219
40550,31427,5135,15175,3467,26292,424,205,219
40555,31431,5135,15176,3467,26296,424,205,219
40560,31434,5135,15178,3467,26299,424,205,219
40565,31435,5135,15178,3467,26300,424,205,219
40570,31440,5136,15181,3468,26303,424,205,219
40575,31442,5138,15183,3470,26304,424,205,219
40580,31450,5140,15186,3471,26310,424,205,219
40585,31453,5141,15187,3471,26312,424,205,219
40590,31458,5142,15188,3471,26316,425,206,219
40595,31462,5142,15191,3471,26320,425,206,219
40600,31465,5143,15194,3472,26322,425,206,219
40605,31466,5144,15195,3473,26322,425,206,219
40610,31471,5145,15200,3474,26325,425,206,219
40615,31473,5147,15202,3476,26326,425,206,219
40620,31481,5150,15206,3478,26331,425,206,219
40625,31484,5151,15206,3478,26333,425,206,219
40630,31489,5152,15207,3478,26337,425,206,219
40635,31493,5152,15209,3478,26341,425,206,219
40640,31496,5152,15210,3478,26344,425,206,219
40645,31497,5152,15210,3478,26345,425,206,219
40650,31502,5153,15215,3479,26349,425,206,219
40655,31504,5153,15216,3479,26351,425,206,219
40660,31512,5154,15218,3479,26358,425,206,219
40665,31515,5155,15220,3480,26360,425,206,219
40670,31520,5156,15221,3481,26364,425,206,219
40675,31524,5156,15224,3481,26367,425,206,219
40680,31527,5158,15225,3483,26369,425,206,219
40685,31528,5159,15226,3484,26369,425,206,219
40690,31533,5160,15228,3484,26373,425,206,219
40695,31535,5160,15229,3484,26375,425,206,219
40700,31543,5161,15232,3484,26382,425,206,219
40705,31546,5162,15232,3484,26384,425,206,219
40710,31551,5163,15235,3484,26388,425,206,219
40715,31555,5163,15238,3484,26391,425,206,219
40720,31558,5164,15238,3485,26394,425,206,219
40725,31559,5164,15238,3485,26395,425,206,219
40730,31564,5165,15240,3485,26399,425,206,219
40735,31566,5166,15241,3485,26400,425,206,219
40740,31574,5167,15244,3486,26407,425,206,219
40745,31577,5167,15245,3486,26410,425,206,219
40750,31582,5168,15248,3487,26414,425,206,219
40755,31586,5168,15248,3487,26418,425,206,219
40760,31589,5169,15250,3488,26420,425,206,219
40765,31590,5169,15250,3488,26421,425,206,219
40770,31595,5170,15254,3489,26424,425,206,219
40775,31597,5172,15256,3491,26425,425,206,219
40780,31605,5173,15262,3492,26432,425,206,219
40785,31608,5173,15264,3492,26435,425,206,219
40790,31613,5174,15266,3493,26439,425,206,219
40795,31617,5174,15268,3493,26443,425,206,219
40800,31620,5175,15269,3494,26445,425,206,219
40805,31621,5175,15269,3494,26446,425,206,219
40810,31626,5176,15271,3494,26450,425,206,219
40815,31628,5177,15272,3495,26451,425,206,219
40820,31636,5179,15274,3496,26457,425,206,219
40825,31639,5179,15274,3496,26460,425,206,219
40830,31644,5180,15277,3497,26464,425,206,219
40835,31648,5180,15278,3497,26468,425,206,219
40840,31651,5180,15279,3497,26471,425,206,219
40845,31652,5180,15279,3497,26472,425,206,219
40850,31657,5181,15281,3497,26476,425,206,219
40855,31659,5182,15283,3498,26477,425,206,219
40860,31667,5184,15287,3500,26483,425,206,219
40865,31670,5185,15289,3501,26485,425,206,219
40870,31675,5186,15292,3502,26489,426,207,219
40875,31679,5186,15294,3502,26492,426,207,219
40880,31682,5187,15296,3503,26495,426,207,219
40885,31683,5187,15296,3503,26496,426,207,219
40890,31688,5188,15296,3503,26500,426,207,219
40895,31690,5189,15297,3503,26501,426,207,219
40900,31698,5191,15300,3504,26507,426,207,219
40905,31701,5192,15301,3505,26509,426,207,219
40910,31706,5193,15303,3505,26513,427,207,220
40915,31710,5193,15306,3505,26516,427,207,220
40920,31713,5195,15309,3507,26518,427,207,220
40925,31714,5195,15309,3507,26519,427,207,220
40930,31719,5196,15313,3508,26522,427,207,220
40935,31721,5198,15315,3510,26523,427,207,220
40940,31729,5199,15320,3511,26530,427,207,220
40945,31732,5199,15322,3511,26533,427,207,220
40950,31737,5200,15324,3512,26537,427,207,220
40955,31741,5200,15326,3512,26541,427,207,220
40960,31744,5201,15329,3513,26543,427,207,220
40965,31745,5202,15330,3514,26543,427,207,220
40970,31750,5203,15333,3514,26546,427,207,220
40975,31752,5205,15333,3515,26547,427,207,220
40980,31760,5206,15336,3516,26554,427,207,220
40985,31763,5206,15337,3516,26557,427,207,220
40990,31768,5207,15341,3517,26561,427,207,220
40995,31772,5207,15343,3517,26565,427,207,220
41000,31775,5207,15345,3517,26568,427,207,220
41005,31776,5208,15346,3518,26568,427,207,220
41010,31781,5209,15349,3519,26571,427,207,220
41015,31783,5211,15350,3520,26572,427,207,220
41020,31791,5212,15351,3521,26579,427,207,220
41025,31794,5212,15352,3521,26582,427,207,220
41030,31799,5213,15353,3521,26586,428,208,220
41035,31803,5213,15355,3521,26590,428,208,220
41040,31806,5213,15356,3521,26593,428,208,220
41045,31807,5213,15356,3521,26594,428,208,220
41050,31812,5214,15358,3521,26598,428,208,220
41055,31814,5214,15359,3521,26600,428,208,220
41060,31822,5216,15363,3521,26606,428,208,220
41065,31825,5217,15364,3521,26608,428,208,220
41070,31830,5218,15368,3522,26612,428,208,220
41075,31834,5218,15370,3522,26616,428,208,220
41080,31837,5218,15372,3522,26619,428,208,220
41085,31838,5218,15372,3522,26620,428,208,220
41090,31843,5219,15374,3523,26624,428,208,220
41095,31845,5219,15375,3523,26626,428,208,220
41100,31853,5221,15380,3524,26632,428,208,220
41105,31856,5222,15380,3524,26634,428,208,220
41110,31861,5223,15381,3524,26638,428,208,220
41115,31865,5223,15382,3524,26642,428,208,220
41120,31868,5223,15383,3524,26645,428,208,220
41125,31869,5223,15383,3524,26646,428,208,220
41130,31874,5224,15387,3525,26650,428,208,220
41135,31876,5224,15389,3525,26652,428,208,220
41140,31884,5226,15391,3526,26658,428,208,220
41145,31887,5227,15392,3526,26660,428,208,220
41150,31892,5228,15395,3526,26664,429,209,220
41155,31896,5228,15398,3526,26667,429,209,220
41160,31899,5229,15399,3527,26670,429,209,220
41165,31900,5230,15400,3528,26670,429,209,220
41170,31905,5231,15403,3528,26673,429,209,220
41175,31907,5233,15405,3530,26674,429,209,220
41180,31915,5234,15409,3531,26681,429,209,220
41185,31918,5234,15410,3531,26684,429,209,220
41190,31923,5234,15412,3531,26689,429,209,220
41195,31927,5234,15415,3531,26693,429,209,220
41200,31930,5234,15416,3531,26696,429,209,220
41205,31931,5234,15416,3531,26697,429,209,220
41210,31936,5235,15418,3532,26701,429,209,220
41215,31938,5236,15419,3532,26702,429,209,220
41220,31946,5237,15424,3533,26709,429,209,220
41225,31949,5237,15427,3533,26712,429,209,220
41230,31954,5237,15429,3533,26717,429,209,220
41235,31958,5237,15431,3533,26721,429,209,220
41240,31961,5237,15433,3533,26724,429,209,220
41245,31962,5237,15433,3533,26725,429,209,220
41250,31967,5238,15434,3533,26729,429,209,220
41255,31969,5239,15436,3534,26730,429,209,220
41260,31977,5240,15442,3535,26737,429,209,220
41265,31980,5240,15444,3535,26740,429,209,220
41270,31985,5241,15445,3536,26744,430,209,221
41275,31989,5241,15447,3536,26747,430,209,221
41280,31992,5242,15448,3537,26750,430,209,221
41285,31993,5243,15449,3538,26750,430,209,221
41290,31998,5244,15452,3539,26754,430,209,221
41295,32000,5244,15453,3539,26756,430,209,221
41300,32008,5246,15457,3541,26762,430,209,221
41305,32011,5247,15458,3541,26764,430,209,221
41310,32016,5248,15458,3541,26768,430,209,221
41315,32020,5248,15461,3541,26772,430,209,221
41320,32023,5248,15462,3541,26775,430,209,221
41325,32024,5248,15462,3541,26776,430,209,221
41330,32029,5249,15465,3541,26780,430,209,221
41335,32031,5249,15466,3541,26782,430,209,221
41340,32039,5250,15471,3542,26789,430,209,221
41345,32042,5251,15472,3543,26791,430,209,221
41350,32047,5252,15475,3543,26795,430,209,221
41355,32051,5252,15476,3543,26799,430,209,221
41360,32054,5252,15478,3543,26802,430,209,221
41365,32055,5253,15479,3544,26802,430,209,221
41370,32060,5254,15481,3544,26806,430,209,221
41375,32062,5254,15483,3544,26808,430,209,221
41380,32070,5255,15489,3544,26815,430,209,221
41385,32073,5256,15491,3544,26817,430,209,221
41390,32078,5257,15494,3544,26821,431,210,221
41395,32082,5257,15495,3544,26825,431,210,221
41400,32085,5257,15496,3544,26828,431,210,221
41405,32086,5258,15497,3545,26828,431,210,221
41410,32091,5259,15500,3546,26832,431,210,221
41415,32093,5260,15500,3546,26833,431,210,221
41420,32101,5262,15504,3547,26839,431,210,221
41425,32104,5262,15505,3547,26842,431,210,221
41430,32109,5263,15508,3548,26846,431,210,221
41435,32113,5263,15511,3548,26849,431,210,221
41440,32116,5264,15511,3549,26852,431,210,221
41445,32117,5264,15511,3549,26853,431,210,221
41450,32122,5265,15512,3549,26857,431,210,221
41455,32124,5266,15512,3549,26858,431,210,221
41460,32132,5268,15515,3551,26864,431,210,221
41465,32135,5268,15517,3551,26867,431,210,221
41470,32140,5269,15519,3551,26871,431,210,221
41475,32144,5269,15522,3551,26874,431,210,221
41480,32147,5270,15525,3552,26877,431,210,221
41485,32148,5271,15526,3553,26877,431,210,221
41490,32153,5272,15529,3554,26881,431,210,221
41495,32155,5273,15529,3554,26882,431,210,221
41500,32163,5274,15533,3554,26889,431,210,221
41505,32166,5274,15533,3554,26892,431,210,221
41510,32171,5275,15535,3554,26896,431,210,221
41515,32175,5275,15538,3554,26900,431,210,221
41520,32178,5275,15538,3554,26903,431,210,221
41525,32179,5276,15539,3555,26903,431,210,221
41530,32184,5277,15541,3556,26907,431,210,221
41535,32186,5278,15542,3557,26908,431,210,221
41540,32194,5280,15545,3557,26914,431,210,221
41545,32197,5281,15547,3557,26916,431,210,221
41550,32202,5281,15549,3557,26921,431,210,221
41555,32206,5281,15551,3557,26925,431,210,221
41560,32209,5281,15553,3557,26928,431,210,221
41565,32210,5281,15553,3557,26929,431,210,221
41570,32215,5282,15556,3558,26932,431,210,221
41575,32217,5284,15556,3559,26933,431,210,221
41580,32225,5287,15561,3562,26938,431,210,221
41585,32228,5287,15561,3562,26941,431,210,221
41590,32233,5287,15563,3562,26946,431,210,221
41595,32237,5287,15565,3562,26950,431,210,221
41600,32240,5287,15566,3562,26953,431,210,221
41605,32241,5288,15567,3563,26953,431,210,221
41610,32246,5289,15570,3564,26957,431,210,221
41615,32248,5289,15572,3564,26959,431,210,221
41620,32256,5291,15576,3566,26965,431,210,221
41625,32259,5291,15578,3566,26968,431,210,221
41630,32264,5292,15582,3567,26972,432,210,222
41635,32268,5292,15585,3567,26975,432,210,222
41640,32271,5293,15586,3568,26978,432,210,222
41645,32272,5293,15586,3568,26979,432,210,222
41650,32277,5294,15589,3568,26982,432,210,222
41655,32279,5296,15591,3570,26983,432,210,222
41660,32287,5297,15596,3571,26990,432,210,222
41665,32290,5298,15596,3571,26992,432,210,222
41670,32295,5299,15599,3571,26996,432,210,222
41675,32299,5299,15600,3571,27000,432,210,222
41680,32302,5300,15603,3572,27002,432,210,222
41685,32303,5300,15603,3572,27003,432,210,222
41690,32308,5301,15605,3573,27006,432,210,222
41695,32310,5303,15605,3574,27007,432,210,222
41700,32318,5305,15609,3575,27013,432,210,222
41705,32321,5306,15609,3575,27015,432,210,222
41710,32326,5307,15611,3576,27019,432,210,222
41715,32330,5307,15613,3576,27023,432,210,222
41720,32333,5307,15614,3576,27026,432,210,222
41725,32334,5307,15614,3576,27027,432,210,222
41730,32339,5307,15616,3576,27032,432,210,222
41735,32341,5307,15617,3576,27034,432,210,222
41740,32349,5308,15620,3577,27041,432,210,222
41745,32352,5309,15622,3577,27043,432,210,222
41750,32357,5310,15623,3577,27047,433,210,223
41755,32361,5310,15625,3577,27051,433,210,223
41760,32364,5310,15626,3577,27054,433,210,223
41765,32365,5310,15626,3577,27055,433,210,223
41770,32370,5310,15629,3577,27060,433,210,223
41775,32372,5310,15630,3577,27062,433,210,223
41780,32380,5312,15633,3578,27068,433,210,223
41785,32383,5312,15634,3578,27071,433,210,223
41790,32388,5313,15636,3579,27075,434,210,224
41795,32392,5313,15639,3579,27078,434,210,224
41800,32395,5314,15641,3580,27081,434,210,224
41805,32396,5314,15642,3580,27082,434,210,224
41810,32401,5315,15645,3580,27085,434,210,224
41815,32403,5317,15646,3581,27086,434,210,224
41820,32411,5320,15652,3583,27091,434,210,224
41825,32414,5321,15653,3583,27093,434,210,224
41830,32419,5321,15657,3583,27098,434,210,224
41835,32423,5321,15660,3583,27102,434,210,224
41840,32426,5322,15661,3584,27104,434,210,224
41845,32427,5323,15662,3585,27104,434,210,224
41850,32432,5324,15664,3585,27108,434,210,224
41855,32434,5325,15665,3585,27109,434,210,224
41860,32442,5328,15668,3587,27114,434,210,224
41865,32445,5329,15670,3588,27116,434,210,224
41870,32450,5329,15673,3588,27121,434,210,224
41875,32454,5329,15675,3588,27125,434,210,224
41880,32457,5330,15677,3589,27127,434,210,224
41885,32458,5330,15677,3589,27128,434,210,224
41890,32463,5331,15680,3589,27132,434,210,224
41895,32465,5332,15681,3589,27133,434,210,224
41900,32473,5334,15687,3590,27139,434,210,224
41905,32476,5335,15689,3590,27141,434,210,224
41910,32481,5335,15692,3590,27146,435,210,225
41915,32485,5335,15693,3590,27150,435,210,225
41920,32488,5335,15695,3590,27153,435,210,225
41925,32489,5335,15695,3590,27154,435,210,225
41930,32494,5336,15699,3591,27157,435,210,225
41935,32496,5338,15701,3593,27158,435,210,225
41940,32504,5340,15705,3594,27164,435,210,225
41945,32507,5340,15707,3594,27167,435,210,225
41950,32512,5341,15711,3595,27171,436,210,226
41955,32516,5341,15714,3595,27174,436,210,226
41960,32519,5342,15716,3596,27177,436,210,226
41965,32520,5342,15716,3596,27178,436,210,226
41970,32525,5343,15719,3596,27182,436,210,226
41975,32527,5343,15721,3596,27184,436,210,226
41980,32535,5346,15727,3599,27189,436,210,226
41985,32538,5346,15728,3599,27192,436,210,226
41990,32543,5347,15731,3600,27196,437,211,226
41995,32547,5347,15733,3600,27199,437,211,226
42000,32550,5349,15736,3602,27201,437,211,226
42005,32551,5349,15736,3602,27202,437,211,226
42010,32556,5350,15740,3603,27206,437,211,226
42015,32558,5350,15741,3603,27208,437,211,226
42020,32566,5351,15744,3603,27215,437,211,226
42025,32569,5351,15745,3603,27218,437,211,226
42030,32574,5351,15746,3603,27223,437,211,226
42035,32578,5351,15746,3603,27227,437,211,226
42040,32581,5351,15746,3603,27230,437,211,226
42045,32582,5351,15746,3603,27231,437,211,226
42050,32587,5352,15747,3603,27235,437,211,226
42055,32589,5353,15747,3603,27236,437,211,226
42060,32597,5354,15751,3604,27243,437,211,226
42065,32600,5354,15753,3604,27246,437,211,226
42070,32605,5354,15755,3604,27251,437,211,226
42075,32609,5354,15756,3604,27255,437,211,226
42080,32612,5354,15757,3604,27258,437,211,226
42085,32613,5354,15757,3604,27259,437,211,226
42090,32618,5355,15760,3604,27263,437,211,226
42095,32620,5356,15760,3604,27264,437,211,226
42100,32628,5357,15764,3605,27271,437,211,226
42105,32631,5357,15766,3605,27274,437,211,226
42110,32636,5358,15767,3605,27278,437,211,226
42115,32640,5358,15770,3605,27282,437,211,226
42120,32643,5358,15771,3605,27285,437,211,226
42125,32644,5358,15772,3605,27286,437,211,226
42130,32649,5358,15774,3605,27290,437,211,226
42135,32651,5360,15774,3606,27291,437,211,226
42140,32659,5361,15777,3606,27298,437,211,226
42145,32662,5361,15779,3606,27301,437,211,226
42150,32667,5362,15781,3607,27305,437,211,226
42155,32671,5362,15782,3607,27309,437,211,226
42160,32674,5363,15784,3608,27311,437,211,226
42165,32675,5363,15785,3608,27312,437,211,226
42170,32680,5363,15787,3608,27316,437,211,226
42175,32682,5365,15787,3609,27317,437,211,226
42180,32690,5367,15791,3610,27323,437,211,226
42185,32693,5368,15792,3611,27325,437,211,226
42190,32698,5369,15794,3611,27329,437,211,226
42195,32702,5369,15794,3611,27333,437,211,226
42200,32705,5369,15795,3611,27336,437,211,226
42205,32706,5369,15796,3611,27337,437,211,226
42210,32711,5369,15797,3611,27341,437,211,226
42215,32713,5371,15797,3612,27342,437,211,226
42220,32721,5372,15802,3613,27349,437,211,226
42225,32724,5373,15804,3614,27351,437,211,226
42230,32729,5374,15809,3615,27355,437,211,226
42235,32733,5374,15811,3615,27359,437,211,226
42240,32736,5374,15811,3615,27362,437,211,226
42245,32737,5375,15812,3616,27362,437,211,226
42250,32742,5376,15812,3616,27366,437,211,226
42255,32744,5377,15813,3617,27367,437,211,226
42260,32752,5378,15816,3618,27374,437,211,226
42265,32755,5378,15817,3618,27377,437,211,226
42270,32760,5379,15820,3618,27381,437,211,226
42275,32764,5379,15824,3618,27384,437,211,226
42280,32767,5380,15824,3619,27387,437,211,226
42285,32768,5381,15825,3620,27387,437,211,226
42290,32773,5382,15827,3621,27391,437,211,226
42295,32775,5383,15829,3622,27392,437,211,226
42300,32783,5385,15832,3623,27398,437,211,226
42305,32786,5386,15834,3624,27400,437,211,226
42310,32791,5387,15836,3624,27404,438,211,227
42315,32795,5387,15839,3624,27407,438,211,227
42320,32798,5388,15840,3625,27410,438,211,227
42325,32799,5389,15841,3626,27410,438,211,227
42330,32804,5390,15845,3626,27413,438,211,227
42335,32806,5392,15845,3627,27414,438,211,227
42340,32814,5394,15850,3629,27420,438,211,227
42345,32817,5395,15852,3630,27422,438,211,227
42350,32822,5396,15853,3630,27426,439,212,227
42355,32826,5396,15856,3630,27429,439,212,227
42360,32829,5398,15858,3632,27431,439,212,227
42365,32830,5398,15859,3632,27432,439,212,227
42370,32835,5398,15863,3632,27437,439,212,227
42375,32837,5398,15864,3632,27439,439,212,227
42380,32845,5399,15867,3633,27446,439,212,227
42385,32848,5399,15868,3633,27449,439,212,227
42390,32853,5400,15871,3633,27453,439,212,227
42395,32857,5400,15872,3633,27456,439,212,227
42400,32860,5401,15873,3634,27459,439,212,227
42405,32861,5401,15874,3634,27460,439,212,227
42410,32866,5401,15876,3634,27465,439,212,227
42415,32868,5401,15877,3634,27467,439,212,227
42420,32876,5402,15882,3634,27474,439,212,227
42425,32879,5402,15883,3634,27477,439,212,227
42430,32884,5403,15886,3634,27481,439,212,227
42435,32888,5403,15887,3634,27485,439,212,227
42440,32891,5403,15890,3634,27488,439,212,227
42445,32892,5404,15891,3635,27488,439,212,227
42450,32897,5405,15892,3636,27492,439,212,227
42455,32899,5405,15892,3636,27494,439,212,227
42460,32907,5407,15896,3638,27500,439,212,227
42465,32910,5407,15897,3638,27503,439,212,227
42470,32915,5408,15897,3638,27507,440,212,228
42475,32919,5408,15900,3638,27511,440,212,228
42480,32922,5409,15901,3639,27513,440,212,228
42485,32923,5409,15901,3639,27514,440,212,228
42490,32928,5410,15902,3639,27518,440,212,228
42495,32930,5411,15904,3640,27519,440,212,228
42500,32938,5412,15909,3641,27526,440,212,228
42505,32941,5412,15909,3641,27529,440,212,228
42510,32946,5412,15913,3641,27534,441,213,228
42515,32950,5412,15916,3641,27538,441,213,228
42520,32953,5412,15918,3641,27541,441,213,228
42525,32954,5413,15919,3642,27541,441,213,228
42530,32959,5414,15922,3642,27544,441,213,228
42535,32961,5416,15922,3643,27545,441,213,228
42540,32969,5417,15925,3644,27552,441,213,228
42545,32972,5417,15928,3644,27555,441,213,228
42550,32977,5417,15932,3644,27560,442,214,228
42555,32981,5417,15936,3644,27564,442,214,228
42560,32984,5417,15938,3644,27567,442,214,228
42565,32985,5417,15938,3644,27568,442,214,228
42570,32990,5418,15940,3644,27571,442,214,228
42575,32992,5420,15942,3646,27572,442,214,228
42580,33000,5421,15945,3646,27579,442,214,228
42585,33003,5421,15947,3646,27582,442,214,228
42590,33008,5422,15949,3647,27586,443,214,229
42595,33012,5422,15949,3647,27590,443,214,229
42600,33015,5422,15949,3647,27593,443,214,229
42605,33016,5423,15950,3648,27593,443,214,229
42610,33021,5424,15951,3648,27597,443,214,229
42615,33023,5424,15951,3648,27599,443,214,229
42620,33031,5425,15955,3648,27606,443,214,229
42625,33034,5426,15957,3649,27608,443,214,229
42630,33039,5427,15959,3649,27612,443,214,229
42635,33043,5427,15960,3649,27615,443,214,229
42640,33046,5428,15963,3650,27618,443,214,229
42645,33047,5428,15963,3650,27619,443,214,229
42650,33052,5429,15966,3651,27623,443,214,229
42655,33054,5429,15968,3651,27625,443,214,229
42660,33062,5430,15973,3652,27632,443,214,229
42665,33065,5430,15974,3652,27635,443,214,229
42670,33070,5431,15977,3653,27639,443,214,229
42675,33074,5431,15979,3653,27643,443,214,229
42680,33077,5431,15980,3653,27646,443,214,229
42685,33078,5431,15980,3653,27647,443,214,229
42690,33083,5432,15983,3653,27651,443,214,229
42695,33085,5432,15983,3653,27653,443,214,229
42700,33093,5433,15987,3653,27660,443,214,229
42705,33096,5434,15989,3654,27662,443,214,229
42710,33101,5435,15991,3655,27666,444,214,230
42715,33105,5435,15994,3655,27669,444,214,230
42720,33108,5436,15995,3656,27672,444,214,230
42725,33109,5437,15996,3657,27672,444,214,230
42730,33114,5438,15999,3658,27676,444,214,230
42735,33116,5439,16000,3659,27677,444,214,230
42740,33124,5441,16003,3660,27683,444,214,230
42745,33127,5441,16004,3660,27686,444,214,230
42750,33132,5442,16007,3660,27690,444,214,230
42755,33136,5442,16008,3660,27694,444,214,230
42760,33139,5442,16010,3660,27697,444,214,230
42765,33140,5443,16011,3661,27697,444,214,230
42770,33145,5444,16015,3662,27701,444,214,230
42775,33147,5445,16015,3662,27702,444,214,230
42780,33155,5446,16017,3663,27709,444,214,230
42785,33158,5446,16018,3663,27712,444,214,230
42790,33163,5447,16020,3663,27716,444,214,230
42795,33167,5447,16022,3663,27720,444,214,230
42800,33170,5448,16024,3664,27722,444,214,230
42805,33171,5449,16025,3665,27722,444,214,230
42810,33176,5450,16026,3665,27725,444,214,230
42815,33178,5452,16026,3666,27726,444,214,230
42820,33186,5454,16028,3667,27732,444,214,230
42825,33189,5454,16030,3667,27735,444,214,230
42830,33194,5455,16033,3668,27739,445,214,231
42835,33198,5455,16036,3668,27742,445,214,231
42840,33201,5457,16038,3670,27744,445,214,231
42845,33202,5458,16039,3671,27744,445,214,231
42850,33207,5459,16041,3672,27748,445,214,231
42855,33209,5460,16041,3672,27749,445,214,231
42860,33217,5461,16045,3672,27756,445,214,231
42865,33220,5462,16047,3673,27758,445,214,231
42870,33225,5462,16049,3673,27763,445,214,231
42875,33229,5462,16050,3673,27767,445,214,231
42880,33232,5462,16052,3673,27770,445,214,231
42885,33233,5463,16053,3674,27770,445,214,231
42890,33238,5464,16056,3675,27774,445,214,231
42895,33240,5465,16057,3676,27775,445,214,231
42900,33248,5467,16061,3678,27781,445,214,231
42905,33251,5467,16062,3678,27784,445,214,231
42910,33256,5467,16063,3678,27789,445,214,231
42915,33260,5467,16063,3678,27793,445,214,231
42920,33263,5467,16064,3678,27796,445,214,231
42925,33264,5467,16065,3678,27797,445,214,231
42930,33269,5467,16066,3678,27802,445,214,231
42935,33271,5468,16067,3679,27803,445,214,231
42940,33279,5469,16073,3680,27810,445,214,231
42945,33282,5469,16075,3680,27813,445,214,231
42950,33287,5470,16078,3680,27817,446,214,232
42955,33291,5470,16080,3680,27820,446,214,232
42960,33294,5471,16081,3681,27823,446,214,232
42965,33295,5471,16081,3681,27824,446,214,232
42970,33300,5471,16085,3681,27829,446,214,232
42975,33302,5472,16085,3681,27830,446,214,232
42980,33310,5474,16090,3683,27836,446,214,232
42985,33313,5474,16091,3683,27839,446,214,232
42990,33318,5475,16094,3684,27843,447,215,232
42995,33322,5475,16096,3684,27846,447,215,232
43000,33325,5477,16097,3686,27848,447,215,232
43005,33326,5477,16097,3686,27849,447,215,232
43010,33331,5478,16100,3687,27853,447,215,232
43015,33333,5479,16101,3688,27854,447,215,232
43020,33341,5480,16103,3689,27861,447,215,232
43025,33344,5481,16105,3690,27863,447,215,232
43030,33349,5481,16110,3690,27868,447,215,232
43035,33353,5481,16112,3690,27872,447,215,232
43040,33356,5481,16114,3690,27875,447,215,232
43045,33357,5481,16114,3690,27876,447,215,232
43050,33362,5482,16115,3690,27880,447,215,232
43055,33364,5482,16117,3690,27882,447,215,232
43060,33372,5483,16119,3691,27889,447,215,232
43065,33375,5483,16120,3691,27892,447,215,232
43070,33380,5483,16123,3691,27897,447,215,232
43075,33384,5483,16127,3691,27900,447,215,232
43080,33387,5484,16128,3692,27903,447,215,232
43085,33388,5485,16129,3693,27903,447,215,232
43090,33393,5486,16131,3693,27907,447,215,232
43095,33395,5486,16133,3693,27909,447,215,232
43100,33403,5487,16136,3693,27916,447,215,232
43105,33406,5488,16139,3694,27918,447,215,232
43110,33411,5488,16143,3694,27923,447,215,232
43115,33415,5488,16145,3694,27926,447,215,232
43120,33418,5489,16147,3695,27929,447,215,232
43125,33419,5489,16147,3695,27930,447,215,232
43130,33424,5490,16149,3696,27934,447,215,232
43135,33426,5491,16151,3697,27935,447,215,232
43140,33434,5492,16155,3698,27942,447,215,232
43145,33437,5492,16156,3698,27945,447,215,232
43150,33442,5493,16158,3698,27949,447,215,232
43155,33446,5493,16161,3698,27953,447,215,232
43160,33449,5493,16163,3698,27956,447,215,232
43165,33450,5493,16164,3698,27957,447,215,232
43170,33455,5493,16167,3698,27961,447,215,232
43175,33457,5495,16168,3699,27962,447,215,232
43180,33465,5496,16175,3699,27969,447,215,232
43185,33468,5497,16178,3700,27971,447,215,232
43190,33473,5498,16182,3701,27975,447,215,232
43195,33477,5498,16184,3701,27979,447,215,232
43200,33480,5498,16186,3701,27982,447,215,232
43205,33481,5498,16186,3701,27983,447,215,232
43210,33486,5498,16190,3701,27987,447,215,232
43215,33488,5500,16191,3703,27988,447,215,232
43220,33496,5501,16195,3704,27995,447,215,232
43225,33499,5501,16195,3704,27998,447,215,232
43230,33504,5502,16198,3704,28002,447,215,232
43235,33508,5502,16200,3704,28006,447,215,232
43240,33511,5502,16201,3704,28009,447,215,232
43245,33512,5502,16202,3704,28010,447,215,232
43250,33517,5503,16205,3705,28013,447,215,232
43255,33519,5505,16207,3707,28014,447,215,232
43260,33527,5507,16212,3709,28020,447,215,232
43265,33530,5507,16214,3709,28023,447,215,232
43270,33535,5508,16218,3710,28027,447,215,232
43275,33539,5508,16218,3710,28031,447,215,232
43280,33542,5509,16221,3711,28033,447,215,232
43285,33543,5509,16221,3711,28034,447,215,232
43290,33548,5510,16223,3711,28037,447,215,232
43295,33550,5512,16223,3712,28038,447,215,232
43300,33558,5513,16224,3712,28045,447,215,232
43305,33561,5513,16224,3712,28048,447,215,232
43310,33566,5514,16228,3713,28052,447,215,232
43315,33570,5514,16230,3713,28056,447,215,232
43320,33573,5515,16233,3714,28058,447,215,232
43325,33574,5516,16234,3715,28058,447,215,232
43330,33579,5517,16235,3715,28062,447,215,232
43335,33581,5517,16236,3715,28064,447,215,232
43340,33589,5518,16240,3715,28071,447,215,232
43345,33592,5518,16240,3715,28074,447,215,232
43350,33597,5519,16245,3716,28078,447,215,232
43355,33601,5519,16249,3716,28082,447,215,232
43360,33604,5519,16250,3716,28085,447,215,232
43365,33605,5519,16250,3716,28086,447,215,232
43370,33610,5520,16253,3717,28090,447,215,232
43375,33612,5520,16254,3717,28092,447,215,232
43380,33620,5521,16257,3718,28099,447,215,232
43385,33623,5521,16258,3718,28102,447,215,232
43390,33628,5522,16261,3719,28106,448,215,233
43395,33632,5522,16262,3719,28110,448,215,233
43400,33635,5522,16264,3719,28113,448,215,233
43405,33636,5522,16264,3719,28114,448,215,233
43410,33641,5523,16266,3720,28118,448,215,233
43415,33643,5523,16267,3720,28120,448,215,233
43420,33651,5525,16271,3722,28126,448,215,233
43425,33654,5525,16273,3722,28129,448,215,233
43430,33659,5526,16277,3723,28133,449,216,233
43435,33663,5526,16278,3723,28137,449,216,233
43440,33666,5526,16280,3723,28140,449,216,233
43445,33667,5526,16280,3723,28141,449,216,233
43450,33672,5527,16282,3723,28144,449,216,233
43455,33674,5529,16283,3724,28145,449,216,233
43460,33682,5531,16287,3725,28151,449,216,233
43465,33685,5531,16289,3725,28154,449,216,233
43470,33690,5532,16293,3726,28158,449,216,233
43475,33694,5532,16294,3726,28162,449,216,233
43480,33697,5533,16297,3727,28164,449,216,233
43485,33698,5533,16297,3727,28165,449,216,233
43490,33703,5534,16299,3728,28169,449,216,233
43495,33705,5535,16299,3728,28170,449,216,233
43500,33713,5538,16304,3730,28175,449,216,233
43505,33716,5539,16305,3731,28177,449,216,233
43510,33721,5540,16308,3732,28181,449,216,233
43515,33725,5540,16308,3732,28185,449,216,233
43520,33728,5540,16309,3732,28188,449,216,233
43525,33729,5541,16310,3733,28188,449,216,233
43530,33734,5542,16313,3734,28191,449,216,233
43535,33736,5544,16314,3736,28192,449,216,233
43540,33744,5545,16319,3736,28199,449,216,233
43545,33747,5546,16321,3737,28201,449,216,233
43550,33752,5547,16322,3737,28205,449,216,233
43555,33756,5547,16323,3737,28209,449,216,233
43560,33759,5547,16326,3737,28212,449,216,233
43565,33760,5547,16326,3737,28213,449,216,233
43570,33765,5548,16328,3737,28216,449,216,233
43575,33767,5550,16329,3739,28217,449,216,233
43580,33775,5551,16335,3739,28224,449,216,233
43585,33778,5551,16336,3739,28227,449,216,233
43590,33783,5552,16336,3739,28231,449,216,233
43595,33787,5552,16338,3739,28235,449,216,233
43600,33790,5552,16339,3739,28238,449,216,233
43605,33791,5552,16339,3739,28239,449,216,233
43610,33796,5553,16341,3739,28243,449,216,233
43615,33798,5554,16342,3739,28244,449,216,233
43620,33806,5557,16348,3742,28249,449,216,233
43625,33809,5557,16350,3742,28252,449,216,233
43630,33814,5558,16352,3742,28256,449,216,233
43635,33818,5558,16355,3742,28260,449,216,233
43640,33821,5559,16358,3743,28262,449,216,233
43645,33822,5559,16358,3743,28263,449,216,233
43650,33827,5560,16358,3743,28267,449,216,233
43655,33829,5560,16358,3743,28269,449,216,233
43660,33837,5562,16364,3745,28275,449,216,233
43665,33840,5562,16366,3745,28278,449,216,233
43670,33845,5563,16370,3745,28282,449,216,233
43675,33849,5563,16371,3745,28286,449,216,233
43680,33852,5564,16374,3746,28288,449,216,233
43685,33853,5564,16374,3746,28289,449,216,233
43690,33858,5565,16376,3747,28293,449,216,233
43695,33860,5565,16378,3747,28295,449,216,233
43700,33868,5566,16383,3748,28302,449,216,233
43705,33871,5566,16384,3748,28305,449,216,233
43710,33876,5567,16387,3749,28309,449,216,233
43715,33880,5567,16388,3749,28312,449,216,233
43720,33883,5568,16389,3750,28315,449,216,233
43725,33884,5569,16390,3751,28315,449,216,233
43730,33889,5570,16391,3751,28319,449,216,233
43735,33891,5571,16391,3751,28320,449,216,233
43740,33899,5573,16396,3753,28326,449,216,233
43745,33902,5573,16397,3753,28329,449,216,233
43750,33907,5573,16398,3753,28334,449,216,233
43755,33911,5573,16401,3753,28338,449,216,233
43760,33914,5573,16402,3753,28341,449,216,233
43765,33915,5573,16403,3753,28342,449,216,233
43770,33920,5573,16406,3753,28347,449,216,233
43775,33922,5574,16407,3754,28348,449,216,233
43780,33930,5575,16411,3754,28355,449,216,233
43785,33933,5575,16413,3754,28358,449,216,233
43790,33938,5575,16416,3754,28363,449,216,233
43795,33942,5575,16417,3754,28367,449,216,233
43800,33945,5575,16419,3754,28370,449,216,233
43805,33946,5575,16419,3754,28371,449,216,233
43810,33951,5575,16422,3754,28375,449,216,233
43815,33953,5577,16423,3755,28376,449,216,233
43820,33961,5578,16429,3755,28383,449,216,233
43825,33964,5578,16430,3755,28386,449,216,233
43830,33969,5578,16433,3755,28391,449,216,233
43835,33973,5578,16434,3755,28395,449,216,233
43840,33976,5578,16434,3755,28398,449,216,233
43845,33977,5578,16435,3755,28399,449,216,233
43850,33982,5579,16437,3755,28402,449,216,233
43855,33984,5581,16438,3757,28403,449,216,233
43860,33992,5582,16442,3757,28410,449,216,233
43865,33995,5582,16444,3757,28413,449,216,233
43870,34000,5583,16447,3758,28417,450,217,233
43875,34004,5583,16448,3758,28421,450,217,233
43880,34007,5584,16450,3759,28423,450,217,233
43885,34008,5584,16450,3759,28424,450,217,233
43890,34013,5585,16454,3759,28428,450,217,233
43895,34015,5585,16455,3759,28430,450,217,233
43900,34023,5586,16457,3760,28437,450,217,233
43905,34026,5586,16457,3760,28440,450,217,233
43910,34031,5587,16459,3760,28444,451,217,234
43915,34035,5587,16460,3760,28448,451,217,234
43920,34038,5587,16461,3760,28451,451,217,234
43925,34039,5587,16462,3760,28452,451,217,234
43930,34044,5588,16464,3761,28456,451,217,234
43935,34046,5588,16464,3761,28458,451,217,234
43940,34054,5589,16468,3761,28465,451,217,234
43945,34057,5590,16470,3762,28467,451,217,234
43950,34062,5591,16472,3762,28471,452,218,234
43955,34066,5591,16475,3762,28475,452,218,234
43960,34069,5591,16477,3762,28478,452,218,234
43965,34070,5591,16478,3762,28479,452,218,234
43970,34075,5592,16479,3763,28483,452,218,234
43975,34077,5593,16479,3763,28484,452,218,234
43980,34085,5595,16482,3764,28490,452,218,234
43985,34088,5595,16484,3764,28493,452,218,234
43990,34093,5596,16484,3764,28497,452,218,234
43995,34097,5596,16487,3764,28500,452,218,234
44000,34100,5597,16490,3765,28503,452,218,234
44005,34101,5598,16491,3766,28503,452,218,234
44010,34106,5599,16494,3767,28507,452,218,234
44015,34108,5600,16496,3768,28508,452,218,234
44020,34116,5601,16499,3769,28515,452,218,234
44025,34119,5601,16501,3769,28518,452,218,234
44030,34124,5602,16502,3770,28522,452,218,234
44035,34128,5602,16503,3770,28526,452,218,234
44040,34131,5602,16506,3770,28529,452,218,234
44045,34132,5603,16507,3771,28529,452,218,234
44050,34137,5604,16511,3772,28532,452,218,234
44055,34139,5606,16513,3774,28533,452,218,234
44060,34147,5607,16518,3774,28540,452,218,234
44065,34150,5607,16520,3774,28543,452,218,234
44070,34155,5608,16524,3775,28547,452,218,234
44075,34159,5608,16525,3775,28551,452,218,234
44080,34162,5608,16527,3775,28554,452,218,234
44085,34163,5608,16527,3775,28555,452,218,234
44090,34168,5609,16529,3775,28559,452,218,234
44095,34170,5610,16530,3775,28560,452,218,234
44100,34178,5612,16535,3777,28566,452,218,234
44105,34181,5613,16537,3778,28568,452,218,234
44110,34186,5614,16540,3778,28572,452,218,234
44115,34190,5614,16543,3778,28576,452,218,234
44120,34193,5614,16544,3778,28579,452,218,234
44125,34194,5614,16544,3778,28580,452,218,234
44130,34199,5615,16547,3779,28584,452,218,234
44135,34201,5615,16548,3779,28586,452,218,234
44140,34209,5616,16551,3779,28593,452,218,234
44145,34212,5616,16551,3779,28596,452,218,234
44150,34217,5617,16555,3780,28600,452,218,234
44155,34221,5617,16559,3780,28604,452,218,234
44160,34224,5618,16560,3781,28606,452,218,234
44165,34225,5618,16560,3781,28607,452,218,234
44170,34230,5619,16564,3782,28611,452,218,234
44175,34232,5619,16564,3782,28613,452,218,234
44180,34240,5620,16570,3783,28620,452,218,234
44185,34243,5621,16571,3784,28622,452,218,234
44190,34248,5622,16574,3784,28626,452,218,234
44195,34252,5622,16576,3784,28630,452,218,234
44200,34255,5622,16578,3784,28633,452,218,234
44205,34256,5622,16578,3784,28634,452,218,234
44210,34261,5623,16581,3784,28637,452,218,234
44215,34263,5625,16582,3785,28638,452,218,234
44220,34271,5628,16588,3788,28643,452,218,234
44225,34274,5628,16589,3788,28646,452,218,234
44230,34279,5629,16591,3788,28650,452,218,234
44235,34283,5629,16593,3788,28653,452,218,234
44240,34286,5630,16594,3789,28656,452,218,234
44245,34287,5631,16595,3790,28656,452,218,234
44250,34292,5632,16596,3790,28659,452,218,234
44255,34294,5634,16596,3791,28660,452,218,234
44260,34302,5635,16601,3791,28667,452,218,234
44265,34305,5635,16604,3791,28670,452,218,234
44270,34310,5636,16605,3791,28674,452,218,234
44275,34314,5636,16606,3791,28677,452,218,234
44280,34317,5637,16606,3792,28680,452,218,234
44285,34318,5638,16607,3793,28680,452,218,234
44290,34323,5639,16608,3793,28684,452,218,234
44295,34325,5640,16609,3793,28685,452,218,234
44300,34333,5641,16613,3793,28692,452,218,234
44305,34336,5641,16614,3793,28695,452,218,234
44310,34341,5642,16617,3794,28699,453,219,234
44315,34345,5642,16621,3794,28703,453,219,234
44320,34348,5642,16623,3794,28706,453,219,234
44325,34349,5642,16623,3794,28707,453,219,234
44330,34354,5643,16626,3795,28710,453,219,234
44335,34356,5645,16626,3796,28711,453,219,234
44340,34364,5647,16629,3797,28717,453,219,234
44345,34367,5648,16631,3798,28719,453,219,234
44350,34372,5649,16632,3798,28723,453,219,234
44355,34376,5649,16635,3798,28727,453,219,234
44360,34379,5649,16636,3798,28730,453,219,234
44365,34380,5649,16636,3798,28731,453,219,234
44370,34385,5650,16640,3799,28735,453,219,234
44375,34387,5650,16642,3799,28737,453,219,234
44380,34395,5651,16645,3799,28744,453,219,234
44385,34398,5652,16648,3800,28746,453,219,234
44390,34403,5653,16648,3800,28750,453,219,234
44395,34407,5653,16648,3800,28754,453,219,234
44400,34410,5654,16650,3801,28756,453,219,234
44405,34411,5655,16651,3802,28756,453,219,234
44410,34416,5656,16655,3803,28760,453,219,234
44415,34418,5656,16656,3803,28762,453,219,234
44420,34426,5657,16660,3804,28769,453,219,234
44425,34429,5658,16662,3805,28771,453,219,234
44430,34434,5658,16665,3805,28776,453,219,234
44435,34438,5658,16668,3805,28780,453,219,234
44440,34441,5658,16670,3805,28783,453,219,234
44445,34442,5659,16671,3806,28783,453,219,234
44450,34447,5660,16671,3806,28787,453,219,234
44455,34449,5661,16672,3807,28788,453,219,234
44460,34457,5663,16677,3809,28794,453,219,234
44465,34460,5663,16679,3809,28797,453,219,234
44470,34465,5664,16682,3809,28801,454,219,235
44475,34469,5664,16683,3809,28805,454,219,235
44480,34472,5664,16684,3809,28808,454,219,235
44485,34473,5664,16685,3809,28809,454,219,235
44490,34478,5664,16689,3809,28813,454,219,235
44495,34480,5666,16691,3811,28814,454,219,235
44500,34488,5668,16695,3812,28820,454,219,235
44505,34491,5668,16697,3812,28823,454,219,235
44510,34496,5669,16700,3812,28827,455,220,235
44515,34500,5669,16701,3812,28831,455,220,235
44520,34503,5669,16701,3812,28834,455,220,235
44525,34504,5669,16701,3812,28835,455,220,235
44530,34509,5670,16705,3813,28838,455,220,235
44535,34511,5672,16705,3814,28839,455,220,235
44540,34519,5674,16710,3815,28845,455,220,235
44545,34522,5674,16711,3815,28848,455,220,235
44550,34527,5675,16713,3816,28852,455,220,235
44555,34531,5675,16714,3816,28855,455,220,235
44560,34534,5677,16717,3818,28857,455,220,235
44565,34535,5678,16718,3819,28857,455,220,235
44570,34540,5679,16721,3820,28860,455,220,235
44575,34542,5681,16722,3822,28861,455,220,235
44580,34550,5683,16726,3823,28867,455,220,235
44585,34553,5683,16727,3823,28870,455,220,235
44590,34558,5684,16728,3823,28874,455,220,235
44595,34562,5684,16730,3823,28878,455,220,235
44600,34565,5684,16732,3823,28881,455,220,235
44605,34566,5684,16732,3823,28882,455,220,235
44610,34571,5685,16733,3823,28886,455,220,235
44615,34573,5686,16734,3823,28887,455,220,235
44620,34581,5688,16738,3824,28893,455,220,235
44625,34584,5689,16739,3825,28895,455,220,235
44630,34589,5690,16743,3825,28899,456,221,235
44635,34593,5690,16744,3825,28903,456,221,235
44640,34596,5690,16745,3825,28906,456,221,235
44645,34597,5690,16745,3825,28907,456,221,235
44650,34602,5691,16746,3825,28911,456,221,235
44655,34604,5692,16747,3826,28912,456,221,235
44660,34612,5693,16750,3827,28919,456,221,235
44665,34615,5693,16751,3827,28922,456,221,235
44670,34620,5694,16754,3827,28926,456,221,235
44675,34624,5694,16756,3827,28930,456,221,235
44680,34627,5694,16758,3827,28933,456,221,235
44685,34628,5694,16758,3827,28934,456,221,235
44690,34633,5695,16760,3827,28938,456,221,235
44695,34635,5696,16761,3828,28939,456,221,235
44700,34643,5698,16765,3829,28945,456,221,235
44705,34646,5698,16767,3829,28948,456,221,235
44710,34651,5699,16771,3830,28952,456,221,235
44715,34655,5699,16773,3830,28955,456,221,235
44720,34658,5701,16775,3832,28957,456,221,235
44725,34659,5702,16776,3833,28957,456,221,235
44730,34664,5703,16778,3834,28961,456,221,235
44735,34666,5704,16779,3834,28962,456,221,235
44740,34674,5705,16784,3835,28969,456,221,235
44745,34677,5705,16784,3835,28972,456,221,235
44750,34682,5706,16786,3835,28976,457,222,235
44755,34686,5706,16788,3835,28979,457,222,235
44760,34689,5707,16790,3836,28982,457,222,235
44765,34690,5707,16790,3836,28983,457,222,235
44770,34695,5708,16792,3836,28987,457,222,235
44775,34697,5709,16792,3836,28988,457,222,235
44780,34705,5711,16797,3836,28994,457,222,235
44785,34708,5712,16798,3836,28996,457,222,235
44790,34713,5712,16801,3836,29001,457,222,235
44795,34717,5712,16802,3836,29005,457,222,235
44800,34720,5712,16803,3836,29008,457,222,235
44805,34721,5712,16803,3836,29009,457,222,235
44810,34726,5713,16805,3837,29013,457,222,235
44815,34728,5714,16806,3837,29014,457,222,235
44820,34736,5717,16811,3840,29019,457,222,235
44825,34739,5717,16812,3840,29022,457,222,235
44830,34744,5717,16813,3840,29027,457,222,235
44835,34748,5717,16816,3840,29030,457,222,235
44840,34751,5718,16817,3841,29033,457,222,235
44845,34752,5718,16817,3841,29034,457,222,235
44850,34757,5719,16819,3842,29038,457,222,235
44855,34759,5720,16819,3842,29039,457,222,235
44860,34767,5722,16823,3842,29045,457,222,235
44865,34770,5722,16823,3842,29048,457,222,235
44870,34775,5722,16828,3842,29053,458,223,235
44875,34779,5722,16830,3842,29057,458,223,235
44880,34782,5722,16830,3842,29060,458,223,235
44885,34783,5722,16830,3842,29061,458,223,235
44890,34788,5723,16832,3843,29064,458,223,235
44895,34790,5725,16833,3845,29065,458,223,235
44900,34798,5726,16836,3846,29072,458,223,235
44905,34801,5727,16838,3846,29074,458,223,235
44910,34806,5728,16839,3846,29078,459,223,236
44915,34810,5728,16841,3846,29082,459,223,236
44920,34813,5729,16844,3847,29084,459,223,236
44925,34814,5729,16845,3847,29085,459,223,236
44930,34819,5730,16849,3848,29088,459,223,236
44935,34821,5732,16851,3850,29089,459,223,236
44940,34829,5733,16853,3850,29096,459,223,236
44945,34832,5733,16856,3850,29099,459,223,236
44950,34837,5734,16859,3851,29103,459,223,236
44955,34841,5734,16862,3851,29107,459,223,236
44960,34844,5734,16864,3851,29110,459,223,236
44965,34845,5735,16865,3852,29110,459,223,236
44970,34850,5736,16866,3852,29114,459,223,236
44975,34852,5736,16867,3852,29116,459,223,236
44980,34860,5737,16872,3853,29123,459,223,236
44985,34863,5737,16874,3853,29126,459,223,236
44990,34868,5738,16876,3853,29130,459,223,236
44995,34872,5738,16877,3853,29134,459,223,236
45000,34875,5738,16878,3853,29137,459,223,236
45005,34876,5738,16878,3853,29138,459,223,236
45010,34881,5739,16879,3853,29142,459,223,236
45015,34883,5739,16879,3853,29144,459,223,236
45020,34891,5741,16882,3854,29150,459,223,236
45025,34894,5741,16883,3854,29153,459,223,236
45030,34899,5742,16885,3855,29157,459,223,236
45035,34903,5742,16888,3855,29161,459,223,236
45040,34906,5742,16889,3855,29164,459,223,236
45045,34907,5743,16890,3856,29164,459,223,236
45050,34912,5744,16893,3857,29167,459,223,236
45055,34914,5746,16893,3858,29168,459,223,236
45060,34922,5748,16896,3859,29174,459,223,236
45065,34925,5749,16897,3859,29176,459,223,236
45070,34930,5750,16900,3860,29180,460,224,236
45075,34934,5750,16903,3860,29183,460,224,236
45080,34937,5751,16904,3861,29186,460,224,236
45085,34938,5751,16904,3861,29187,460,224,236
45090,34943,5752,16908,3862,29190,460,224,236
45095,34945,5754,16908,3863,29191,460,224,236
45100,34953,5756,16911,3863,29197,460,224,236
45105,34956,5757,16913,3864,29199,460,224,236
45110,34961,5758,16916,3864,29203,461,225,236
45115,34965,5758,16917,3864,29207,461,225,236
45120,34968,5759,16918,3865,29209,461,225,236
45125,34969,5760,16919,3866,29209,461,225,236
45130,34974,5761,16920,3866,29213,461,225,236
45135,34976,5761,16920,3866,29215,461,225,236
45140,34984,5763,16923,3867,29221,461,225,236
45145,34987,5763,16925,3867,29224,461,225,236
45150,34992,5764,16929,3868,29228,462,226,236
45155,34996,5764,16930,3868,29231,462,226,236
45160,34999,5765,16931,3869,29234,462,226,236
45165,35000,5765,16931,3869,29235,462,226,236
45170,35005,5766,16934,3870,29239,462,226,236
45175,35007,5766,16936,3870,29241,462,226,236
45180,35015,5768,16939,3870,29247,462,226,236
45185,35018,5769,16939,3870,29249,462,226,236
45190,35023,5770,16943,3871,29253,462,226,236
45195,35027,5770,16945,3871,29257,462,226,236
45200,35030,5770,16946,3871,29260,462,226,236
45205,35031,5770,16946,3871,29261,462,226,236
45210,35036,5770,16950,3871,29266,462,226,236
45215,35038,5770,16951,3871,29268,462,226,236
45220,35046,5771,16953,3872,29275,462,226,236
45225,35049,5772,16954,3872,29277,462,226,236
45230,35054,5773,16955,3872,29281,462,226,236
45235,35058,5773,16957,3872,29285,462,226,236
45240,35061,5774,16959,3873,29287,462,226,236
45245,35062,5774,16959,3873,29288,462,226,236
45250,35067,5774,16962,3873,29292,462,226,236
45255,35069,5776,16964,3875,29293,462,226,236
45260,35077,5777,16972,3876,29300,462,226,236
45265,35080,5777,16974,3876,29303,462,226,236
45270,35085,5778,16977,3876,29307,462,226,236
45275,35089,5778,16978,3876,29311,462,226,236
45280,35092,5778,16978,3876,29314,462,226,236
45285,35093,5778,16979,3876,29315,462,226,236
45290,35098,5779,16983,3877,29318,462,226,236
45295,35100,5781,16984,3879,29319,462,226,236
45300,35108,5784,16987,3881,29324,462,226,236
45305,35111,5784,16987,3881,29327,462,226,236
45310,35116,5784,16989,3881,29332,462,226,236
45315,35120,5784,16990,3881,29336,462,226,236
45320,35123,5784,16991,3881,29339,462,226,236
45325,35124,5785,16992,3882,29339,462,226,236
45330,35129,5786,16994,3882,29343,462,226,236
45335,35131,5787,16994,3882,29344,462,226,236
45340,35139,5789,16998,3883,29350,462,226,236
45345,35142,5789,17001,3883,29353,462,226,236
45350,35147,5789,17003,3883,29358,462,226,236
45355,35151,5789,17005,3883,29361,462,226,236
45360,35154,5790,17006,3884,29364,462,226,236
45365,35155,5790,17006,3884,29365,462,226,236
45370,35160,5791,17011,3885,29368,462,226,236
45375,35162,5793,17013,3887,29369,462,226,236
45380,35170,5795,17017,3888,29375,462,226,236
45385,35173,5796,17019,3889,29377,462,226,236
45390,35178,5796,17021,3889,29382,462,226,236
45395,35182,5796,17024,3889,29385,462,226,236
45400,35185,5797,17025,3890,29388,462,226,236
45405,35186,5797,17026,3890,29389,462,226,236
45410,35191,5798,17027,3890,29393,462,226,236
45415,35193,5799,17028,3891,29394,462,226,236
45420,35201,5802,17035,3894,29399,462,226,236
45425,35204,5802,17037,3894,29402,462,226,236
45430,35209,5803,17038,3894,29406,463,226,237
45435,35213,5803,17040,3894,29409,463,226,237
45440,35216,5804,17040,3895,29412,463,226,237
45445,35217,5804,17041,3895,29413,463,226,237
45450,35222,5805,17042,3895,29417,463,226,237
45455,35224,5805,17043,3895,29419,463,226,237
45460,35232,5806,17047,3895,29426,463,226,237
45465,35235,5806,17048,3895,29429,463,226,237
45470,35240,5807,17051,3896,29433,464,226,238
45475,35244,5807,17053,3896,29436,464,226,238
45480,35247,5808,17055,3897,29439,464,226,238
45485,35248,5809,17056,3898,29439,464,226,238
45490,35253,5810,17060,3898,29443,464,226,238
45495,35255,5810,17060,3898,29445,464,226,238
45500,35263,5811,17062,3899,29452,464,226,238
45505,35266,5811,17064,3899,29455,464,226,238
45510,35271,5812,17068,3900,29459,464,226,238
45515,35275,5812,17068,3900,29463,464,226,238
45520,35278,5813,17069,3901,29465,464,226,238
45525,35279,5813,17069,3901,29466,464,226,238
45530,35284,5814,17070,3901,29470,464,226,238
45535,35286,5815,17072,3902,29471,464,226,238
45540,35294,5817,17076,3903,29477,464,226,238
45545,35297,5817,17076,3903,29480,464,226,238
45550,35302,5818,17078,3903,29484,464,226,238
45555,35306,5818,17080,3903,29488,464,226,238
45560,35309,5818,17082,3903,29491,464,226,238
45565,35310,5818,17082,3903,29492,464,226,238
45570,35315,5818,17085,3903,29497,464,226,238
45575,35317,5819,17087,3904,29498,464,226,238
45580,35325,5820,17091,3905,29505,464,226,238
45585,35328,5820,17091,3905,29508,464,226,238
45590,35333,5821,17093,3906,29512,465,226,239
45595,35337,5821,17095,3906,29516,465,226,239
45600,35340,5821,17097,3906,29519,465,226,239
45605,35341,5822,17098,3907,29519,465,226,239
45610,35346,5823,17098,3907,29523,465,226,239
45615,35348,5824,17098,3907,29524,465,226,239
45620,35356,5825,17099,3907,29531,465,226,239
45625,35359,5825,17100,3907,29534,465,226,239
45630,35364,5826,17104,3908,29538,466,227,239
45635,35368,5826,17108,3908,29541,466,227,239
45640,35371,5827,17110,3909,29544,466,227,239
45645,35372,5828,17111,3910,29544,466,227,239
45650,35377,5829,17113,3910,29547,466,227,239
45655,35379,5831,17114,3911,29548,466,227,239
45660,35387,5834,17117,3912,29553,466,227,239
45665,35390,5835,17118,3913,29555,466,227,239
45670,35395,5836,17122,3913,29559,466,227,239
45675,35399,5836,17124,3913,29563,466,227,239
45680,35402,5837,17126,3914,29565,466,227,239
45685,35403,5837,17127,3914,29566,466,227,239
45690,35408,5837,17130,3914,29571,466,227,239
45695,35410,5837,17131,3914,29573,466,227,239
45700,35418,5838,17134,3914,29580,466,227,239
45705,35421,5839,17137,3915,29582,466,227,239
45710,35426,5840,17139,3915,29586,466,227,239
45715,35430,5840,17140,3915,29590,466,227,239
45720,35433,5841,17141,3916,29592,466,227,239
45725,35434,5841,17141,3916,29593,466,227,239
45730,35439,5841,17144,3916,29598,466,227,239
45735,35441,5841,17145,3916,29600,466,227,239
45740,35449,5842,17148,3916,29607,466,227,239
45745,35452,5843,17148,3916,29609,466,227,239
45750,35457,5844,17152,3917,29613,466,227,239
45755,35461,5844,17153,3917,29616,466,227,239
45760,35464,5845,17154,3918,29619,466,227,239
45765,35465,5845,17154,3918,29620,466,227,239
45770,35470,5846,17157,3919,29623,466,227,239
45775,35472,5848,17159,3921,29624,466,227,239
45780,35480,5851,17164,3923,29629,466,227,239
45785,35483,5851,17165,3923,29632,466,227,239
45790,35488,5852,17167,3924,29636,466,227,239
45795,35492,5852,17168,3924,29640,466,227,239
45800,35495,5852,17169,3924,29643,466,227,239
45805,35496,5853,17170,3925,29643,466,227,239
45810,35501,5854,17175,3926,29646,466,227,239
45815,35503,5856,17177,3928,29647,466,227,239
45820,35511,5858,17182,3929,29653,466,227,239
45825,35514,5858,17183,3929,29656,466,227,239
45830,35519,5859,17185,3929,29660,466,227,239
45835,35523,5859,17187,3929,29663,466,227,239
45840,35526,5860,17187,3930,29666,466,227,239
45845,35527,5860,17187,3930,29667,466,227,239
45850,35532,5861,17191,3931,29670,466,227,239
45855,35534,5863,17192,3933,29671,466,227,239
45860,35542,5864,17195,3934,29678,466,227,239
45865,35545,5864,17196,3934,29681,466,227,239
45870,35550,5865,17199,3934,29685,466,227,239
45875,35554,5865,17201,3934,29689,466,227,239
45880,35557,5865,17202,3934,29692,466,227,239
45885,35558,5865,17202,3934,29693,466,227,239
45890,35563,5866,17206,3935,29696,466,227,239
45895,35565,5868,17207,3937,29697,466,227,239
45900,35573,5870,17211,3938,29703,466,227,239
45905,35576,5871,17211,3938,29705,466,227,239
45910,35581,5872,17213,3939,29709,466,227,239
45915,35585,5872,17216,3939,29713,466,227,239
45920,35588,5872,17217,3939,29716,466,227,239
45925,35589,5872,17217,3939,29717,466,227,239
45930,35594,5872,17221,3939,29722,466,227,239
45935,35596,5873,17223,3940,29723,466,227,239
45940,35604,5874,17227,3941,29730,466,227,239
45945,35607,5875,17229,3941,29732,466,227,239
45950,35612,5876,17230,3941,29736,466,227,239
45955,35616,5876,17233,3941,29740,466,227,239
45960,35619,5877,17235,3942,29742,466,227,239
45965,35620,5877,17236,3942,29743,466,227,239
45970,35625,5877,17238,3942,29748,466,227,239
45975,35627,5877,17238,3942,29750,466,227,239
45980,35635,5879,17240,3942,29756,466,227,239
45985,35638,5879,17242,3942,29759,466,227,239
45990,35643,5880,17244,3943,29763,467,227,240
45995,35647,5880,17246,3943,29767,467,227,240
46000,35650,5880,17247,3943,29770,467,227,240
46005,35651,5880,17247,3943,29771,467,227,240
46010,35656,5881,17249,3943,29775,467,227,240
46015,35658,5881,17250,3943,29777,467,227,240
46020,35666,5884,17256,3946,29782,467,227,240
46025,35669,5884,17257,3946,29785,467,227,240
46030,35674,5884,17259,3946,29790,467,227,240
46035,35678,5884,17262,3946,29793,467,227,240
46040,35681,5885,17262,3947,29796,467,227,240
46045,35682,5885,17262,3947,29797,467,227,240
46050,35687,5886,17264,3947,29801,467,227,240
46055,35689,5886,17264,3947,29803,467,227,240
46060,35697,5888,17270,3948,29809,467,227,240
46065,35700,5888,17270,3948,29812,467,227,240
46070,35705,5888,17271,3948,29817,467,227,240
46075,35709,5888,17274,3948,29820,467,227,240
46080,35712,5889,17274,3949,29823,467,227,240
46085,35713,5889,17275,3949,29824,467,227,240
46090,35718,5890,17278,3950,29827,467,227,240
46095,35720,5892,17278,3951,29828,467,227,240
46100,35728,5894,17282,3952,29834,467,227,240
46105,35731,5895,17283,3953,29836,467,227,240
46110,35736,5895,17286,3953,29841,468,227,241
46115,35740,5895,17288,3953,29845,468,227,241
46120,35743,5895,17291,3953,29848,468,227,241
46125,35744,5895,17292,3953,29849,468,227,241
46130,35749,5896,17296,3953,29852,468,227,241
46135,35751,5898,17296,3954,29853,468,227,241
46140,35759,5901,17301,3956,29858,468,227,241
46145,35762,5902,17302,3956,29860,468,227,241
46150,35767,5903,17303,3957,29864,468,227,241
46155,35771,5903,17304,3957,29868,468,227,241
46160,35774,5904,17305,3958,29870,468,227,241
46165,35775,5904,17306,3958,29871,468,227,241
46170,35780,5904,17311,3958,29875,468,227,241
46175,35782,5906,17312,3960,29876,468,227,241
46180,35790,5908,17317,3961,29882,468,227,241
46185,35793,5909,17319,3961,29884,468,227,241
46190,35798,5910,17323,3962,29888,468,227,241
46195,35802,5910,17326,3962,29892,468,227,241
46200,35805,5910,17326,3962,29895,468,227,241
46205,35806,5910,17326,3962,29896,468,227,241
46210,35811,5910,17326,3962,29901,468,227,241
46215,35813,5910,17327,3962,29903,468,227,241
46220,35821,5911,17330,3962,29910,468,227,241
46225,35824,5911,17331,3962,29913,468,227,241
46230,35829,5912,17335,3963,29917,469,228,241
46235,35833,5912,17336,3963,29921,469,228,241
46240,35836,5912,17339,3963,29924,469,228,241
46245,35837,5912,17339,3963,29925,469,228,241
46250,35842,5913,17341,3963,29929,469,228,241
46255,35844,5913,17341,3963,29931,469,228,241
46260,35852,5915,17346,3964,29937,469,228,241
46265,35855,5916,17347,3964,29939,469,228,241
46270,35860,5917,17350,3965,29943,469,228,241
46275,35864,5917,17352,3965,29947,469,228,241
46280,35867,5917,17354,3965,29950,469,228,241
46285,35868,5918,17355,3966,29950,469,228,241
46290,35873,5919,17358,3967,29954,469,228,241
46295,35875,5919,17360,3967,29956,469,228,241
46300,35883,5921,17363,3968,29962,469,228,241
46305,35886,5922,17365,3968,29964,469,228,241
46310,35891,5923,17369,3969,29968,469,228,241
46315,35895,5923,17370,3969,29971,469,228,241
46320,35898,5924,17372,3970,29974,469,228,241
46325,35899,5925,17373,3971,29974,469,228,241
46330,35904,5926,17376,3972,29978,469,228,241
46335,35906,5927,17376,3972,29979,469,228,241
46340,35914,5928,17380,3972,29986,469,228,241
46345,35917,5928,17381,3972,29989,469,228,241
46350,35922,5929,17382,3972,29993,469,228,241
46355,35926,5929,17383,3972,29997,469,228,241
46360,35929,5929,17384,3972,30000,469,228,241
46365,35930,5930,17385,3973,30000,469,228,241
46370,35935,5931,17388,3974,30004,469,228,241
46375,35937,5932,17390,3975,30005,469,228,241
46380,35945,5933,17395,3975,30012,469,228,241
46385,35948,5933,17395,3975,30015,469,228,241
46390,35953,5934,17400,3976,30019,470,229,241
46395,35957,5934,17401,3976,30023,470,229,241
46400,35960,5934,17404,3976,30026,470,229,241
46405,35961,5935,17405,3977,30026,470,229,241
46410,35966,5936,17408,3978,30029,470,229,241
46415,35968,5938,17409,3980,30030,470,229,241
46420,35976,5939,17413,3981,30037,470,229,241
46425,35979,5939,17416,3981,30040,470,229,241
46430,35984,5940,17417,3981,30044,471,229,242
46435,35988,5940,17420,3981,30048,471,229,242
46440,35991,5940,17421,3981,30051,471,229,242
46445,35992,5941,17422,3982,30051,471,229,242
46450,35997,5942,17425,3982,30054,471,229,242
46455,35999,5944,17426,3983,30055,471,229,242
46460,36007,5947,17430,3986,30060,471,229,242
46465,36010,5947,17432,3986,30063,471,229,242
46470,36015,5948,17434,3986,30067,471,229,242
46475,36019,5948,17435,3986,30071,471,229,242
46480,36022,5948,17436,3986,30074,471,229,242
46485,36023,5948,17436,3986,30075,471,229,242
46490,36028,5949,17440,3987,30078,471,229,242
46495,36030,5951,17440,3988,30079,471,229,242
46500,36038,5953,17444,3989,30085,471,229,242
46505,36041,5953,17446,3989,30088,471,229,242
46510,36046,5954,17448,3989,30092,471,229,242
46515,36050,5954,17450,3989,30095,471,229,242
46520,36053,5955,17452,3990,30098,471,229,242
46525,36054,5955,17452,3990,30099,471,229,242
46530,36059,5956,17456,3991,30102,471,229,242
46535,36061,5958,17456,3992,30103,471,229,242
46540,36069,5960,17460,3994,30109,471,229,242
46545,36072,5960,17463,3994,30112,471,229,242
46550,36077,5961,17465,3995,30116,472,229,243
46555,36081,5961,17467,3995,30120,472,229,243
46560,36084,5962,17470,3996,30122,472,229,243
46565,36085,5963,17471,3997,30122,472,229,243
46570,36090,5964,17473,3997,30126,472,229,243
46575,36092,5965,17475,3998,30127,472,229,243
46580,36100,5966,17479,3999,30134,472,229,243
46585,36103,5966,17480,3999,30137,472,229,243
46590,36108,5967,17484,4000,30141,472,229,243
46595,36112,5967,17487,4000,30145,472,229,243
46600,36115,5968,17488,4001,30147,472,229,243
46605,36116,5968,17488,4001,30148,472,229,243
46610,36121,5969,17491,4002,30152,472,229,243
46615,36123,5970,17493,4003,30153,472,229,243
46620,36131,5972,17496,4004,30159,472,229,243
46625,36134,5972,17498,4004,30162,472,229,243
46630,36139,5973,17501,4005,30166,472,229,243
46635,36143,5973,17504,4005,30170,472,229,243
46640,36146,5973,17506,4005,30173,472,229,243
46645,36147,5973,17506,4005,30174,472,229,243
46650,36152,5973,17509,4005,30179,472,229,243
46655,36154,5973,17511,4005,30181,472,229,243
46660,36162,5974,17514,4005,30188,472,229,243
46665,36165,5974,17515,4005,30191,472,229,243
46670,36170,5975,17516,4006,30195,473,229,244
46675,36174,5975,17517,4006,30199,473,229,244
46680,36177,5975,17517,4006,30202,473,229,244
46685,36178,5975,17517,4006,30203,473,229,244
46690,36183,5975,17518,4006,30208,473,229,244
46695,36185,5975,17520,4006,30210,473,229,244
46700,36193,5976,17523,4006,30217,473,229,244
46705,36196,5976,17526,4006,30220,473,229,244
46710,36201,5977,17527,4006,30224,473,229,244
46715,36205,5977,17529,4006,30228,473,229,244
46720,36208,5977,17531,4006,30231,473,229,244
46725,36209,5977,17532,4006,30232,473,229,244
46730,36214,5978,17535,4007,30235,473,229,244
46735,36216,5980,17536,4008,30236,473,229,244
46740,36224,5983,17541,4010,30241,473,229,244
46745,36227,5983,17542,4010,30244,473,229,244
46750,36232,5984,17545,4011,30248,473,229,244
46755,36236,5984,17548,4011,30252,473,229,244
46760,36239,5984,17549,4011,30255,473,229,244
46765,36240,5985,17550,4012,30255,473,229,244
46770,36245,5986,17552,4013,30259,473,229,244
46775,36247,5987,17553,4013,30260,473,229,244
46780,36255,5988,17557,4013,30267,473,229,244
46785,36258,5989,17558,4014,30269,473,229,244
46790,36263,5990,17561,4014,30273,474,230,244
46795,36267,5990,17565,4014,30276,474,230,244
46800,36270,5992,17566,4016,30278,474,230,244
46805,36271,5993,17567,4017,30278,474,230,244
46810,36276,5994,17570,4017,30282,474,230,244
46815,36278,5994,17572,4017,30284,474,230,244
46820,36286,5996,17577,4019,30290,474,230,244
46825,36289,5996,17579,4019,30293,474,230,244
46830,36294,5996,17581,4019,30298,474,230,244
46835,36298,5996,17582,4019,30301,474,230,244
46840,36301,5997,17583,4020,30304,474,230,244
46845,36302,5998,17584,4021,30304,474,230,244
46850,36307,5999,17589,4022,30308,474,230,244
46855,36309,5999,17589,4022,30310,474,230,244
46860,36317,6000,17590,4022,30317,474,230,244
46865,36320,6000,17592,4022,30320,474,230,244
46870,36325,6000,17593,4022,30325,474,230,244
46875,36329,6000,17596,4022,30329,474,230,244
46880,36332,6000,17597,4022,30332,474,230,244
46885,36333,6000,17598,4022,30333,474,230,244
46890,36338,6000,17600,4022,30338,474,230,244
46895,36340,6000,17600,4022,30340,474,230,244
46900,36348,6001,17602,4022,30347,474,230,244
46905,36351,6002,17604,4023,30349,474,230,244
46910,36356,6003,17606,4024,30353,475,230,245
46915,36360,6003,17608,4024,30357,475,230,245
46920,36363,6003,17609,4024,30360,475,230,245
46925,36364,6003,17609,4024,30361,475,230,245
46930,36369,6003,17613,4024,30365,475,230,245
46935,36371,6005,17614,4025,30366,475,230,245
46940,36379,6006,17618,4025,30373,475,230,245
46945,36382,6006,17620,4025,30376,475,230,245
46950,36387,6007,17624,4025,30380,476,231,245
46955,36391,6007,17627,4025,30383,476,231,245
46960,36394,6008,17628,4026,30386,476,231,245
46965,36395,6008,17628,4026,30387,476,231,245
46970,36400,6009,17629,4026,30391,476,231,245
46975,36402,6010,17629,4026,30392,476,231,245
46980,36410,6012,17634,4028,30398,476,231,245
46985,36413,6012,17635,4028,30401,476,231,245
46990,36418,6013,17639,4029,30405,477,232,245
46995,36422,6013,17641,4029,30409,477,232,245
47000,36425,6013,17642,4029,30412,477,232,245
47005,36426,6013,17643,4029,30413,477,232,245
47010,36431,6014,17646,4030,30417,477,232,245
47015,36433,6015,17647,4030,30418,477,232,245
47020,36441,6017,17650,4031,30424,477,232,245
47025,36444,6017,17651,4031,30427,477,232,245
47030,36449,6018,17651,4031,30431,478,232,246
47035,36453,6018,17652,4031,30435,478,232,246
47040,36456,6019,17653,4032,30437,478,232,246
47045,36457,6019,17653,4032,30438,478,232,246
47050,36462,6020,17655,4032,30441,478,232,246
47055,36464,6022,17657,4034,30442,478,232,246
47060,36472,6023,17660,4035,30449,478,232,246
47065,36475,6023,17662,4035,30452,478,232,246
47070,36480,6024,17663,4035,30456,478,232,246
47075,36484,6024,17665,4035,30460,478,232,246
47080,36487,6025,17666,4036,30462,478,232,246
47085,36488,6026,17667,4037,30462,478,232,246
47090,36493,6027,17670,4038,30465,478,232,246
47095,36495,6029,17671,4040,30466,478,232,246
47100,36503,6031,17674,4041,30472,478,232,246
47105,36506,6031,17676,4041,30475,478,232,246
47110,36511,6032,17678,4041,30479,478,232,246
47115,36515,6032,17680,4041,30482,478,232,246
47120,36518,6033,17683,4042,30485,478,232,246
47125,36519,6034,17684,4043,30485,478,232,246
47130,36524,6035,17686,4043,30489,478,232,246
47135,36526,6036,17686,4043,30490,478,232,246
47140,36534,6038,17691,4045,30496,478,232,246
47145,36537,6038,17693,4045,30499,478,232,246
47150,36542,6039,17695,4046,30503,479,232,247
47155,36546,6039,17696,4046,30506,479,232,247
47160,36549,6040,17697,4047,30509,479,232,247
47165,36550,6040,17697,4047,30510,479,232,247
47170,36555,6041,17699,4048,30514,479,232,247
47175,36557,6042,17700,4049,30515,479,232,247
47180,36565,6043,17704,4049,30522,479,232,247
47185,36568,6043,17704,4049,30525,479,232,247
47190,36573,6044,17707,4050,30529,480,232,248
47195,36577,6044,17707,4050,30533,480,232,248
47200,36580,6044,17709,4050,30536,480,232,248
47205,36581,6045,17710,4051,30536,480,232,248
47210,36586,6046,17712,4051,30539,480,232,248
47215,36588,6048,17713,4052,30540,480,232,248
47220,36596,6049,17717,4052,30547,480,232,248
47225,36599,6050,17719,4053,30549,480,232,248
47230,36604,6051,17722,4054,30553,480,232,248
47235,36608,6051,17723,4054,30557,480,232,248
47240,36611,6052,17725,4055,30559,480,232,248
47245,36612,6053,17726,4056,30559,480,232,248
47250,36617,6054,17727,4056,30563,480,232,248
47255,36619,6055,17727,4056,30564,480,232,248
47260,36627,6056,17730,4057,30571,480,232,248
47265,36630,6057,17731,4058,30573,480,232,248
47270,36635,6058,17732,4058,30577,480,232,248
47275,36639,6058,17733,4058,30581,480,232,248
47280,36642,6058,17734,4058,30584,480,232,248
47285,36643,6059,17735,4059,30584,480,232,248
47290,36648,6060,17738,4059,30588,480,232,248
47295,36650,6060,17739,4059,30590,480,232,248
47300,36658,6062,17743,4061,30596,480,232,248
47305,36661,6062,17744,4061,30599,480,232,248
47310,36666,6063,17748,4062,30603,481,232,249
47315,36670,6063,17748,4062,30607,481,232,249
47320,36673,6063,17749,4062,30610,481,232,249
47325,36674,6064,17750,4063,30610,481,232,249
47330,36679,6065,17751,4064,30614,481,232,249
47335,36681,6065,17753,4064,30616,481,232,249
47340,36689,6066,17758,4064,30623,481,232,249
47345,36692,6066,17758,4064,30626,481,232,249
47350,36697,6067,17762,4065,30630,481,232,249
47355,36701,6067,17765,4065,30634,481,232,249
47360,36704,6067,17766,4065,30637,481,232,249
47365,36705,6067,17766,4065,30638,481,232,249
47370,36710,6068,17768,4066,30642,481,232,249
47375,36712,6068,17768,4066,30644,481,232,249
47380,36720,6070,17771,4068,30650,481,232,249
47385,36723,6070,17771,4068,30653,481,232,249
47390,36728,6071,17773,4068,30657,481,232,249
47395,36732,6071,17776,4068,30660,481,232,249
47400,36735,6072,17778,4069,30663,481,232,249
47405,36736,6072,17778,4069,30664,481,232,249
47410,36741,6073,17780,4070,30667,481,232,249
47415,36743,6075,17782,4072,30668,481,232,249
47420,36751,6076,17786,4072,30675,481,232,249
47425,36754,6076,17787,4072,30678,481,232,249
47430,36759,6077,17789,4072,30682,481,232,249
47435,36763,6077,17791,4072,30685,481,232,249
47440,36766,6078,17793,4073,30688,481,232,249
47445,36767,6078,17793,4073,30689,481,232,249
47450,36772,6079,17795,4073,30693,481,232,249
47455,36774,6080,17796,4073,30694,481,232,249
47460,36782,6082,17799,4075,30700,481,232,249
47465,36785,6082,17802,4075,30703,481,232,249
47470,36790,6083,17806,4075,30707,481,232,249
47475,36794,6083,17809,4075,30711,481,232,249
47480,36797,6083,17810,4075,30714,481,232,249
47485,36798,6083,17810,4075,30715,481,232,249
47490,36803,6084,17814,4076,30719,481,232,249
47495,36805,6085,17814,4076,30720,481,232,249
47500,36813,6086,17817,4077,30727,481,232,249
47505,36816,6086,17819,4077,30730,481,232,249
47510,36821,6087,17822,4077,30734,481,232,249
47515,36825,6087,17823,4077,30738,481,232,249
47520,36828,6087,17824,4077,30741,481,232,249
47525,36829,6087,17824,4077,30742,481,232,249
47530,36834,6088,17826,4077,30746,481,232,249
47535,36836,6089,17826,4077,30747,481,232,249
47540,36844,6091,17829,4078,30753,481,232,249
47545,36847,6091,17830,4078,30756,481,232,249
47550,36852,6092,17832,4078,30760,481,232,249
47555,36856,6092,17835,4078,30764,481,232,249
47560,36859,6092,17838,4078,30767,481,232,249
47565,36860,6092,17838,4078,30768,481,232,249
47570,36865,6093,17839,4079,30772,481,232,249
47575,36867,6094,17840,4080,30773,481,232,249
47580,36875,6097,17844,4082,30778,481,232,249
47585,36878,6097,17845,4082,30781,481,232,249
47590,36883,6098,17848,4083,30785,482,232,250
47595,36887,6098,17849,4083,30789,482,232,250
47600,36890,6098,17849,4083,30792,482,232,250
47605,36891,6099,17850,4084,30792,482,232,250
47610,36896,6100,17853,4084,30796,482,232,250
47615,36898,6101,17854,4085,30797,482,232,250
47620,36906,6102,17859,4086,30804,482,232,250
47625,36909,6102,17859,4086,30807,482,232,250
47630,36914,6103,17863,4087,30811,483,233,250
47635,36918,6103,17864,4087,30815,483,233,250
47640,36921,6104,17866,4088,30817,483,233,250
47645,36922,6104,17866,4088,30818,483,233,250
47650,36927,6105,17869,4088,30822,483,233,250
47655,36929,6106,17869,4088,30823,483,233,250
47660,36937,6107,17871,4088,30830,483,233,250
47665,36940,6107,17871,4088,30833,483,233,250
47670,36945,6108,17874,4089,30837,483,233,250
47675,36949,6108,17875,4089,30841,483,233,250
47680,36952,6109,17877,4090,30843,483,233,250
47685,36953,6110,17878,4091,30843,483,233,250
47690,36958,6111,17880,4091,30846,483,233,250
47695,36960,6113,17882,4093,30847,483,233,250
47700,36968,6116,17885,4095,30852,483,233,250
47705,36971,6117,17887,4096,30854,483,233,250
47710,36976,6118,17889,4096,30858,483,233,250
47715,36980,6118,17889,4096,30862,483,233,250
47720,36983,6118,17890,4096,30865,483,233,250
47725,36984,6119,17891,4097,30865,483,233,250
47730,36989,6120,17893,4097,30869,483,233,250
47735,36991,6120,17894,4097,30871,483,233,250
47740,36999,6121,17897,4098,30878,483,233,250
47745,37002,6122,17898,4099,30880,483,233,250
47750,37007,6123,17902,4100,30884,483,233,250
47755,37011,6123,17904,4100,30888,483,233,250
47760,37014,6123,17905,4100,30891,483,233,250
47765,37015,6123,17905,4100,30892,483,233,250
47770,37020,6124,17908,4101,30896,483,233,250
47775,37022,6124,17908,4101,30898,483,233,250
47780,37030,6125,17914,4102,30905,483,233,250
47785,37033,6126,17917,4103,30907,483,233,250
47790,37038,6127,17919,4103,30911,483,233,250
47795,37042,6127,17920,4103,30915,483,233,250
47800,37045,6127,17920,4103,30918,483,233,250
47805,37046,6127,17920,4103,30919,483,233,250
47810,37051,6128,17923,4103,30923,483,233,250
47815,37053,6129,17925,4104,30924,483,233,250
47820,37061,6132,17930,4106,30929,483,233,250
47825,37064,6133,17933,4107,30931,483,233,250
47830,37069,6134,17935,4107,30935,483,233,250
47835,37073,6134,17938,4107,30939,483,233,250
47840,37076,6135,17941,4108,30941,483,233,250
47845,37077,6135,17941,4108,30942,483,233,250
47850,37082,6135,17942,4108,30947,483,233,250
47855,37084,6136,17944,4109,30948,483,233,250
47860,37092,6138,17947,4109,30954,483,233,250
47865,37095,6139,17948,4109,30956,483,233,250
47870,37100,6140,17951,4110,30960,483,233,250
47875,37104,6140,17952,4110,30964,483,233,250
47880,37107,6141,17954,4111,30966,483,233,250
47885,37108,6141,17955,4111,30967,483,233,250
47890,37113,6141,17956,4111,30972,483,233,250
47895,37115,6141,17958,4111,30974,483,233,250
47900,37123,6143,17962,4112,30980,483,233,250
47905,37126,6143,17962,4112,30983,483,233,250
47910,37131,6144,17963,4113,30987,483,233,250
47915,37135,6144,17964,4113,30991,483,233,250
47920,37138,6144,17967,4113,30994,483,233,250
47925,37139,6144,17967,4113,30995,483,233,250
47930,37144,6145,17969,4114,30999,483,233,250
47935,37146,6145,17970,4114,31001,483,233,250
47940,37154,6148,17976,4116,31006,483,233,250
47945,37157,6149,17977,4116,31008,483,233,250
47950,37162,6150,17979,4117,31012,483,233,250
47955,37166,6150,17980,4117,31015,483,233,250
47960,37169,6151,17981,4118,31018,483,233,250
47965,37170,6151,17981,4118,31019,483,233,250
47970,37175,6152,17983,4118,31023,483,233,250
47975,37177,6152,17983,4118,31025,483,233,250
47980,37185,6153,17986,4118,31032,483,233,250
47985,37188,6154,17988,4119,31034,483,233,250
47990,37193,6155,17989,4119,31038,483,233,250
47995,37197,6155,17990,4119,31042,483,233,250
48000,37200,6156,17992,4120,31044,483,233,250
48005,37201,6156,17992,4120,31045,483,233,250
48010,37206,6157,17993,4120,31049,483,233,250
48015,37208,6158,17993,4120,31050,483,233,250
48020,37216,6159,17996,4120,31057,483,233,250
48025,37219,6160,17996,4120,31059,483,233,250
48030,37224,6161,17999,4121,31063,483,233,250
48035,37228,6161,18000,4121,31067,483,233,250
48040,37231,6161,18002,4121,31070,483,233,250
48045,37232,6162,18003,4122,31070,483,233,250
48050,37237,6163,18006,4122,31073,483,233,250
48055,37239,6165,18006,4123,31074,483,233,250
48060,37247,6167,18011,4125,31080,483,233,250
48065,37250,6167,18012,4125,31083,483,233,250
48070,37255,6167,18013,4125,31088,483,233,250
48075,37259,6167,18016,4125,31092,483,233,250
48080,37262,6167,18016,4125,31095,483,233,250
48085,37263,6167,18017,4125,31096,483,233,250
48090,37268,6167,18020,4125,31101,483,233,250
48095,37270,6168,18022,4126,31102,483,233,250
48100,37278,6170,18025,4127,31108,483,233,250
48105,37281,6170,18027,4127,31111,483,233,250
48110,37286,6170,18031,4127,31116,483,233,250
48115,37290,6170,18032,4127,31120,483,233,250
48120,37293,6170,18034,4127,31123,483,233,250
48125,37294,6170,18035,4127,31124,483,233,250
48130,37299,6170,18038,4127,31128,483,233,250
48135,37301,6172,18039,4128,31129,483,233,250
48140,37309,6174,18045,4129,31135,483,233,250
48145,37312,6174,18046,4129,31138,483,233,250
48150,37317,6174,18049,4129,31143,483,233,250
48155,37321,6174,18051,4129,31147,483,233,250
48160,37324,6174,18054,4129,31150,483,233,250
48165,37325,6174,18054,4129,31151,483,233,250
48170,37330,6175,18055,4129,31155,483,233,250
48175,37332,6176,18056,4130,31156,483,233,250
48180,37340,6179,18061,4132,31161,483,233,250
48185,37343,6180,18064,4133,31163,483,233,250
48190,37348,6181,18067,4133,31167,483,233,250
48195,37352,6181,18070,4133,31170,483,233,250
48200,37355,6183,18072,4135,31172,483,233,250
48205,37356,6183,18072,4135,31173,483,233,250
48210,37361,6184,18075,4135,31177,483,233,250
48215,37363,6184,18077,4135,31179,483,233,250
48220,37371,6185,18081,4136,31186,483,233,250
48225,37374,6186,18083,4137,31188,483,233,250
48230,37379,6187,18086,4137,31192,483,233,250
48235,37383,6187,18089,4137,31195,483,233,250
48240,37386,6189,18091,4139,31197,483,233,250
48245,37387,6189,18091,4139,31198,483,233,250
48250,37392,6190,18092,4139,31202,483,233,250
48255,37394,6190,18093,4139,31204,483,233,250
48260,37402,6191,18099,4139,31211,483,233,250
48265,37405,6192,18100,4140,31213,483,233,250
48270,37410,6193,18102,4140,31217,484,233,251
48275,37414,6193,18105,4140,31221,484,233,251
48280,37417,6193,18106,4140,31224,484,233,251
48285,37418,6193,18106,4140,31225,484,233,251
48290,37423,6194,18108,4140,31228,484,233,251
48295,37425,6196,18109,4141,31229,484,233,251
48300,37433,6199,18114,4143,31234,484,233,251
48305,37436,6200,18116,4143,31236,484,233,251
48310,37441,6201,18118,4144,31240,484,233,251
48315,37445,6201,18120,4144,31244,484,233,251
48320,37448,6201,18121,4144,31247,484,233,251
48325,37449,6201,18121,4144,31248,484,233,251
48330,37454,6202,18125,4145,31251,484,233,251
48335,37456,6204,18126,4146,31252,484,233,251
48340,37464,6206,18129,4147,31258,484,233,251
48345,37467,6207,18129,4147,31260,484,233,251
48350,37472,6208,18131,4148,31264,484,233,251
48355,37476,6208,18132,4148,31268,484,233,251
48360,37479,6208,18133,4148,31271,484,233,251
48365,37480,6208,18133,4148,31272,484,233,251
48370,37485,6209,18135,4148,31276,484,233,251
48375,37487,6210,18135,4148,31277,484,233,251
48380,37495,6211,18137,4149,31284,484,233,251
48385,37498,6211,18138,4149,31287,484,233,251
48390,37503,6212,18139,4149,31291,484,233,251
48395,37507,6212,18139,4149,31295,484,233,251
48400,37510,6212,18140,4149,31298,484,233,251
48405,37511,6212,18140,4149,31299,484,233,251
48410,37516,6213,18142,4150,31303,484,233,251
48415,37518,6214,18143,4150,31304,484,233,251
48420,37526,6216,18147,4151,31310,484,233,251
48425,37529,6216,18147,4151,31313,484,233,251
48430,37534,6217,18151,4152,31317,484,233,251
48435,37538,6217,18153,4152,31321,484,233,251
48440,37541,6217,18155,4152,31324,484,233,251
48445,37542,6217,18155,4152,31325,484,233,251
48450,37547,6218,18159,4153,31328,484,233,251
48455,37549,6220,18160,4155,31329,484,233,251
48460,37557,6222,18165,4156,31335,484,233,251
48465,37560,6222,18168,4156,31338,484,233,251
48470,37565,6223,18170,4156,31342,484,233,251
48475,37569,6223,18170,4156,31346,484,233,251
48480,37572,6224,18172,4157,31348,484,233,251
48485,37573,6225,18173,4158,31348,484,233,251
48490,37578,6226,18176,4158,31352,484,233,251
48495,37580,6226,18178,4158,31354,484,233,251
48500,37588,6227,18182,4159,31361,484,233,251
48505,37591,6228,18185,4160,31363,484,233,251
48510,37596,6228,18188,4160,31368,484,233,251
48515,37600,6228,18189,4160,31372,484,233,251
48520,37603,6228,18190,4160,31375,484,233,251
48525,37604,6229,18191,4161,31375,484,233,251
48530,37609,6230,18194,4161,31379,484,233,251
48535,37611,6230,18194,4161,31381,484,233,251
48540,37619,6231,18197,4161,31388,484,233,251
48545,37622,6232,18199,4162,31390,484,233,251
48550,37627,6232,18200,4162,31395,484,233,251
48555,37631,6232,18203,4162,31399,484,233,251
48560,37634,6232,18204,4162,31402,484,233,251
48565,37635,6233,18205,4163,31402,484,233,251
48570,37640,6234,18207,4163,31406,484,233,251
48575,37642,6234,18207,4163,31408,484,233,251
48580,37650,6235,18209,4163,31415,484,233,251
48585,37653,6236,18211,4163,31417,484,233,251
48590,37658,6237,18214,4163,31421,485,233,252
48595,37662,6237,18217,4163,31424,485,233,252
48600,37665,6239,18220,4165,31426,485,233,252
48605,37666,6239,18220,4165,31427,485,233,252
48610,37671,6240,18221,4165,31430,485,233,252
48615,37673,6242,18222,4166,31431,485,233,252
48620,37681,6245,18227,4169,31436,485,233,252
48625,37684,6245,18227,4169,31439,485,233,252
48630,37689,6245,18231,4169,31444,485,233,252
48635,37693,6245,18233,4169,31448,485,233,252
48640,37696,6245,18233,4169,31451,485,233,252
48645,37697,6245,18234,4169,31452,485,233,252
48650,37702,6246,18236,4169,31456,485,233,252
48655,37704,6247,18236,4169,31457,485,233,252
48660,37712,6250,18239,4170,31462,485,233,252
48665,37715,6250,18240,4170,31465,485,233,252
48670,37720,6250,18242,4170,31470,485,233,252
48675,37724,6250,18245,4170,31473,485,233,252
48680,37727,6251,18247,4171,31476,485,233,252
48685,37728,6251,18248,4171,31477,485,233,252
48690,37733,6252,18250,4171,31481,485,233,252
48695,37735,6253,18252,4172,31482,485,233,252
48700,37743,6255,18257,4174,31488,485,233,252
48705,37746,6255,18258,4174,31491,485,233,252
48710,37751,6256,18261,4175,31495,486,234,252
48715,37755,6256,18263,4175,31498,486,234,252
48720,37758,6257,18264,4176,31501,486,234,252
48725,37759,6258,18265,4177,31501,486,234,252
48730,37764,6259,18266,4177,31504,486,234,252
48735,37766,6261,18267,4178,31505,486,234,252
48740,37774,6262,18272,4179,31512,486,234,252
48745,37777,6263,18275,4180,31514,486,234,252
48750,37782,6264,18278,4180,31518,486,234,252
48755,37786,6264,18280,4180,31522,486,234,252
48760,37789,6264,18280,4180,31525,486,234,252
48765,37790,6265,18281,4181,31525,486,234,252
48770,37795,6266,18284,4182,31529,486,234,252
48775,37797,6267,18284,4182,31530,486,234,252
48780,37805,6268,18288,4182,31537,486,234,252
48785,37808,6268,18289,4182,31540,486,234,252
48790,37813,6269,18292,4183,31544,486,234,252
48795,37817,6269,18292,4183,31548,486,234,252
48800,37820,6269,18293,4183,31551,486,234,252
48805,37821,6270,18294,4184,31551,486,234,252
48810,37826,6271,18297,4184,31554,486,234,252
48815,37828,6273,18298,4186,31555,486,234,252
48820,37836,6274,18304,4187,31562,486,234,252
48825,37839,6274,18305,4187,31565,486,234,252
48830,37844,6275,18307,4188,31569,487,234,253
48835,37848,6275,18308,4188,31573,487,234,253
48840,37851,6276,18310,4189,31575,487,234,253
48845,37852,6276,18310,4189,31576,487,234,253
48850,37857,6277,18313,4189,31580,487,234,253
48855,37859,6278,18314,4189,31581,487,234,253
48860,37867,6280,18316,4189,31587,487,234,253
48865,37870,6281,18318,4190,31589,487,234,253
48870,37875,6282,18321,4191,31593,487,234,253
48875,37879,6282,18322,4191,31597,487,234,253
48880,37882,6283,18325,4192,31599,487,234,253
48885,37883,6283,18325,4192,31600,487,234,253
48890,37888,6284,18327,4192,31604,487,234,253
48895,37890,6285,18327,4192,31605,487,234,253
48900,37898,6287,18331,4193,31611,487,234,253
48905,37901,6287,18333,4193,31614,487,234,253
48910,37906,6288,18334,4193,31618,487,234,253
48915,37910,6288,18337,4193,31621,487,234,253
48920,37913,6289,18339,4194,31624,487,234,253
48925,37914,6289,18340,4194,31625,487,234,253
48930,37919,6289,18342,4194,31630,487,234,253
48935,37921,6289,18342,4194,31632,487,234,253
48940,37929,6290,18348,4195,31639,487,234,253
48945,37932,6290,18348,4195,31642,487,234,253
48950,37937,6291,18350,4196,31646,488,234,254
48955,37941,6291,18353,4196,31649,488,234,254
48960,37944,6292,18354,4197,31652,488,234,254
48965,37945,6292,18355,4197,31653,488,234,254
48970,37950,6292,18356,4197,31658,488,234,254
48975,37952,6292,18357,4197,31660,488,234,254
48980,37960,6293,18361,4197,31667,488,234,254
48985,37963,6293,18363,4197,31670,488,234,254
48990,37968,6294,18365,4198,31674,488,234,254
48995,37972,6294,18367,4198,31678,488,234,254
49000,37975,6294,18368,4198,31681,488,234,254
49005,37976,6294,18369,4198,31682,488,234,254
49010,37981,6295,18371,4198,31686,488,234,254
49015,37983,6296,18371,4198,31687,488,234,254
49020,37991,6298,18378,4200,31693,488,234,254
49025,37994,6298,18378,4200,31696,488,234,254
49030,37999,6299,18381,4201,31700,488,234,254
49035,38003,6299,18383,4201,31704,488,234,254
49040,38006,6300,18384,4202,31706,488,234,254
49045,38007,6301,18385,4203,31706,488,234,254
49050,38012,6302,18387,4203,31709,488,234,254
49055,38014,6304,18388,4205,31710,488,234,254
49060,38022,6305,18392,4206,31717,488,234,254
49065,38025,6306,18395,4207,31719,488,234,254
49070,38030,6307,18400,4208,31723,489,235,254
49075,38034,6307,18401,4208,31727,489,235,254
49080,38037,6308,18404,4209,31729,489,235,254
49085,38038,6308,18404,4209,31730,489,235,254
49090,38043,6309,18408,4210,31734,489,235,254
49095,38045,6309,18409,4210,31736,489,235,254
49100,38053,6310,18411,4210,31743,489,235,254
49105,38056,6311,18414,4211,31745,489,235,254
49110,38061,6312,18417,4212,31749,490,236,254
49115,38065,6312,18419,4212,31753,490,236,254
49120,38068,6312,18419,4212,31756,490,236,254
49125,38069,6312,18419,4212,31757,490,236,254
49130,38074,6313,18421,4212,31761,490,236,254
49135,38076,6313,18423,4212,31763,490,236,254
49140,38084,6316,18429,4215,31768,490,236,254
49145,38087,6317,18432,4216,31770,490,236,254
49150,38092,6318,18433,4217,31774,491,236,255
49155,38096,6318,18435,4217,31778,491,236,255
49160,38099,6318,18436,4217,31781,491,236,255
49165,38100,6318,18436,4217,31782,491,236,255
49170,38105,6319,18439,4217,31786,491,236,255
49175,38107,6319,18440,4217,31788,491,236,255
49180,38115,6320,18446,4218,31795,491,236,255
49185,38118,6321,18447,4219,31797,491,236,255
49190,38123,6322,18450,4220,31801,492,237,255
49195,38127,6322,18452,4220,31805,492,237,255
49200,38130,6323,18453,4221,31807,492,237,255
49205,38131,6323,18453,4221,31808,492,237,255
49210,38136,6324,18455,4221,31812,492,237,255
49215,38138,6325,18456,4222,31813,492,237,255
49220,38146,6326,18460,4223,31820,492,237,255
49225,38149,6326,18462,4223,31823,492,237,255
49230,38154,6327,18463,4223,31827,492,237,255
49235,38158,6327,18465,4223,31831,492,237,255
49240,38161,6327,18467,4223,31834,492,237,255
49245,38162,6328,18468,4224,31834,492,237,255
49250,38167,6329,18472,4225,31838,492,237,255
49255,38169,6330,18473,4226,31839,492,237,255
49260,38177,6332,18477,4228,31845,492,237,255
49265,38180,6332,18477,4228,31848,492,237,255
49270,38185,6333,18481,4229,31852,492,237,255
49275,38189,6333,18481,4229,31856,492,237,255
49280,38192,6333,18482,4229,31859,492,237,255
49285,38193,6334,18483,4230,31859,492,237,255
49290,38198,6335,18484,4230,31863,492,237,255
49295,38200,6336,18485,4230,31864,492,237,255
49300,38208,6337,18489,4231,31871,492,237,255
49305,38211,6337,18490,4231,31874,492,237,255
49310,38216,6338,18492,4231,31878,493,237,256
49315,38220,6338,18493,4231,31882,493,237,256
49320,38223,6339,18495,4232,31884,493,237,256
49325,38224,6339,18495,4232,31885,493,237,256
49330,38229,6340,18498,4233,31888,493,237,256
49335,38231,6342,18498,4234,31889,493,237,256
49340,38239,6344,18503,4236,31895,493,237,256
49345,38242,6344,18505,4236,31898,493,237,256
49350,38247,6345,18507,4236,31902,494,237,257
49355,38251,6345,18508,4236,31906,494,237,257
49360,38254,6346,18511,4237,31908,494,237,257
49365,38255,6347,18512,4238,31908,494,237,257
49370,38260,6348,18515,4239,31911,494,237,257
49375,38262,6350,18516,4241,31912,494,237,257
49380,38270,6352,18518,4242,31918,494,237,257
49385,38273,6352,18519,4242,31921,494,237,257
49390,38278,6352,18523,4242,31926,494,237,257
49395,38282,6352,18526,4242,31929,494,237,257
49400,38285,6353,18526,4243,31932,494,237,257
49405,38286,6353,18527,4243,31933,494,237,257
49410,38291,6354,18528,4244,31937,494,237,257
49415,38293,6354,18528,4244,31939,494,237,257
49420,38301,6355,18533,4244,31946,494,237,257
49425,38304,6355,18533,4244,31949,494,237,257
49430,38309,6355,18535,4244,31954,494,237,257
49435,38313,6355,18539,4244,31957,494,237,257
49440,38316,6356,18539,4245,31960,494,237,257
49445,38317,6356,18539,4245,31961,494,237,257
49450,38322,6357,18543,4245,31965,494,237,257
49455,38324,6357,18544,4245,31967,494,237,257
49460,38332,6358,18547,4245,31974,494,237,257
49465,38335,6359,18548,4246,31976,494,237,257
49470,38340,6359,18551,4246,31981,494,237,257
49475,38344,6359,18553,4246,31985,494,237,257
49480,38347,6359,18555,4246,31988,494,237,257
49485,38348,6359,18555,4246,31989,494,237,257
49490,38353,6360,18557,4247,31993,494,237,257
49495,38355,6361,18558,4247,31994,494,237,257
49500,38363,6364,18561,4249,31999,494,237,257
49505,38366,6364,18563,4249,32002,494,237,257
49510,38371,6365,18565,4249,32006,494,237,257
49515,38375,6365,18567,4249,32010,494,237,257
49520,38378,6366,18569,4250,32012,494,237,257
49525,38379,6366,18570,4250,32013,494,237,257
49530,38384,6366,18572,4250,32018,494,237,257
49535,38386,6367,18573,4250,32019,494,237,257
49540,38394,6368,18577,4250,32026,494,237,257
49545,38397,6368,18578,4250,32029,494,237,257
49550,38402,6369,18581,4251,32033,494,237,257
49555,38406,6369,18581,4251,32037,494,237,257
49560,38409,6370,18584,4252,32039,494,237,257
49565,38410,6370,18584,4252,32040,494,237,257
49570,38415,6370,18586,4252,32044,494,237,257
49575,38417,6372,18587,4253,32045,494,237,257
49580,38425,6373,18591,4253,32052,494,237,257
49585,38428,6373,18592,4253,32055,494,237,257
49590,38433,6374,18594,4254,32059,494,237,257
49595,38437,6374,18595,4254,32063,494,237,257
49600,38440,6374,18597,4254,32066,494,237,257
49605,38441,6374,18598,4254,32067,494,237,257
49610,38446,6375,18602,4255,32070,494,237,257
49615,38448,6377,18604,4257,32071,494,237,257
49620,38456,6380,18608,4260,32076,494,237,257
49625,38459,6380,18608,4260,32079,494,237,257
49630,38464,6381,18609,4261,32083,494,237,257
49635,38468,6381,18610,4261,32087,494,237,257
49640,38471,6381,18612,4261,32090,494,237,257
49645,38472,6381,18612,4261,32091,494,237,257
49650,38477,6382,18612,4261,32095,494,237,257
49655,38479,6382,18613,4261,32097,494,237,257
49660,38487,6383,18614,4261,32104,494,237,257
49665,38490,6383,18614,4261,32107,494,237,257
49670,38495,6384,18616,4262,32111,494,237,257
49675,38499,6384,18620,4262,32115,494,237,257
49680,38502,6384,18621,4262,32118,494,237,257
49685,38503,6384,18621,4262,32119,494,237,257
49690,38508,6385,18623,4263,32123,494,237,257
49695,38510,6385,18625,4263,32125,494,237,257
49700,38518,6386,18629,4263,32132,494,237,257
49705,38521,6387,18631,4264,32134,494,237,257
49710,38526,6388,18634,4264,32138,494,237,257
49715,38530,6388,18635,4264,32142,494,237,257
49720,38533,6388,18637,4264,32145,494,237,257
49725,38534,6388,18637,4264,32146,494,237,257
49730,38539,6389,18639,4264,32149,494,237,257
49735,38541,6391,18639,4265,32150,494,237,257
49740,38549,6394,18642,4267,32155,494,237,257
49745,38552,6394,18644,4267,32158,494,237,257
49750,38557,6395,18646,4268,32162,494,237,257
49755,38561,6395,18648,4268,32166,494,237,257
49760,38564,6396,18650,4269,32168,494,237,257
49765,38565,6397,18651,4270,32168,494,237,257
49770,38570,6398,18654,4271,32171,494,237,257
49775,38572,6400,18655,4272,32172,494,237,257
49780,38580,6401,18658,4272,32179,494,237,257
49785,38583,6401,18659,4272,32182,494,237,257
49790,38588,6402,18662,4273,32186,494,237,257
49795,38592,6402,18663,4273,32189,494,237,257
49800,38595,6404,18665,4275,32191,494,237,257
49805,38596,6405,18666,4276,32191,494,237,257
49810,38601,6406,18669,4276,32194,494,237,257
49815,38603,6408,18670,4278,32195,494,237,257
49820,38611,6409,18671,4278,32202,494,237,257
49825,38614,6409,18673,4278,32205,494,237,257
49830,38619,6410,18675,4279,32209,494,237,257
49835,38623,6410,18679,4279,32213,494,237,257
49840,38626,6410,18680,4279,32216,494,237,257
49845,38627,6410,18680,4279,32217,494,237,257
49850,38632,6411,18682,4280,32221,494,237,257
49855,38634,6412,18683,4280,32222,494,237,257
49860,38642,6414,18687,4281,32228,494,237,257
49865,38645,6414,18687,4281,32231,494,237,257
49870,38650,6415,18689,4282,32235,494,237,257
49875,38654,6415,18692,4282,32239,494,237,257
49880,38657,6415,18694,4282,32242,494,237,257
49885,38658,6416,18695,4283,32242,494,237,257
49890,38663,6417,18697,4284,32246,494,237,257
49895,38665,6417,18697,4284,32248,494,237,257
49900,38673,6419,18700,4285,32254,494,237,257
49905,38676,6420,18702,4286,32256,494,237,257
49910,38681,6421,18704,4286,32260,494,237,257
49915,38685,6421,18705,4286,32264,494,237,257
49920,38688,6421,18705,4286,32267,494,237,257
49925,38689,6421,18705,4286,32268,494,237,257
49930,38694,6422,18708,4286,32272,494,237,257
49935,38696,6422,18709,4286,32274,494,237,257
49940,38704,6423,18711,4287,32281,494,237,257
49945,38707,6423,18712,4287,32284,494,237,257
49950,38712,6424,18714,4288,32288,494,237,257
49955,38716,6424,18716,4288,32291,494,237,257
49960,38719,6425,18718,4289,32294,494,237,257
49965,38720,6426,18719,4290,32294,494,237,257
49970,38725,6427,18723,4291,32297,494,237,257
49975,38727,6429,18724,4293,32298,494,237,257
49980,38735,6431,18730,4295,32304,494,237,257
49985,38738,6431,18731,4295,32307,494,237,257
49990,38743,6432,18736,4296,32311,494,237,257
49995,38747,6432,18738,4296,32314,494,237,257
50000,38750,6433,18738,4297,32317,494,237,257
50005,38751,6433,18738,4297,32318,494,237,257
50010,38756,6433,18742,4297,32322,494,237,257
50015,38758,6435,18744,4299,32323,494,237,257
50020,38766,6437,18749,4301,32329,494,237,257
50025,38769,6437,18751,4301,32332,494,237,257
50030,38774,6438,18753,4301,32336,494,237,257
50035,38778,6438,18755,4301,32340,494,237,257
50040,38781,6438,18756,4301,32343,494,237,257
50045,38782,6438,18756,4301,32344,494,237,257
50050,38787,6438,18759,4301,32348,494,237,257
50055,38789,6440,18759,4302,32349,494,237,257
50060,38797,6441,18760,4302,32356,494,237,257
50065,38800,6441,18761,4302,32359,494,237,257
50070,38805,6441,18763,4302,32364,495,237,258
50075,38809,6441,18765,4302,32368,495,237,258
50080,38812,6441,18767,4302,32371,495,237,258
50085,38813,6441,18767,4302,32372,495,237,258
50090,38818,6442,18770,4303,32376,495,237,258
50095,38820,6443,18771,4304,32377,495,237,258
50100,38828,6444,18774,4304,32384,495,237,258
50105,38831,6445,18777,4305,32386,495,237,258
50110,38836,6445,18779,4305,32391,495,237,258
50115,38840,6445,18783,4305,32394,495,237,258
50120,38843,6446,18783,4306,32397,495,237,258
50125,38844,6446,18783,4306,32398,495,237,258
50130,38849,6447,18787,4306,32401,495,237,258
50135,38851,6449,18788,4308,32402,495,237,258
50140,38859,6451,18794,4310,32408,495,237,258
50145,38862,6452,18795,4311,32410,495,237,258
50150,38867,6453,18800,4312,32414,495,237,258
50155,38871,6453,18803,4312,32417,495,237,258
50160,38874,6454,18804,4313,32420,495,237,258
50165,38875,6455,18805,4314,32420,495,237,258
50170,38880,6456,18808,4314,32424,495,237,258
50175,38882,6456,18809,4314,32426,495,237,258
50180,38890,6459,18813,4316,32431,495,237,258
50185,38893,6459,18815,4316,32434,495,237,258
50190,38898,6460,18819,4317,32438,496,238,258
50195,38902,6460,18821,4317,32442,496,238,258
50200,38905,6460,18822,4317,32445,496,238,258
50205,38906,6460,18822,4317,32446,496,238,258
50210,38911,6461,18822,4317,32450,496,238,258
50215,38913,6461,18822,4317,32452,496,238,258
50220,38921,6462,18827,4318,32459,496,238,258
50225,38924,6462,18828,4318,32462,496,238,258
50230,38929,6463,18831,4319,32466,496,238,258
50235,38933,6463,18834,4319,32470,496,238,258
50240,38936,6463,18835,4319,32473,496,238,258
50245,38937,6463,18835,4319,32474,496,238,258
50250,38942,6464,18837,4320,32478,496,238,258
50255,38944,6464,18839,4320,32480,496,238,258
50260,38952,6465,18845,4321,32487,496,238,258
50265,38955,6465,18846,4321,32490,496,238,258
50270,38960,6466,18848,4322,32494,496,238,258
50275,38964,6466,18850,4322,32497,496,238,258
50280,38967,6467,18852,4323,32500,496,238,258
50285,38968,6468,18853,4324,32500,496,238,258
50290,38973,6469,18856,4324,32503,496,238,258
50295,38975,6471,18856,4325,32504,496,238,258
50300,38983,6472,18859,4325,32511,496,238,258
50305,38986,6473,18860,4326,32513,496,238,258
50310,38991,6474,18864,4327,32517,496,238,258
50315,38995,6474,18867,4327,32520,496,238,258
50320,38998,6475,18868,4328,32523,496,238,258
50325,38999,6475,18868,4328,32524,496,238,258
50330,39004,6476,18871,4329,32527,496,238,258
50335,39006,6478,18871,4330,32528,496,238,258
50340,39014,6479,18872,4330,32535,496,238,258
50345,39017,6480,18875,4331,32537,496,238,258
50350,39022,6481,18878,4332,32541,497,239,258
50355,39026,6481,18880,4332,32545,497,239,258
50360,39029,6481,18882,4332,32548,497,239,258
50365,39030,6482,18883,4333,32548,497,239,258
50370,39035,6483,18887,4333,32551,497,239,258
50375,39037,6485,18888,4334,32552,497,239,258
50380,39045,6487,18895,4336,32558,497,239,258
50385,39048,6488,18896,4337,32560,497,239,258
50390,39053,6489,18896,4337,32564,498,239,259
50395,39057,6489,18899,4337,32568,498,239,259
50400,39060,6490,18901,4338,32570,498,239,259
50405,39061,6490,18901,4338,32571,498,239,259
50410,39066,6491,18903,4339,32574,498,239,259
50415,39068,6493,18904,4341,32575,498,239,259
50420,39076,6494,18908,4341,32582,498,239,259
50425,39079,6494,18910,4341,32585,498,239,259
50430,39084,6495,18913,4342,32589,498,239,259
50435,39088,6495,18914,4342,32593,498,239,259
50440,39091,6495,18915,4342,32596,498,239,259
50445,39092,6496,18916,4343,32596,498,239,259
50450,39097,6497,18920,4344,32599,498,239,259
50455,39099,6499,18920,4345,32600,498,239,259
50460,39107,6500,18923,4345,32607,498,239,259
50465,39110,6500,18924,4345,32610,498,239,259
50470,39115,6501,18926,4345,32614,499,240,259
50475,39119,6501,18929,4345,32617,499,240,259
50480,39122,6502,18929,4346,32620,499,240,259
50485,39123,6503,18930,4347,32620,499,240,259
50490,39128,6504,18932,4347,32624,499,240,259
50495,39130,6504,18933,4347,32626,499,240,259
50500,39138,6505,18938,4347,32633,499,240,259
50505,39141,6505,18939,4347,32636,499,240,259
50510,39146,6506,18942,4348,32640,500,240,260
50515,39150,6506,18942,4348,32644,500,240,260
50520,39153,6506,18943,4348,32647,500,240,260
50525,39154,6507,18944,4349,32647,500,240,260
50530,39159,6508,18947,4350,32651,500,240,260
50535,39161,6508,18948,4350,32653,500,240,260
50540,39169,6509,18953,4351,32660,500,240,260
50545,39172,6510,18954,4352,32662,500,240,260
50550,39177,6511,18957,4352,32666,500,240,260
50555,39181,6511,18960,4352,32670,500,240,260
50560,39184,6511,18961,4352,32673,500,240,260
50565,39185,6512,18962,4353,32673,500,240,260
50570,39190,6513,18965,4353,32677,500,240,260
50575,39192,6513,18966,4353,32679,500,240,260
50580,39200,6515,18971,4354,32685,500,240,260
50585,39203,6516,18973,4355,32687,500,240,260
50590,39208,6517,18975,4355,32691,500,240,260
50595,39212,6517,18977,4355,32695,500,240,260
50600,39215,6517,18980,4355,32698,500,240,260
50605,39216,6517,18981,4355,32699,500,240,260
50610,39221,6517,18983,4355,32704,500,240,260
50615,39223,6517,18984,4355,32706,500,240,260
50620,39231,6518,18988,4355,32713,500,240,260
50625,39234,6518,18989,4355,32716,500,240,260
50630,39239,6519,18991,4355,32720,501,240,261
50635,39243,6519,18993,4355,32723,501,240,261
50640,39246,6520,18995,4356,32726,501,240,261
50645,39247,6520,18995,4356,32727,501,240,261
50650,39252,6520,18996,4356,32732,501,240,261
50655,39254,6521,18996,4356,32733,501,240,261
50660,39262,6522,19000,4356,32740,501,240,261
50665,39265,6522,19000,4356,32743,501,240,261
50670,39270,6523,19004,4357,32747,501,240,261
50675,39274,6523,19006,4357,32750,501,240,261
50680,39277,6524,19007,4358,32753,501,240,261
50685,39278,6524,19008,4358,32754,501,240,261
50690,39283,6525,19009,4358,32758,501,240,261
50695,39285,6526,19010,4359,32759,501,240,261
50700,39293,6529,19015,4362,32764,501,240,261
50705,39296,6529,19018,4362,32767,501,240,261
50710,39301,6530,19020,4362,32771,501,240,261
50715,39305,6530,19022,4362,32775,501,240,261
50720,39308,6530,19024,4362,32778,501,240,261
50725,39309,6530,19024,4362,32779,501,240,261
50730,39314,6531,19027,4363,32782,501,240,261
50735,39316,6533,19029,4365,32783,501,240,261
50740,39324,6535,19033,4366,32789,501,240,261
50745,39327,6535,19035,4366,32792,501,240,261
50750,39332,6536,19038,4366,32796,501,240,261
50755,39336,6536,19040,4366,32800,501,240,261
50760,39339,6536,19043,4366,32803,501,240,261
50765,39340,6536,19043,4366,32804,501,240,261
50770,39345,6537,19047,4367,32807,501,240,261
50775,39347,6539,19049,4369,32808,501,240,261
50780,39355,6540,19054,4369,32815,501,240,261
50785,39358,6541,19057,4370,32817,501,240,261
50790,39363,6542,19061,4371,32821,501,240,261
50795,39367,6542,19063,4371,32824,501,240,261
50800,39370,6543,19064,4372,32827,501,240,261
50805,39371,6543,19064,4372,32828,501,240,261
50810,39376,6544,19066,4373,32832,501,240,261
50815,39378,6545,19066,4373,32833,501,240,261
50820,39386,6547,19070,4375,32839,501,240,261
50825,39389,6547,19072,4375,32842,501,240,261
50830,39394,6548,19074,4376,32846,502,240,262
50835,39398,6548,19075,4376,32850,502,240,262
50840,39401,6548,19075,4376,32853,502,240,262
50845,39402,6549,19076,4377,32853,502,240,262
50850,39407,6550,19079,4378,32857,502,240,262
50855,39409,6550,19080,4378,32859,502,240,262
50860,39417,6551,19083,4379,32866,502,240,262
50865,39420,6551,19085,4379,32869,502,240,262
50870,39425,6552,19086,4379,32873,503,241,262
50875,39429,6552,19089,4379,32877,503,241,262
50880,39432,6552,19090,4379,32880,503,241,262
50885,39433,6553,19091,4380,32880,503,241,262
50890,39438,6554,19093,4380,32884,503,241,262
50895,39440,6554,19094,4380,32886,503,241,262
50900,39448,6556,19096,4382,32892,503,241,262
50905,39451,6556,19098,4382,32895,503,241,262
50910,39456,6557,19099,4383,32899,503,241,262
50915,39460,6557,19100,4383,32903,503,241,262
50920,39463,6558,19103,4384,32905,503,241,262
50925,39464,6559,19104,4385,32905,503,241,262
50930,39469,6560,19109,4386,32908,503,241,262
50935,39471,6562,19110,4387,32909,503,241,262
50940,39479,6565,19113,4389,32914,503,241,262
50945,39482,6565,19114,4389,32917,503,241,262
50950,39487,6566,19117,4390,32921,503,241,262
50955,39491,6566,19118,4390,32925,503,241,262
50960,39494,6566,19121,4390,32928,503,241,262
50965,39495,6567,19122,4391,32928,503,241,262
50970,39500,6568,19126,4392,32931,503,241,262
50975,39502,6570,19127,4393,32932,503,241,262
50980,39510,6572,19133,4395,32938,503,241,262
50985,39513,6572,19134,4395,32941,503,241,262
50990,39518,6573,19136,4395,32945,503,241,262
50995,39522,6573,19139,4395,32948,503,241,262
51000,39525,6574,19140,4396,32951,503,241,262
51005,39526,6574,19140,4396,32952,503,241,262
51010,39531,6575,19145,4397,32955,503,241,262
51015,39533,6577,19146,4399,32956,503,241,262
51020,39541,6579,19150,4401,32962,503,241,262
51025,39544,6579,19151,4401,32965,503,241,262
51030,39549,6580,19154,4401,32969,503,241,262
51035,39553,6580,19157,4401,32973,503,241,262
51040,39556,6580,19159,4401,32976,503,241,262
51045,39557,6580,19160,4401,32977,503,241,262
51050,39562,6581,19163,4402,32980,503,241,262
51055,39564,6583,19163,4403,32981,503,241,262
51060,39572,6586,19165,4405,32986,503,241,262
51065,39575,6587,19166,4406,32988,503,241,262
51070,39580,6587,19169,4406,32993,503,241,262
51075,39584,6587,19169,4406,32997,503,241,262
51080,39587,6588,19171,4407,32999,503,241,262
51085,39588,6588,19171,4407,33000,503,241,262
51090,39593,6589,19173,4408,33003,503,241,262
51095,39595,6591,19174,4409,33004,503,241,262
51100,39603,6593,19177,4410,33010,503,241,262
51105,39606,6594,19179,4411,33012,503,241,262
51110,39611,6594,19182,4411,33017,503,241,262
51115,39615,6594,19184,4411,33021,503,241,262
51120,39618,6595,19187,4412,33023,503,241,262
51125,39619,6596,19188,4413,33023,503,241,262
51130,39624,6597,19192,4414,33027,503,241,262
51135,39626,6597,19192,4414,33029,503,241,262
51140,39634,6598,19194,4414,33036,503,241,262
51145,39637,6598,19196,4414,33039,503,241,262
51150,39642,6598,19200,4414,33044,503,241,262
51155,39646,6598,19203,4414,33048,503,241,262
51160,39649,6598,19204,4414,33051,503,241,262
51165,39650,6598,19204,4414,33052,503,241,262
51170,39655,6599,19206,4414,33056,503,241,262
51175,39657,6599,19207,4414,33058,503,241,262
51180,39665,6601,19213,4416,33064,503,241,262
51185,39668,6601,19214,4416,33067,503,241,262
51190,39673,6602,19216,4416,33071,503,241,262
51195,39677,6602,19217,4416,33074,503,241,262
51200,39680,6603,19217,4417,33077,503,241,262
51205,39681,6604,19218,4418,33077,503,241,262
51210,39686,6605,19221,4418,33081,503,241,262
51215,39688,6605,19223,4418,33083,503,241,262
51220,39696,6607,19227,4420,33089,503,241,262
51225,39699,6607,19228,4420,33092,503,241,262
51230,39704,6608,19231,4420,33096,503,241,262
51235,39708,6608,19233,4420,33100,503,241,262
51240,39711,6608,19236,4420,33103,503,241,262
51245,39712,6608,19236,4420,33104,503,241,262
51250,39717,6609,19237,4420,33108,503,241,262
51255,39719,6610,19239,4421,33109,503,241,262
51260,39727,6611,19243,4421,33116,503,241,262
51265,39730,6611,19245,4421,33119,503,241,262
51270,39735,6611,19248,4421,33124,503,241,262
51275,39739,6611,19251,4421,33128,503,241,262
51280,39742,6612,19252,4422,33130,503,241,262
51285,39743,6613,19253,4423,33130,503,241,262
51290,39748,6614,19255,4423,33134,503,241,262
51295,39750,6615,19255,4423,33135,503,241,262
51300,39758,6616,19259,4423,33142,503,241,262
51305,39761,6616,19259,4423,33145,503,241,262
51310,39766,6616,19260,4423,33150,504,241,263
51315,39770,6616,19262,4423,33153,504,241,263
51320,39773,6617,19264,4424,33156,504,241,263
51325,39774,6617,19264,4424,33157,504,241,263
51330,39779,6618,19266,4424,33160,504,241,263
51335,39781,6620,19266,4425,33161,504,241,263
51340,39789,6621,19267,4425,33168,504,241,263
51345,39792,6621,19268,4425,33171,504,241,263
51350,39797,6622,19271,4426,33175,505,242,263
51355,39801,6622,19273,4426,33178,505,242,263
51360,39804,6623,19275,4427,33181,505,242,263
51365,39805,6623,19275,4427,33182,505,242,263
51370,39810,6623,19278,4427,33186,505,242,263
51375,39812,6625,19278,4428,33187,505,242,263
51380,39820,6628,19286,4431,33192,505,242,263
51385,39823,6628,19286,4431,33195,505,242,263
51390,39828,6629,19290,4432,33199,505,242,263
51395,39832,6629,19294,4432,33202,505,242,263
51400,39835,6630,19295,4433,33205,505,242,263
51405,39836,6630,19296,4433,33206,505,242,263
51410,39841,6630,19297,4433,33211,505,242,263
51415,39843,6631,19298,4434,33212,505,242,263
51420,39851,6633,19300,4435,33218,505,242,263
51425,39854,6634,19302,4436,33220,505,242,263
51430,39859,6635,19303,4437,33224,505,242,263
51435,39863,6635,19306,4437,33227,505,242,263
51440,39866,6636,19307,4438,33230,505,242,263
51445,39867,6636,19307,4438,33231,505,242,263
51450,39872,6636,19308,4438,33235,505,242,263
51455,39874,6638,19308,4439,33236,505,242,263
51460,39882,6639,19311,4440,33243,505,242,263
51465,39885,6640,19313,4441,33245,505,242,263
51470,39890,6641,19315,4441,33249,506,242,264
51475,39894,6641,19318,4441,33253,506,242,264
51480,39897,6641,19321,4441,33256,506,242,264
51485,39898,6642,19322,4442,33256,506,242,264
51490,39903,6643,19325,4443,33260,506,242,264
51495,39905,6643,19325,4443,33262,506,242,264
51500,39913,6644,19327,4443,33269,506,242,264
51505,39916,6645,19329,4444,33271,506,242,264
51510,39921,6646,19329,4444,33275,507,242,265
51515,39925,6646,19331,4444,33279,507,242,265
51520,39928,6647,19333,4445,33281,507,242,265
51525,39929,6647,19333,4445,33282,507,242,265
51530,39934,6648,19335,4445,33286,507,242,265
51535,39936,6648,19335,4445,33288,507,242,265
51540,39944,6650,19338,4447,33294,507,242,265
51545,39947,6651,19340,4448,33296,507,242,265
51550,39952,6652,19342,4449,33300,507,242,265
51555,39956,6652,19342,4449,33304,507,242,265
51560,39959,6652,19343,4449,33307,507,242,265
51565,39960,6652,19343,4449,33308,507,242,265
51570,39965,6653,19346,4450,33312,507,242,265
51575,39967,6653,19346,4450,33314,507,242,265
51580,39975,6655,19350,4452,33320,507,242,265
51585,39978,6656,19351,4453,33322,507,242,265
51590,39983,6657,19354,4453,33326,507,242,265
51595,39987,6657,19354,4453,33330,507,242,265
51600,39990,6657,19355,4453,33333,507,242,265
51605,39991,6657,19355,4453,33334,507,242,265
51610,39996,6658,19357,4453,33338,507,242,265
51615,39998,6659,19357,4453,33339,507,242,265
51620,40006,6660,19361,4454,33346,507,242,265
51625,40009,6660,19363,4454,33349,507,242,265
51630,40014,6661,19365,4454,33353,508,243,265
51635,40018,6661,19368,4454,33356,508,243,265
51640,40021,6662,19368,4455,33359,508,243,265
51645,40022,6662,19368,4455,33360,508,243,265
51650,40027,6663,19370,4455,33363,508,243,265
51655,40029,6665,19371,4456,33364,508,243,265
51660,40037,6666,19375,4456,33371,508,243,265
51665,40040,6666,19378,4456,33374,508,243,265
51670,40045,6666,19380,4456,33379,508,243,265
51675,40049,6666,19383,4456,33383,508,243,265
51680,40052,6666,19386,4456,33386,508,243,265
51685,40053,6667,19387,4457,33386,508,243,265
51690,40058,6668,19392,4458,33389,508,243,265
51695,40060,6670,19394,4460,33390,508,243,265
51700,40068,6671,19399,4461,33397,508,243,265
51705,40071,6671,19401,4461,33400,508,243,265
51710,40076,6671,19402,4461,33405,508,243,265
51715,40080,6671,19404,4461,33409,508,243,265
51720,40083,6671,19406,4461,33412,508,243,265
51725,40084,6671,19406,4461,33413,508,243,265
51730,40089,6672,19407,4461,33417,508,243,265
51735,40091,6673,19407,4461,33418,508,243,265
51740,40099,6674,19409,4461,33425,508,243,265
51745,40102,6674,19410,4461,33428,508,243,265
51750,40107,6675,19413,4461,33432,508,243,265
51755,40111,6675,19414,4461,33436,508,243,265
51760,40114,6675,19415,4461,33439,508,243,265
51765,40115,6676,19416,4462,33439,508,243,265
51770,40120,6677,19418,4462,33443,508,243,265
51775,40122,6678,19420,4463,33444,508,243,265
51780,40130,6680,19425,4464,33450,508,243,265
51785,40133,6680,19428,4464,33453,508,243,265
51790,40138,6681,19432,4465,33457,508,243,265
51795,40142,6681,19432,4465,33461,508,243,265
51800,40145,6681,19433,4465,33464,508,243,265
51805,40146,6681,19433,4465,33465,508,243,265
51810,40151,6682,19436,4466,33468,508,243,265
51815,40153,6684,19436,4467,33469,508,243,265
51820,40161,6685,19441,4468,33476,508,243,265
51825,40164,6685,19442,4468,33479,508,243,265
51830,40169,6686,19444,4469,33483,509,243,266
51835,40173,6686,19445,4469,33487,509,243,266
51840,40176,6686,19446,4469,33490,509,243,266
51845,40177,6686,19446,4469,33491,509,243,266
51850,40182,6687,19450,4469,33494,509,243,266
51855,40184,6689,19451,4470,33495,509,243,266
51860,40192,6691,19456,4471,33501,509,243,266
51865,40195,6691,19456,4471,33504,509,243,266
51870,40200,6691,19457,4471,33509,509,243,266
51875,40204,6691,19458,4471,33512,509,243,266
51880,40207,6692,19460,4472,33515,509,243,266
51885,40208,6692,19460,4472,33516,509,243,266
51890,40213,6693,19462,4472,33520,509,243,266
51895,40215,6694,19462,4472,33521,509,243,266
51900,40223,6696,19464,4473,33527,509,243,266
51905,40226,6696,19467,4473,33530,509,243,266
51910,40231,6696,19468,4473,33535,509,243,266
51915,40235,6696,19470,4473,33538,509,243,266
51920,40238,6697,19470,4474,33541,509,243,266
51925,40239,6698,19471,4475,33541,509,243,266
51930,40244,6699,19475,4476,33545,509,243,266
51935,40246,6699,19476,4476,33547,509,243,266
51940,40254,6701,19481,4478,33553,509,243,266
51945,40257,6701,19482,4478,33556,509,243,266
51950,40262,6702,19484,4479,33560,510,244,266
51955,40266,6702,19487,4479,33563,510,244,266
51960,40269,6703,19487,4480,33566,510,244,266
51965,40270,6703,19487,4480,33567,510,244,266
51970,40275,6703,19490,4480,33572,510,244,266
51975,40277,6704,19490,4480,33573,510,244,266
51980,40285,6705,19494,4481,33580,510,244,266
51985,40288,6705,19495,4481,33583,510,244,266
51990,40293,6706,19496,4481,33587,510,244,266
51995,40297,6706,19497,4481,33591,510,244,266
52000,40300,6707,19500,4482,33593,510,244,266
52005,40301,6707,19501,4482,33594,510,244,266
52010,40306,6707,19505,4482,33598,510,244,266
52015,40308,6709,19506,4484,33599,510,244,266
52020,40316,6710,19511,4484,33606,510,244,266
52025,40319,6710,19512,4484,33609,510,244,266
52030,40324,6711,19514,4484,33613,510,244,266
52035,40328,6711,19516,4484,33617,510,244,266
52040,40331,6711,19517,4484,33620,510,244,266
52045,40332,6711,19517,4484,33621,510,244,266
52050,40337,6711,19519,4484,33626,510,244,266
52055,40339,6712,19520,4484,33627,510,244,266
52060,40347,6713,19524,4484,33634,510,244,266
52065,40350,6713,19527,4484,33637,510,244,266
52070,40355,6714,19531,4485,33641,511,245,266
52075,40359,6714,19533,4485,33645,511,245,266
52080,40362,6715,19535,4486,33647,511,245,266
52085,40363,6715,19535,4486,33648,511,245,266
52090,40368,6716,19537,4486,33652,511,245,266
52095,40370,6717,19537,4486,33653,511,245,266
52100,40378,6718,19538,4486,33660,511,245,266
52105,40381,6718,19538,4486,33663,511,245,266
52110,40386,6719,19541,4487,33667,512,246,266
52115,40390,6719,19543,4487,33670,512,246,266
52120,40393,6720,19545,4488,33673,512,246,266
52125,40394,6721,19546,4489,33673,512,246,266
52130,40399,6722,19547,4489,33677,512,246,266
52135,40401,6723,19549,4490,33678,512,246,266
52140,40409,6725,19553,4492,33684,512,246,266
52145,40412,6725,19554,4492,33687,512,246,266
52150,40417,6726,19556,4493,33691,512,246,266
52155,40421,6726,19556,4493,33695,512,246,266
52160,40424,6726,19558,4493,33698,512,246,266
52165,40425,6726,19559,4493,33699,512,246,266
52170,40430,6726,19560,4493,33704,512,246,266
52175,40432,6727,19561,4493,33705,512,246,266
52180,40440,6728,19563,4493,33712,512,246,266
52185,40443,6729,19564,4494,33714,512,246,266
52190,40448,6730,19566,4494,33718,512,246,266
52195,40452,6730,19568,4494,33722,512,246,266
52200,40455,6731,19570,4495,33724,512,246,266
52205,40456,6731,19571,4495,33725,512,246,266
52210,40461,6731,19574,4495,33729,512,246,266
52215,40463,6733,19575,4496,33730,512,246,266
52220,40471,6734,19582,4496,33737,512,246,266
52225,40474,6735,19583,4497,33739,512,246,266
52230,40479,6736,19586,4497,33743,512,246,266
52235,40483,6736,19587,4497,33747,512,246,266
52240,40486,6736,19588,4497,33750,512,246,266
52245,40487,6736,19589,4497,33751,512,246,266
52250,40492,6737,19592,4498,33755,512,246,266
52255,40494,6738,19593,4498,33756,512,246,266
52260,40502,6739,19598,4498,33763,512,246,266
52265,40505,6739,19598,4498,33766,512,246,266
52270,40510,6740,19601,4498,33770,513,247,266
52275,40514,6740,19602,4498,33774,513,247,266
52280,40517,6741,19604,4499,33776,513,247,266
52285,40518,6741,19604,4499,33777,513,247,266
52290,40523,6742,19605,4499,33781,513,247,266
52295,40525,6742,19606,4499,33783,513,247,266
52300,40533,6743,19609,4499,33790,513,247,266
52305,40536,6743,19610,4499,33793,513,247,266
52310,40541,6744,19610,4499,33797,514,247,267
52315,40545,6744,19611,4499,33801,514,247,267
52320,40548,6744,19612,4499,33804,514,247,267
52325,40549,6745,19613,4500,33804,514,247,267
52330,40554,6746,19615,4500,33808,514,247,267
52335,40556,6746,19615,4500,33810,514,247,267
52340,40564,6748,19619,4501,33816,514,247,267
52345,40567,6749,19621,4502,33818,514,247,267
52350,40572,6750,19625,4503,33822,514,247,267
52355,40576,6750,19626,4503,33826,514,247,267
52360,40579,6750,19628,4503,33829,514,247,267
52365,40580,6751,19629,4504,33829,514,247,267
52370,40585,6752,19632,4505,33833,514,247,267
52375,40587,6753,19632,4505,33834,514,247,267
52380,40595,6754,19635,4505,33841,514,247,267
52385,40598,6754,19637,4505,33844,514,247,267
52390,40603,6755,19638,4506,33848,514,247,267
52395,40607,6755,19641,4506,33852,514,247,267
52400,40610,6756,19642,4507,33854,514,247,267
52405,40611,6756,19642,4507,33855,514,247,267
52410,40616,6757,19644,4508,33859,514,247,267
52415,40618,6758,19646,4509,33860,514,247,267
52420,40626,6760,19650,4511,33866,514,247,267
52425,40629,6760,19653,4511,33869,514,247,267
52430,40634,6761,19654,4511,33873,515,247,268
52435,40638,6761,19654,4511,33877,515,247,268
52440,40641,6761,19655,4511,33880,515,247,268
52445,40642,6762,19656,4512,33880,515,247,268
52450,40647,6763,19658,4512,33883,515,247,268
52455,40649,6765,19659,4514,33884,515,247,268
52460,40657,6766,19664,4514,33891,515,247,268
52465,40660,6766,19664,4514,33894,515,247,268
52470,40665,6767,19665,4514,33898,516,248,268
52475,40669,6767,19667,4514,33902,516,248,268
52480,40672,6767,19667,4514,33905,516,248,268
52485,40673,6767,19667,4514,33906,516,248,268
52490,40678,6768,19669,4515,33910,516,248,268
52495,40680,6769,19670,4515,33911,516,248,268
52500,40688,6770,19672,4515,33918,516,248,268
52505,40691,6770,19674,4515,33921,516,248,268
52510,40696,6771,19677,4516,33925,517,249,268
52515,40700,6771,19678,4516,33929,517,249,268
52520,40703,6771,19680,4516,33932,517,249,268
52525,40704,6771,19680,4516,33933,517,249,268
52530,40709,6771,19681,4516,33938,517,249,268
52535,40711,6772,19681,4516,33939,517,249,268
52540,40719,6773,19683,4516,33946,517,249,268
52545,40722,6774,19686,4517,33948,517,249,268
52550,40727,6775,19688,4518,33952,518,250,268
52555,40731,6775,19691,4518,33956,518,250,268
52560,40734,6775,19691,4518,33959,518,250,268
52565,40735,6775,19691,4518,33960,518,250,268
52570,40740,6775,19694,4518,33964,518,250,268
52575,40742,6777,19696,4520,33965,518,250,268
52580,40750,6778,19699,4520,33972,518,250,268
52585,40753,6778,19699,4520,33975,518,250,268
52590,40758,6779,19702,4520,33979,518,250,268
52595,40762,6779,19704,4520,33983,518,250,268
52600,40765,6779,19705,4520,33986,518,250,268
52605,40766,6779,19705,4520,33987,518,250,268
52610,40771,6780,19709,4520,33990,518,250,268
52615,40773,6782,19711,4522,33991,518,250,268
52620,40781,6784,19714,4524,33997,518,250,268
52625,40784,6785,19716,4525,33999,518,250,268
52630,40789,6786,19720,4526,34003,518,250,268
52635,40793,6786,19724,4526,34006,518,250,268
52640,40796,6787,19725,4527,34009,518,250,268
52645,40797,6787,19726,4527,34010,518,250,268
52650,40802,6788,19727,4528,34014,518,250,268
52655,40804,6789,19729,4529,34015,518,250,268
52660,40812,6790,19730,4529,34022,518,250,268
52665,40815,6790,19732,4529,34025,518,250,268
52670,40820,6791,19733,4529,34029,518,250,268
52675,40824,6791,19734,4529,34032,518,250,268
52680,40827,6792,19736,4530,34035,518,250,268
52685,40828,6792,19737,4530,34036,518,250,268
52690,40833,6793,19738,4530,34039,518,250,268
52695,40835,6795,19739,4531,34040,518,250,268
52700,40843,6796,19742,4531,34047,518,250,268
52705,40846,6796,19745,4531,34050,518,250,268
52710,40851,6797,19748,4532,34054,519,251,268
52715,40855,6797,19751,4532,34058,519,251,268
52720,40858,6797,19753,4532,34061,519,251,268
52725,40859,6798,19754,4533,34061,519,251,268
52730,40864,6799,19757,4533,34065,519,251,268
52735,40866,6800,19757,4533,34066,519,251,268
52740,40874,6801,19761,4533,34073,519,251,268
52745,40877,6801,19763,4533,34076,519,251,268
52750,40882,6802,19765,4533,34080,519,251,268
52755,40886,6802,19767,4533,34084,519,251,268
52760,40889,6802,19768,4533,34087,519,251,268
52765,40890,6803,19769,4534,34087,519,251,268
52770,40895,6804,19772,4535,34091,519,251,268
52775,40897,6805,19773,4536,34092,519,251,268
52780,40905,6806,19776,4536,34099,519,251,268
52785,40908,6806,19778,4536,34102,519,251,268
52790,40913,6807,19781,4536,34106,519,251,268
52795,40917,6807,19783,4536,34109,519,251,268
52800,40920,6809,19784,4538,34111,519,251,268
52805,40921,6809,19785,4538,34112,519,251,268
52810,40926,6809,19788,4538,34117,519,251,268
52815,40928,6809,19789,4538,34119,519,251,268
52820,40936,6810,19792,4539,34126,519,251,268
52825,40939,6811,19795,4540,34128,519,251,268
52830,40944,6812,19799,4541,34132,519,251,268
52835,40948,6812,19801,4541,34136,519,251,268
52840,40951,6812,19802,4541,34139,519,251,268
52845,40952,6812,19802,4541,34140,519,251,268
52850,40957,6812,19804,4541,34145,519,251,268
52855,40959,6812,19804,4541,34147,519,251,268
52860,40967,6813,19807,4541,34154,519,251,268
52865,40970,6813,19808,4541,34157,519,251,268
52870,40975,6814,19811,4542,34161,519,251,268
52875,40979,6814,19812,4542,34165,519,251,268
52880,40982,6814,19812,4542,34168,519,251,268
52885,40983,6814,19813,4542,34169,519,251,268
52890,40988,6814,19816,4542,34174,519,251,268
52895,40990,6814,19818,4542,34176,519,251,268
52900,40998,6815,19822,4542,34183,519,251,268
52905,41001,6815,19823,4542,34186,519,251,268
52910,41006,6816,19827,4543,34190,519,251,268
52915,41010,6816,19829,4543,34194,519,251,268
52920,41013,6816,19829,4543,34197,519,251,268
52925,41014,6817,19830,4544,34197,519,251,268
52930,41019,6818,19831,4544,34201,519,251,268
52935,41021,6819,19833,4545,34202,519,251,268
52940,41029,6821,19839,4547,34208,519,251,268
52945,41032,6821,19841,4547,34211,519,251,268
52950,41037,6822,19846,4548,34215,520,252,268
52955,41041,6822,19847,4548,34219,520,252,268
52960,41044,6823,19849,4549,34221,520,252,268
52965,41045,6824,19850,4550,34221,520,252,268
52970,41050,6825,19853,4551,34224,520,252,268
52975,41052,6827,19854,4552,34225,520,252,268
52980,41060,6829,19859,4554,34231,520,252,268
52985,41063,6829,19862,4554,34234,520,252,268
52990,41068,6829,19864,4554,34239,521,253,268
52995,41072,6829,19865,4554,34242,521,253,268
53000,41075,6831,19868,4556,34244,521,253,268
53005,41076,6831,19868,4556,34245,521,253,268
53010,41081,6832,19871,4557,34248,521,253,268
53015,41083,6834,19872,4558,34249,521,253,268
53020,41091,6836,19877,4559,34255,521,253,268
53025,41094,6836,19879,4559,34258,521,253,268
53030,41099,6836,19881,4559,34263,522,253,269
53035,41103,6836,19882,4559,34267,522,253,269
53040,41106,6837,19883,4560,34269,522,253,269
53045,41107,6838,19884,4561,34269,522,253,269
53050,41112,6839,19887,4562,34273,522,253,269
53055,41114,6839,19889,4562,34275,522,253,269
53060,41122,6841,19894,4564,34281,522,253,269
53065,41125,6842,19896,4565,34283,522,253,269
53070,41130,6842,19899,4565,34288,523,254,269
53075,41134,6842,19901,4565,34292,523,254,269
53080,41137,6842,19902,4565,34295,523,254,269
53085,41138,6842,19902,4565,34296,523,254,269
53090,41143,6843,19906,4566,34300,523,254,269
53095,41145,6843,19908,4566,34302,523,254,269
53100,41153,6846,19911,4568,34307,523,254,269
53105,41156,6846,19912,4568,34310,523,254,269
53110,41161,6847,19915,4569,34314,523,254,269
53115,41165,6847,19917,4569,34318,523,254,269
53120,41168,6847,19919,4569,34321,523,254,269
53125,41169,6847,19919,4569,34322,523,254,269
53130,41174,6847,19924,4569,34326,523,254,269
53135,41176,6849,19925,4571,34327,523,254,269
53140,41184,6851,19932,4573,34333,523,254,269
53145,41187,6852,19934,4574,34335,523,254,269
53150,41192,6853,19938,4575,34339,523,254,269
53155,41196,6853,19941,4575,34343,523,254,269
53160,41199,6854,19943,4576,34345,523,254,269
53165,41200,6854,19943,4576,34346,523,254,269
53170,41205,6854,19945,4576,34350,523,254,269
53175,41207,6856,19946,4578,34351,523,254,269
53180,41215,6857,19948,4578,34358,523,254,269
53185,41218,6857,19950,4578,34361,523,254,269
53190,41223,6858,19954,4579,34365,524,255,269
53195,41227,6858,19954,4579,34369,524,255,269
53200,41230,6859,19957,4580,34371,524,255,269
53205,41231,6859,19958,4580,34372,524,255,269
53210,41236,6860,19961,4581,34375,524,255,269
53215,41238,6862,19961,4582,34376,524,255,269
53220,41246,6863,19963,4583,34383,524,255,269
53225,41249,6863,19964,4583,34386,524,255,269
53230,41254,6864,19967,4583,34390,525,256,269
53235,41258,6864,19968,4583,34394,525,256,269
53240,41261,6864,19971,4583,34397,525,256,269
53245,41262,6865,19972,4584,34397,525,256,269
53250,41267,6866,19973,4584,34401,525,256,269
53255,41269,6867,19974,4585,34402,525,256,269
53260,41277,6869,19979,4587,34408,525,256,269
53265,41280,6869,19980,4587,34411,525,256,269
53270,41285,6870,19982,4588,34415,526,257,269
53275,41289,6870,19985,4588,34418,526,257,269
53280,41292,6871,19988,4589,34421,526,257,269
53285,41293,6871,19988,4589,34422,526,257,269
53290,41298,6872,19989,4590,34426,526,257,269
53295,41300,6873,19990,4590,34427,526,257,269
53300,41308,6875,19993,4591,34433,526,257,269
53305,41311,6875,19994,4591,34436,526,257,269
53310,41316,6876,19996,4591,34440,526,257,269
53315,41320,6876,19998,4591,34443,526,257,269
53320,41323,6877,19998,4592,34446,526,257,269
53325,41324,6877,19998,4592,34447,526,257,269
53330,41329,6878,20001,4593,34450,526,257,269
53335,41331,6880,20003,4595,34451,526,257,269
53340,41339,6883,20009,4598,34456,526,257,269
53345,41342,6883,20010,4598,34459,526,257,269
53350,41347,6883,20014,4598,34464,526,257,269
53355,41351,6883,20015,4598,34468,526,257,269
53360,41354,6883,20016,4598,34471,526,257,269
53365,41355,6883,20017,4598,34472,526,257,269
53370,41360,6883,20019,4598,34477,526,257,269
53375,41362,6883,20020,4598,34479,526,257,269
53380,41370,6884,20024,4599,34486,526,257,269
53385,41373,6884,20025,4599,34489,526,257,269
53390,41378,6884,20027,4599,34494,527,257,270
53395,41382,6884,20031,4599,34498,527,257,270
53400,41385,6884,20032,4599,34501,527,257,270
53405,41386,6884,20032,4599,34502,527,257,270
53410,41391,6884,20034,4599,34507,527,257,270
53415,41393,6884,20035,4599,34509,527,257,270
53420,41401,6885,20036,4599,34516,527,257,270
53425,41404,6885,20037,4599,34519,527,257,270
53430,41409,6885,20038,4599,34524,528,257,271
53435,41413,6885,20040,4599,34528,528,257,271
53440,41416,6885,20041,4599,34531,528,257,271
53445,41417,6885,20041,4599,34532,528,257,271
53450,41422,6886,20045,4600,34536,528,257,271
53455,41424,6887,20046,4601,34537,528,257,271
53460,41432,6889,20048,4602,34543,528,257,271
53465,41435,6890,20050,4603,34545,528,257,271
53470,41440,6891,20051,4603,34549,528,257,271
53475,41444,6891,20052,4603,34552,528,257,271
53480,41447,6892,20053,4604,34555,528,257,271
53485,41448,6892,20054,4604,34556,528,257,271
53490,41453,6893,20056,4605,34560,528,257,271
53495,41455,6894,20056,4605,34561,528,257,271
53500,41463,6895,20058,4606,34568,528,257,271
53505,41466,6895,20058,4606,34571,528,257,271
53510,41471,6896,20060,4607,34575,528,257,271
53515,41475,6896,20061,4607,34578,528,257,271
53520,41478,6897,20061,4608,34581,528,257,271
53525,41479,6898,20062,4609,34581,528,257,271
53530,41484,6899,20065,4610,34584,528,257,271
53535,41486,6901,20065,4611,34585,528,257,271
53540,41494,6903,20067,4612,34591,528,257,271
53545,41497,6904,20069,4613,34593,528,257,271
53550,41502,6905,20072,4614,34597,528,257,271
53555,41506,6905,20075,4614,34601,528,257,271
53560,41509,6905,20076,4614,34604,528,257,271
53565,41510,6905,20076,4614,34605,528,257,271
53570,41515,6906,20078,4615,34609,528,257,271
53575,41517,6907,20080,4616,34610,528,257,271
53580,41525,6909,20084,4617,34616,528,257,271
53585,41528,6910,20085,4618,34618,528,257,271
53590,41533,6911,20089,4619,34622,528,257,271
53595,41537,6911,20091,4619,34626,528,257,271
53600,41540,6911,20092,4619,34629,528,257,271
53605,41541,6911,20092,4619,34630,528,257,271
53610,41546,6912,20095,4619,34633,528,257,271
53615,41548,6914,20095,4620,34634,528,257,271
53620,41556,6915,20099,4620,34641,528,257,271
53625,41559,6915,20101,4620,34644,528,257,271
53630,41564,6916,20105,4621,34648,528,257,271
53635,41568,6916,20106,4621,34652,528,257,271
53640,41571,6917,20108,4622,34654,528,257,271
53645,41572,6917,20108,4622,34655,528,257,271
53650,41577,6918,20110,4622,34659,528,257,271
53655,41579,6918,20110,4622,34661,528,257,271
53660,41587,6919,20116,4623,34668,528,257,271
53665,41590,6919,20119,4623,34671,528,257,271
53670,41595,6920,20122,4623,34675,528,257,271
53675,41599,6920,20125,4623,34678,528,257,271
53680,41602,6922,20128,4625,34680,528,257,271
53685,41603,6922,20128,4625,34681,528,257,271
53690,41608,6923,20132,4626,34685,528,257,271
53695,41610,6923,20133,4626,34687,528,257,271
53700,41618,6925,20137,4627,34693,528,257,271
53705,41621,6925,20139,4627,34696,528,257,271
53710,41626,6926,20142,4627,34700,528,257,271
53715,41630,6926,20143,4627,34704,528,257,271
53720,41633,6926,20144,4627,34707,528,257,271
53725,41634,6926,20144,4627,34708,528,257,271
53730,41639,6927,20147,4627,34712,528,257,271
53735,41641,6927,20149,4627,34714,528,257,271
53740,41649,6928,20151,4628,34721,528,257,271
53745,41652,6929,20153,4629,34723,528,257,271
53750,41657,6930,20154,4630,34727,528,257,271
53755,41661,6930,20156,4630,34730,528,257,271
53760,41664,6931,20158,4631,34733,528,257,271
53765,41665,6931,20158,4631,34734,528,257,271
53770,41670,6932,20160,4631,34738,528,257,271
53775,41672,6933,20161,4632,34739,528,257,271
53780,41680,6934,20167,4633,34746,528,257,271
53785,41683,6934,20168,4633,34749,528,257,271
53790,41688,6934,20171,4633,34754,528,257,271
53795,41692,6934,20173,4633,34758,528,257,271
53800,41695,6934,20174,4633,34761,528,257,271
53805,41696,6934,20174,4633,34762,528,257,271
53810,41701,6935,20177,4633,34765,528,257,271
53815,41703,6937,20178,4635,34766,528,257,271
53820,41711,6938,20184,4636,34773,528,257,271
53825,41714,6938,20186,4636,34776,528,257,271
53830,41719,6938,20188,4636,34781,529,258,271
53835,41723,6938,20190,4636,34785,529,258,271
53840,41726,6938,20192,4636,34788,529,258,271
53845,41727,6939,20193,4637,34788,529,258,271
53850,41732,6940,20196,4638,34791,529,258,271
53855,41734,6942,20197,4639,34792,529,258,271
53860,41742,6943,20202,4640,34799,529,258,271
53865,41745,6943,20203,4640,34802,529,258,271
53870,41750,6943,20206,4640,34807,530,258,272
53875,41754,6943,20208,4640,34811,530,258,272
53880,41757,6943,20209,4640,34814,530,258,272
53885,41758,6944,20210,4641,34814,530,258,272
53890,41763,6945,20213,4642,34818,530,258,272
53895,41765,6946,20215,4643,34819,530,258,272
53900,41773,6948,20218,4644,34825,530,258,272
53905,41776,6948,20219,4644,34828,530,258,272
53910,41781,6949,20221,4645,34832,530,258,272
53915,41785,6949,20222,4645,34836,530,258,272
53920,41788,6949,20224,4645,34839,530,258,272
53925,41789,6950,20225,4646,34839,530,258,272
53930,41794,6951,20226,4646,34843,530,258,272
53935,41796,6952,20226,4646,34844,530,258,272
53940,41804,6953,20228,4646,34851,530,258,272
53945,41807,6953,20231,4646,34854,530,258,272
53950,41812,6954,20234,4646,34858,531,258,273
53955,41816,6954,20235,4646,34862,531,258,273
53960,41819,6954,20236,4646,34865,531,258,273
53965,41820,6954,20236,4646,34866,531,258,273
53970,41825,6954,20238,4646,34871,531,258,273
53975,41827,6955,20239,4647,34872,531,258,273
53980,41835,6957,20243,4649,34878,531,258,273
53985,41838,6957,20245,4649,34881,531,258,273
53990,41843,6958,20248,4649,34885,532,259,273
53995,41847,6958,20250,4649,34889,532,259,273
54000,41850,6958,20251,4649,34892,532,259,273
54005,41851,6959,20252,4650,34892,532,259,273
54010,41856,6960,20254,4650,34895,532,259,273
54015,41858,6962,20255,4651,34896,532,259,273
54020,41866,6964,20259,4652,34902,532,259,273
54025,41869,6964,20260,4652,34905,532,259,273
54030,41874,6965,20263,4652,34909,532,259,273
54035,41878,6965,20265,4652,34913,532,259,273
54040,41881,6965,20265,4652,34916,532,259,273
54045,41882,6966,20266,4653,34916,532,259,273
54050,41887,6967,20268,4653,34919,532,259,273
54055,41889,6969,20269,4654,34920,532,259,273
54060,41897,6971,20274,4656,34926,532,259,273
54065,41900,6971,20275,4656,34929,532,259,273
54070,41905,6972,20276,4656,34933,532,259,273
54075,41909,6972,20278,4656,34936,532,259,273
54080,41912,6973,20281,4657,34939,532,259,273
54085,41913,6973,20281,4657,34940,532,259,273
54090,41918,6974,20284,4657,34943,532,259,273
54095,41920,6976,20285,4659,34944,532,259,273
54100,41928,6977,20289,4659,34951,532,259,273
54105,41931,6977,20290,4659,34954,532,259,273
54110,41936,6978,20291,4659,34958,532,259,273
54115,41940,6978,20294,4659,34961,532,259,273
54120,41943,6979,20295,4660,34964,532,259,273
54125,41944,6979,20296,4660,34965,532,259,273
54130,41949,6979,20298,4660,34969,532,259,273
54135,41951,6981,20298,4661,34970,532,259,273
54140,41959,6982,20301,4662,34977,532,259,273
54145,41962,6982,20301,4662,34980,532,259,273
54150,41967,6983,20303,4662,34984,532,259,273
54155,41971,6983,20304,4662,34988,532,259,273
54160,41974,6983,20307,4662,34991,532,259,273
54165,41975,6983,20307,4662,34992,532,259,273
54170,41980,6983,20310,4662,34996,532,259,273
54175,41982,6985,20311,4663,34997,532,259,273
54180,41990,6987,20316,4664,35003,532,259,273
54185,41993,6987,20317,4664,35006,532,259,273
54190,41998,6988,20321,4665,35010,532,259,273
54195,42002,6988,20322,4665,35014,532,259,273
54200,42005,6988,20324,4665,35017,532,259,273
54205,42006,6988,20325,4665,35018,532,259,273
54210,42011,6988,20327,4665,35023,532,259,273
54215,42013,6989,20328,4665,35024,532,259,273
54220,42021,6990,20330,4665,35031,532,259,273
54225,42024,6990,20332,4665,35034,532,259,273
54230,42029,6991,20333,4665,35038,533,260,273
54235,42033,6991,20335,4665,35041,533,260,273
54240,42036,6993,20336,4667,35043,533,260,273
54245,42037,6993,20336,4667,35044,533,260,273
54250,42042,6994,20339,4667,35048,533,260,273
54255,42044,6994,20340,4667,35050,533,260,273
54260,42052,6995,20343,4667,35057,533,260,273
54265,42055,6995,20344,4667,35060,533,260,273
54270,42060,6995,20346,4667,35065,533,260,273
54275,42064,6995,20349,4667,35068,533,260,273
54280,42067,6996,20352,4668,35071,533,260,273
54285,42068,6997,20353,4669,35071,533,260,273
54290,42073,6998,20355,4669,35075,533,260,273
54295,42075,6998,20356,4669,35077,533,260,273
54300,42083,7000,20358,4671,35083,533,260,273
54305,42086,7000,20359,4671,35086,533,260,273
54310,42091,7000,20361,4671,35091,533,260,273
54315,42095,7000,20363,4671,35095,533,260,273
54320,42098,7000,20364,4671,35098,533,260,273
54325,42099,7000,20364,4671,35099,533,260,273
54330,42104,7000,20367,4671,35104,533,260,273
54335,42106,7000,20368,4671,35106,533,260,273
54340,42114,7002,20372,4673,35112,533,260,273
54345,42117,7003,20373,4674,35114,533,260,273
54350,42122,7004,20376,4674,35118,534,261,273
54355,42126,7004,20377,4674,35121,534,261,273
54360,42129,7005,20378,4675,35124,534,261,273
54365,42130,7005,20378,4675,35125,534,261,273
54370,42135,7005,20382,4675,35130,534,261,273
54375,42137,7005,20383,4675,35132,534,261,273
54380,42145,7006,20387,4675,35139,534,261,273
54385,42148,7006,20387,4675,35142,534,261,273
54390,42153,7007,20390,4675,35146,534,261,273
54395,42157,7007,20392,4675,35149,534,261,273
54400,42160,7008,20394,4676,35152,534,261,273
54405,42161,7008,20394,4676,35153,534,261,273
54410,42166,7009,20396,4676,35157,534,261,273
54415,42168,7009,20397,4676,35159,534,261,273
54420,42176,7011,20402,4677,35165,534,261,273
54425,42179,7012,20405,4678,35167,534,261,273
54430,42184,7013,20408,4679,35171,534,261,273
54435,42188,7013,20411,4679,35174,534,261,273
54440,42191,7014,20414,4680,35177,534,261,273
54445,42192,7014,20414,4680,35178,534,261,273
54450,42197,7015,20416,4681,35182,534,261,273
54455,42199,7015,20417,4681,35184,534,261,273
54460,42207,7016,20420,4681,35191,534,261,273
54465,42210,7017,20423,4682,35193,534,261,273
54470,42215,7018,20427,4683,35197,535,262,273
54475,42219,7018,20429,4683,35200,535,262,273
54480,42222,7020,20431,4685,35202,535,262,273
54485,42223,7021,20432,4686,35202,535,262,273
54490,42228,7022,20433,4686,35205,535,262,273
54495,42230,7024,20435,4688,35206,535,262,273
54500,42238,7025,20440,4689,35213,535,262,273
54505,42241,7025,20442,4689,35216,535,262,273
54510,42246,7025,20445,4689,35221,535,262,273
54515,42250,7025,20446,4689,35225,535,262,273
54520,42253,7025,20447,4689,35228,535,262,273
54525,42254,7025,20448,4689,35229,535,262,273
54530,42259,7026,20450,4689,35233,535,262,273
54535,42261,7027,20450,4689,35234,535,262,273
54540,42269,7028,20452,4689,35241,535,262,273
54545,42272,7028,20455,4689,35244,535,262,273
54550,42277,7028,20458,4689,35249,535,262,273
54555,42281,7028,20461,4689,35252,535,262,273
54560,42284,7029,20461,4690,35255,535,262,273
54565,42285,7030,20462,4691,35255,535,262,273
54570,42290,7031,20465,4691,35258,535,262,273
54575,42292,7033,20466,4693,35259,535,262,273
54580,42300,7034,20470,4693,35266,535,262,273
54585,42303,7034,20471,4693,35269,535,262,273
54590,42308,7035,20471,4693,35273,536,262,274
54595,42312,7035,20474,4693,35277,536,262,274
54600,42315,7035,20475,4693,35280,536,262,274
54605,42316,7035,20476,4693,35281,536,262,274
54610,42321,7035,20478,4693,35286,536,262,274
54615,42323,7036,20479,4694,35287,536,262,274
54620,42331,7038,20484,4696,35293,536,262,274
54625,42334,7038,20486,4696,35296,536,262,274
54630,42339,7039,20489,4696,35300,537,263,274
54635,42343,7039,20492,4696,35304,537,263,274
54640,42346,7039,20493,4696,35307,537,263,274
54645,42347,7039,20493,4696,35308,537,263,274
54650,42352,7039,20495,4696,35312,537,263,274
54655,42354,7041,20496,4697,35313,537,263,274
54660,42362,7043,20499,4699,35319,537,263,274
54665,42365,7043,20500,4699,35322,537,263,274
54670,42370,7044,20503,4699,35326,538,264,274
54675,42374,7044,20504,4699,35330,538,264,274
54680,42377,7044,20505,4699,35333,538,264,274
54685,42378,7044,20506,4699,35334,538,264,274
54690,42383,7044,20508,4699,35339,538,264,274
54695,42385,7045,20509,4700,35340,538,264,274
54700,42393,7046,20512,4701,35347,538,264,274
54705,42396,7046,20512,4701,35350,538,264,274
54710,42401,7047,20515,4701,35354,539,265,274
54715,42405,7047,20517,4701,35358,539,265,274
54720,42408,7048,20519,4702,35360,539,265,274
54725,42409,7048,20520,4702,35361,539,265,274
54730,42414,7049,20522,4703,35365,539,265,274
54735,42416,7049,20523,4703,35367,539,265,274
54740,42424,7050,20527,4704,35374,539,265,274
54745,42427,7050,20527,4704,35377,539,265,274
54750,42432,7051,20530,4705,35381,539,265,274
54755,42436,7051,20530,4705,35385,539,265,274
54760,42439,7051,20531,4705,35388,539,265,274
54765,42440,7051,20531,4705,35389,539,265,274
54770,42445,7052,20534,4705,35393,539,265,274
54775,42447,7052,20536,4705,35395,539,265,274
54780,42455,7055,20543,4708,35400,539,265,274
54785,42458,7055,20544,4708,35403,539,265,274
54790,42463,7056,20545,4708,35407,539,265,274
54795,42467,7056,20548,4708,35411,539,265,274
54800,42470,7057,20551,4709,35413,539,265,274
54805,42471,7057,20551,4709,35414,539,265,274
54810,42476,7058,20553,4709,35418,539,265,274
54815,42478,7058,20554,4709,35420,539,265,274
54820,42486,7058,20556,4709,35428,539,265,274
54825,42489,7058,20557,4709,35431,539,265,274
54830,42494,7059,20559,4709,35435,540,266,274
54835,42498,7059,20561,4709,35438,540,266,274
54840,42501,7060,20563,4710,35441,540,266,274
54845,42502,7061,20564,4711,35441,540,266,274
54850,42507,7062,20566,4711,35444,540,266,274
54855,42509,7064,20566,4712,35445,540,266,274
54860,42517,7064,20570,4712,35453,540,266,274
54865,42520,7064,20572,4712,35456,540,266,274
54870,42525,7065,20574,4712,35460,540,266,274
54875,42529,7065,20577,4712,35463,540,266,274
54880,42532,7066,20580,4713,35466,540,266,274
54885,42533,7066,20580,4713,35467,540,266,274
54890,42538,7067,20584,4714,35470,540,266,274
54895,42540,7069,20584,4715,35471,540,266,274
54900,42548,7070,20589,4716,35478,540,266,274
54905,42551,7070,20590,4716,35481,540,266,274
54910,42556,7071,20594,4717,35485,540,266,274
54915,42560,7071,20594,4717,35489,540,266,274
54920,42563,7071,20595,4717,35492,540,266,274
54925,42564,7071,20595,4717,35493,540,266,274
54930,42569,7072,20598,4718,35497,540,266,274
54935,42571,7073,20599,4718,35498,540,266,274
54940,42579,7075,20605,4719,35504,540,266,274
54945,42582,7075,20607,4719,35507,540,266,274
54950,42587,7076,20610,4719,35511,540,266,274
54955,42591,7076,20612,4719,35515,540,266,274
54960,42594,7077,20615,4720,35517,540,266,274
54965,42595,7077,20615,4720,35518,540,266,274
54970,42600,7077,20619,4720,35522,540,266,274
54975,42602,7079,20620,4721,35523,540,266,274
54980,42610,7080,20620,4721,35530,540,266,274
54985,42613,7080,20620,4721,35533,540,266,274
54990,42618,7081,20622,4721,35537,540,266,274
54995,42622,7081,20623,4721,35541,540,266,274
55000,42625,7081,20623,4721,35544,540,266,274
55005,42626,7081,20624,4721,35545,540,266,274
55010,42631,7081,20625,4721,35550,540,266,274
55015,42633,7082,20625,4721,35551,540,266,274
55020,42641,7084,20632,4723,35557,540,266,274
55025,42644,7084,20635,4723,35560,540,266,274
55030,42649,7085,20635,4723,35564,540,266,274
55035,42653,7085,20637,4723,35568,540,266,274
55040,42656,7085,20639,4723,35571,540,266,274
55045,42657,7085,20640,4723,35572,540,266,274
55050,42662,7085,20644,4723,35576,540,266,274
55055,42664,7087,20645,4725,35577,540,266,274
55060,42672,7089,20649,4726,35583,540,266,274
55065,42675,7089,20651,4726,35586,540,266,274
55070,42680,7090,20651,4726,35590,541,266,275
55075,42684,7090,20653,4726,35593,541,266,275
55080,42687,7091,20653,4727,35596,541,266,275
55085,42688,7092,20654,4728,35596,541,266,275
55090,42693,7093,20656,4728,35600,541,266,275
55095,42695,7094,20657,4729,35601,541,266,275
55100,42703,7095,20659,4729,35608,541,266,275
55105,42706,7095,20661,4729,35611,541,266,275
55110,42711,7096,20665,4730,35615,541,266,275
55115,42715,7096,20667,4730,35619,541,266,275
55120,42718,7096,20668,4730,35622,541,266,275
55125,42719,7096,20668,4730,35623,541,266,275
55130,42724,7097,20669,4730,35627,541,266,275
55135,42726,7098,20671,4731,35628,541,266,275
55140,42734,7099,20676,4732,35635,541,266,275
55145,42737,7100,20678,4733,35637,541,266,275
55150,42742,7101,20681,4734,35641,541,266,275
55155,42746,7101,20684,4734,35645,541,266,275
55160,42749,7101,20686,4734,35648,541,266,275
55165,42750,7102,20687,4735,35648,541,266,275
55170,42755,7103,20687,4735,35652,541,266,275
55175,42757,7104,20687,4735,35653,541,266,275
55180,42765,7105,20691,4735,35660,541,266,275
55185,42768,7106,20693,4736,35662,541,266,275
55190,42773,7107,20694,4736,35666,542,267,275
55195,42777,7107,20697,4736,35669,542,267,275
55200,42780,7108,20699,4737,35672,542,267,275
55205,42781,7108,20699,4737,35673,542,267,275
55210,42786,7109,20701,4737,35676,542,267,275
55215,42788,7111,20702,4739,35677,542,267,275
55220,42796,7113,20707,4741,35683,542,267,275
55225,42799,7113,20708,4741,35686,542,267,275
55230,42804,7114,20709,4741,35690,543,267,276
55235,42808,7114,20712,4741,35693,543,267,276
55240,42811,7115,20713,4742,35696,543,267,276
55245,42812,7116,20714,4743,35696,543,267,276
55250,42817,7117,20718,4744,35699,543,267,276
55255,42819,7119,20718,4745,35700,543,267,276
55260,42827,7121,20723,4747,35706,543,267,276
55265,42830,7121,20724,4747,35709,543,267,276
55270,42835,7122,20726,4748,35713,543,267,276
55275,42839,7122,20729,4748,35716,543,267,276
55280,42842,7123,20730,4749,35719,543,267,276
55285,42843,7123,20731,4749,35720,543,267,276
55290,42848,7123,20734,4749,35725,543,267,276
55295,42850,7123,20736,4749,35727,543,267,276
55300,42858,7124,20741,4750,35734,543,267,276
55305,42861,7124,20742,4750,35737,543,267,276
55310,42866,7125,20745,4751,35741,543,267,276
55315,42870,7125,20748,4751,35745,543,267,276
55320,42873,7126,20751,4752,35747,543,267,276
55325,42874,7126,20751,4752,35748,543,267,276
55330,42879,7126,20753,4752,35752,543,267,276
55335,42881,7128,20754,4753,35753,543,267,276
55340,42889,7130,20757,4754,35759,543,267,276
55345,42892,7130,20757,4754,35762,543,267,276
55350,42897,7130,20759,4754,35767,543,267,276
55355,42901,7130,20760,4754,35771,543,267,276
55360,42904,7130,20761,4754,35774,543,267,276
55365,42905,7130,20762,4754,35775,543,267,276
55370,42910,7131,20762,4754,35779,543,267,276
55375,42912,7132,20763,4755,35780,543,267,276
55380,42920,7134,20767,4756,35786,543,267,276
55385,42923,7134,20768,4756,35789,543,267,276
55390,42928,7134,20771,4756,35794,543,267,276
55395,42932,7134,20774,4756,35797,543,267,276
55400,42935,7135,20774,4757,35800,543,267,276
55405,42936,7135,20775,4757,35801,543,267,276
55410,42941,7136,20777,4757,35804,543,267,276
55415,42943,7138,20778,4758,35805,543,267,276
55420,42951,7140,20782,4760,35811,543,267,276
55425,42954,7140,20784,4760,35814,543,267,276
55430,42959,7141,20787,4761,35818,543,267,276
55435,42963,7141,20790,4761,35821,543,267,276
55440,42966,7142,20791,4762,35824,543,267,276
55445,42967,7142,20791,4762,35825,543,267,276
55450,42972,7143,20792,4762,35829,543,267,276
55455,42974,7144,20792,4762,35830,543,267,276
55460,42982,7146,20794,4763,35836,543,267,276
55465,42985,7146,20794,4763,35839,543,267,276
55470,42990,7147,20794,4763,35843,543,267,276
55475,42994,7147,20796,4763,35847,543,267,276
55480,42997,7147,20797,4763,35850,543,267,276
55485,42998,7148,20798,4764,35850,543,267,276
55490,43003,7149,20800,4765,35854,543,267,276
55495,43005,7150,20800,4765,35855,543,267,276
55500,43013,7153,20805,4767,35860,543,267,276
55505,43016,7153,20807,4767,35863,543,267,276
55510,43021,7154,20809,4768,35867,543,267,276
55515,43025,7154,20812,4768,35871,543,267,276
55520,43028,7155,20814,4769,35873,543,267,276
55525,43029,7156,20815,4770,35873,543,267,276
55530,43034,7157,20817,4770,35877,543,267,276
55535,43036,7157,20817,4770,35879,543,267,276
55540,43044,7157,20823,4770,35887,543,267,276
55545,43047,7157,20824,4770,35890,543,267,276
55550,43052,7158,20825,4770,35894,543,267,276
55555,43056,7158,20827,4770,35898,543,267,276
55560,43059,7158,20827,4770,35901,543,267,276
55565,43060,7158,20827,4770,35902,543,267,276
55570,43065,7159,20830,4771,35906,543,267,276
55575,43067,7159,20831,4771,35908,543,267,276
55580,43075,7159,20833,4771,35916,543,267,276
55585,43078,7159,20835,4771,35919,543,267,276
55590,43083,7160,20838,4772,35923,543,267,276
55595,43087,7160,20839,4772,35927,543,267,276
55600,43090,7161,20842,4773,35929,543,267,276
55605,43091,7162,20843,4774,35929,543,267,276
55610,43096,7163,20845,4775,35933,543,267,276
55615,43098,7164,20845,4775,35934,543,267,276
55620,43106,7165,20848,4775,35941,543,267,276
55625,43109,7166,20851,4776,35943,543,267,276
55630,43114,7167,20853,4776,35947,543,267,276
55635,43118,7167,20853,4776,35951,543,267,276
55640,43121,7167,20853,4776,35954,543,267,276
55645,43122,7167,20853,4776,35955,543,267,276
55650,43127,7167,20854,4776,35960,543,267,276
55655,43129,7168,20855,4776,35961,543,267,276
55660,43137,7169,20858,4777,35968,543,267,276
55665,43140,7169,20859,4777,35971,543,267,276
55670,43145,7170,20861,4777,35975,543,267,276
55675,43149,7170,20863,4777,35978,543,267,276
55680,43152,7171,20864,4778,35981,543,267,276
55685,43153,7171,20864,4778,35982,543,267,276
55690,43158,7171,20868,4778,35986,543,267,276
55695,43160,7173,20868,4779,35987,543,267,276
55700,43168,7175,20869,4780,35993,543,267,276
55705,43171,7175,20871,4780,35996,543,267,276
55710,43176,7176,20874,4781,36000,543,267,276
55715,43180,7176,20877,4781,36004,543,267,276
55720,43183,7176,20879,4781,36007,543,267,276
55725,43184,7176,20879,4781,36008,543,267,276
55730,43189,7177,20882,4782,36011,543,267,276
55735,43191,7179,20883,4783,36012,543,267,276
55740,43199,7180,20887,4784,36019,543,267,276
55745,43202,7180,20889,4784,36022,543,267,276
55750,43207,7181,20891,4785,36026,543,267,276
55755,43211,7181,20893,4785,36030,543,267,276
55760,43214,7181,20894,4785,36033,543,267,276
55765,43215,7182,20895,4786,36033,543,267,276
55770,43220,7183,20899,4787,36036,543,267,276
55775,43222,7185,20899,4788,36037,543,267,276
55780,43230,7186,20900,4788,36044,543,267,276
55785,43233,7186,20900,4788,36047,543,267,276
55790,43238,7187,20902,4788,36051,543,267,276
55795,43242,7187,20903,4788,36055,543,267,276
55800,43245,7187,20904,4788,36058,543,267,276
55805,43246,7187,20904,4788,36059,543,267,276
55810,43251,7188,20905,4788,36063,543,267,276
55815,43253,7188,20905,4788,36065,543,267,276
55820,43261,7190,20911,4790,36071,543,267,276
55825,43264,7191,20913,4791,36073,543,267,276
55830,43269,7192,20914,4791,36077,543,267,276
55835,43273,7192,20918,4791,36081,543,267,276
55840,43276,7192,20920,4791,36084,543,267,276
55845,43277,7192,20920,4791,36085,543,267,276
55850,43282,7193,20924,4792,36089,543,267,276
55855,43284,7193,20925,4792,36091,543,267,276
55860,43292,7194,20928,4793,36098,543,267,276
55865,43295,7194,20930,4793,36101,543,267,276
55870,43300,7195,20934,4794,36105,543,267,276
55875,43304,7195,20937,4794,36109,543,267,276
55880,43307,7195,20938,4794,36112,543,267,276
55885,43308,7195,20938,4794,36113,543,267,276
55890,43313,7196,20939,4795,36117,543,267,276
55895,43315,7196,20941,4795,36119,543,267,276
55900,43323,7198,20945,4797,36125,543,267,276
55905,43326,7198,20946,4797,36128,543,267,276
55910,43331,7199,20948,4797,36132,543,267,276
55915,43335,7199,20949,4797,36135,543,267,276
55920,43338,7201,20952,4799,36137,543,267,276
55925,43339,7201,20953,4799,36138,543,267,276
55930,43344,7202,20955,4799,36142,543,267,276
55935,43346,7203,20956,4799,36143,543,267,276
55940,43354,7204,20960,4800,36150,543,267,276
55945,43357,7204,20961,4800,36153,543,267,276
55950,43362,7205,20963,4800,36157,543,267,276
55955,43366,7205,20964,4800,36161,543,267,276
55960,43369,7205,20964,4800,36164,543,267,276
55965,43370,7205,20964,4800,36165,543,267,276
55970,43375,7206,20966,4801,36169,543,267,276
55975,43377,7207,20967,4802,36170,543,267,276
55980,43385,7209,20972,4804,36176,543,267,276
55985,43388,7209,20972,4804,36179,543,267,276
55990,43393,7209,20973,4804,36184,543,267,276
55995,43397,7209,20974,4804,36188,543,267,276
56000,43400,7209,20975,4804,36191,543,267,276
56005,43401,7209,20975,4804,36192,543,267,276
56010,43406,7210,20976,4804,36196,543,267,276
56015,43408,7211,20977,4804,36197,543,267,276
56020,43416,7213,20982,4805,36203,543,267,276
56025,43419,7214,20983,4806,36205,543,267,276
56030,43424,7214,20986,4806,36210,543,267,276
56035,43428,7214,20988,4806,36213,543,267,276
56040,43431,7215,20990,4807,36216,543,267,276
56045,43432,7216,20991,4808,36216,543,267,276
56050,43437,7217,20995,4809,36220,543,267,276
56055,43439,7217,20995,4809,36222,543,267,276
56060,43447,7218,21000,4809,36229,543,267,276
56065,43450,7218,21001,4809,36232,543,267,276
56070,43455,7218,21005,4809,36237,543,267,276
56075,43459,7218,21006,4809,36241,543,267,276
56080,43462,7218,21007,4809,36244,543,267,276
56085,43463,7219,21008,4810,36244,543,267,276
56090,43468,7220,21010,4811,36248,543,267,276
56095,43470,7220,21012,4811,36250,543,267,276
56100,43478,7221,21014,4812,36257,543,267,276
56105,43481,7221,21015,4812,36260,543,267,276
56110,43486,7222,21016,4812,36264,543,267,276
56115,43490,7222,21017,4812,36268,543,267,276
56120,43493,7222,21019,4812,36271,543,267,276
56125,43494,7222,21019,4812,36272,543,267,276
56130,43499,7222,21021,4812,36276,543,267,276
56135,43501,7224,21022,4813,36277,543,267,276
56140,43509,7224,21028,4813,36285,543,267,276
56145,43512,7224,21030,4813,36288,543,267,276
56150,43517,7225,21033,4814,36292,543,267,276
56155,43521,7225,21035,4814,36296,543,267,276
56160,43524,7225,21038,4814,36299,543,267,276
56165,43525,7225,21039,4814,36300,543,267,276
56170,43530,7225,21041,4814,36305,543,267,276
56175,43532,7226,21041,4814,36306,543,267,276
56180,43540,7226,21045,4814,36314,543,267,276
56185,43543,7226,21046,4814,36317,543,267,276
56190,43548,7227,21048,4814,36321,543,267,276
56195,43552,7227,21050,4814,36325,543,267,276
56200,43555,7227,21051,4814,36328,543,267,276
56205,43556,7227,21051,4814,36329,543,267,276
56210,43561,7228,21055,4815,36333,543,267,276
56215,43563,7229,21057,4816,36334,543,267,276
56220,43571,7230,21062,4817,36341,543,267,276
56225,43574,7230,21064,4817,36344,543,267,276
56230,43579,7231,21066,4817,36348,543,267,276
56235,43583,7231,21068,4817,36352,543,267,276
56240,43586,7231,21071,4817,36355,543,267,276
56245,43587,7231,21071,4817,36356,543,267,276
56250,43592,7232,21072,4817,36359,543,267,276
56255,43594,7234,21073,4819,36360,543,267,276
56260,43602,7234,21074,4819,36368,543,267,276
56265,43605,7234,21077,4819,36371,543,267,276
56270,43610,7235,21079,4819,36375,543,267,276
56275,43614,7235,21081,4819,36378,543,267,276
56280,43617,7236,21083,4820,36381,543,267,276
56285,43618,7236,21084,4820,36382,543,267,276
56290,43623,7236,21086,4820,36387,543,267,276
56295,43625,7237,21088,4821,36388,543,267,276
56300,43633,7238,21094,4822,36395,543,267,276
56305,43636,7238,21096,4822,36398,543,267,276
56310,43641,7239,21100,4823,36402,543,267,276
56315,43645,7239,21101,4823,36406,543,267,276
56320,43648,7240,21102,4824,36408,543,267,276
56325,43649,7240,21103,4824,36409,543,267,276
56330,43654,7240,21107,4824,36413,543,267,276
56335,43656,7242,21108,4826,36414,543,267,276
56340,43664,7243,21113,4827,36421,543,267,276
56345,43667,7243,21115,4827,36424,543,267,276
56350,43672,7244,21116,4827,36428,543,267,276
56355,43676,7244,21117,4827,36432,543,267,276
56360,43679,7244,21119,4827,36435,543,267,276
56365,43680,7244,21119,4827,36436,543,267,276
56370,43685,7244,21122,4827,36441,543,267,276
56375,43687,7244,21123,4827,36443,543,267,276
56380,43695,7245,21129,4828,36450,543,267,276
56385,43698,7245,21130,4828,36453,543,267,276
56390,43703,7246,21132,4829,36457,543,267,276
56395,43707,7246,21134,4829,36460,543,267,276
56400,43710,7247,21135,4830,36463,543,267,276
56405,43711,7247,21135,4830,36464,543,267,276
56410,43716,7248,21136,4830,36468,543,267,276
56415,43718,7248,21136,4830,36470,543,267,276
56420,43726,7248,21140,4830,36478,543,267,276
56425,43729,7248,21141,4830,36481,543,267,276
56430,43734,7249,21143,4831,36485,543,267,276
56435,43738,7249,21144,4831,36488,543,267,276
56440,43741,7250,21146,4832,36491,543,267,276
56445,43742,7250,21147,4832,36492,543,267,276
56450,43747,7251,21149,4833,36496,543,267,276
56455,43749,7252,21150,4834,36497,543,267,276
56460,43757,7252,21154,4834,36505,543,267,276
56465,43760,7253,21156,4835,36507,543,267,276
56470,43765,7253,21161,4835,36512,543,267,276
56475,43769,7253,21161,4835,36516,543,267,276
56480,43772,7253,21162,4835,36519,543,267,276
56485,43773,7253,21163,4835,36520,543,267,276
56490,43778,7254,21165,4835,36524,543,267,276
56495,43780,7255,21165,4835,36525,543,267,276
56500,43788,7255,21169,4835,36533,543,267,276
56505,43791,7256,21171,4836,36535,543,267,276
56510,43796,7256,21174,4836,36540,543,267,276
56515,43800,7256,21178,4836,36543,543,267,276
56520,43803,7257,21178,4837,36546,543,267,276
56525,43804,7258,21179,4838,36546,543,267,276
56530,43809,7259,21182,4838,36549,543,267,276
56535,43811,7261,21183,4840,36550,543,267,276
56540,43819,7262,21188,4841,36557,543,267,276
56545,43822,7263,21190,4842,36559,543,267,276
56550,43827,7263,21192,4842,36564,543,267,276
56555,43831,7263,21194,4842,36567,543,267,276
56560,43834,7264,21196,4843,36570,543,267,276
56565,43835,7265,21197,4844,36570,543,267,276
56570,43840,7266,21197,4844,36574,543,267,276
56575,43842,7267,21199,4845,36575,543,267,276
56580,43850,7269,21203,4847,36581,543,267,276
56585,43853,7270,21205,4848,36583,543,267,276
56590,43858,7271,21207,4849,36587,543,267,276
56595,43862,7271,21208,4849,36591,543,267,276
56600,43865,7271,21208,4849,36594,543,267,276
56605,43866,7271,21208,4849,36595,543,267,276
56610,43871,7271,21209,4849,36600,543,267,276
56615,43873,7272,21210,4849,36601,543,267,276
56620,43881,7273,21216,4850,36608,543,267,276
56625,43884,7273,21217,4850,36611,543,267,276
56630,43889,7274,21219,4851,36615,543,267,276
56635,43893,7274,21222,4851,36618,543,267,276
56640,43896,7276,21223,4853,36620,543,267,276
56645,43897,7276,21223,4853,36621,543,267,276
56650,43902,7276,21225,4853,36626,543,267,276
56655,43904,7276,21225,4853,36628,543,267,276
56660,43912,7276,21227,4853,36636,543,267,276
56665,43915,7276,21227,4853,36639,543,267,276
56670,43920,7277,21229,4853,36643,543,267,276
56675,43924,7277,21230,4853,36646,543,267,276
56680,43927,7278,21231,4854,36649,543,267,276
56685,43928,7278,21231,4854,36650,543,267,276
56690,43933,7279,21233,4854,36654,543,267,276
56695,43935,7279,21234,4854,36656,543,267,276
56700,43943,7279,21235,4854,36664,543,267,276
56705,43946,7279,21236,4854,36667,543,267,276
56710,43951,7279,21238,4854,36672,543,267,276
56715,43955,7279,21240,4854,36676,543,267,276
56720,43958,7279,21242,4854,36679,543,267,276
56725,43959,7279,21242,4854,36680,543,267,276
56730,43964,7280,21245,4854,36684,543,267,276
56735,43966,7280,21245,4854,36686,543,267,276
56740,43974,7281,21249,4855,36693,543,267,276
56745,43977,7281,21250,4855,36696,543,267,276
56750,43982,7281,21252,4855,36701,543,267,276
56755,43986,7281,21256,4855,36705,543,267,276
56760,43989,7281,21257,4855,36708,543,267,276
56765,43990,7281,21258,4855,36709,543,267,276
56770,43995,7282,21261,4855,36712,543,267,276
56775,43997,7284,21262,4856,36713,543,267,276
56780,44005,7285,21266,4857,36720,543,267,276
56785,44008,7285,21266,4857,36723,543,267,276
56790,44013,7285,21268,4857,36728,543,267,276
56795,44017,7285,21270,4857,36732,543,267,276
56800,44020,7285,21272,4857,36735,543,267,276
56805,44021,7285,21272,4857,36736,543,267,276
56810,44026,7286,21275,4858,36739,543,267,276
56815,44028,7288,21276,4860,36740,543,267,276
56820,44036,7289,21280,4861,36747,543,267,276
56825,44039,7289,21281,4861,36750,543,267,276
56830,44044,7290,21285,4862,36754,543,267,276
56835,44048,7290,21286,4862,36757,543,267,276
56840,44051,7291,21288,4863,36760,543,267,276
56845,44052,7292,21289,4864,36760,543,267,276
56850,44057,7293,21290,4864,36764,543,267,276
56855,44059,7294,21290,4864,36765,543,267,276
56860,44067,7296,21294,4866,36771,543,267,276
56865,44070,7296,21296,4866,36774,543,267,276
56870,44075,7297,21300,4867,36778,543,267,276
56875,44079,7297,21301,4867,36782,543,267,276
56880,44082,7297,21302,4867,36785,543,267,276
56885,44083,7298,21303,4868,36785,543,267,276
56890,44088,7298,21304,4868,36789,543,267,276
56895,44090,7300,21304,4869,36790,543,267,276
56900,44098,7301,21307,4870,36797,543,267,276
56905,44101,7302,21310,4871,36799,543,267,276
56910,44106,7303,21313,4871,36803,543,267,276
56915,44110,7303,21315,4871,36807,543,267,276
56920,44113,7303,21317,4871,36810,543,267,276
56925,44114,7303,21317,4871,36811,543,267,276
56930,44119,7303,21320,4871,36816,543,267,276
56935,44121,7304,21322,4872,36817,543,267,276
56940,44129,7305,21325,4873,36824,543,267,276
56945,44132,7305,21326,4873,36827,543,267,276
56950,44137,7306,21329,4874,36831,543,267,276
56955,44141,7306,21332,4874,36835,543,267,276
56960,44144,7306,21334,4874,36838,543,267,276
56965,44145,7306,21335,4874,36839,543,267,276
56970,44150,7306,21337,4874,36844,543,267,276
56975,44152,7307,21339,4875,36845,543,267,276
56980,44160,7307,21343,4875,36853,543,267,276
56985,44163,7308,21346,4876,36855,543,267,276
56990,44168,7309,21350,4876,36859,543,267,276
56995,44172,7309,21352,4876,36863,543,267,276
57000,44175,7309,21354,4876,36866,543,267,276
57005,44176,7309,21355,4876,36867,543,267,276
57010,44181,7310,21356,4876,36870,543,267,276
57015,44183,7312,21357,4878,36871,543,267,276
57020,44191,7312,21362,4878,36879,543,267,276
57025,44194,7312,21364,4878,36882,543,267,276
57030,44199,7313,21367,4879,36886,543,267,276
57035,44203,7313,21369,4879,36890,543,267,276
57040,44206,7313,21371,4879,36893,543,267,276
57045,44207,7313,21371,4879,36894,543,267,276
57050,44212,7314,21375,4880,36897,543,267,276
57055,44214,7316,21375,4881,36898,543,267,276
57060,44222,7317,21379,4882,36905,543,267,276
57065,44225,7317,21380,4882,36908,543,267,276
57070,44230,7318,21382,4882,36912,543,267,276
57075,44234,7318,21383,4882,36916,543,267,276
57080,44237,7318,21383,4882,36919,543,267,276
57085,44238,7318,21384,4882,36920,543,267,276
57090,44243,7319,21386,4883,36924,543,267,276
57095,44245,7320,21386,4883,36925,543,267,276
57100,44253,7322,21390,4885,36931,543,267,276
57105,44256,7322,21393,4885,36934,543,267,276
57110,44261,7323,21397,4885,36938,543,267,276
57115,44265,7323,21399,4885,36942,543,267,276
57120,44268,7323,21400,4885,36945,543,267,276
57125,44269,7324,21401,4886,36945,543,267,276
57130,44274,7325,21402,4886,36949,543,267,276
57135,44276,7325,21404,4886,36951,543,267,276
57140,44284,7326,21409,4887,36958,543,267,276
57145,44287,7326,21412,4887,36961,543,267,276
57150,44292,7327,21414,4887,36965,543,267,276
57155,44296,7327,21414,4887,36969,543,267,276
57160,44299,7327,21415,4887,36972,543,267,276
57165,44300,7328,21416,4888,36972,543,267,276
57170,44305,7329,21418,4888,36976,543,267,276
57175,44307,7329,21419,4888,36978,543,267,276
57180,44315,7330,21421,4889,36985,543,267,276
57185,44318,7330,21423,4889,36988,543,267,276
57190,44323,7331,21426,4890,36992,543,267,276
57195,44327,7331,21427,4890,36996,543,267,276
57200,44330,7331,21430,4890,36999,543,267,276
57205,44331,7331,21430,4890,37000,543,267,276
57210,44336,7332,21431,4890,37004,543,267,276
57215,44338,7332,21432,4890,37006,543,267,276
57220,44346,7333,21436,4891,37013,543,267,276
57225,44349,7333,21438,4891,37016,543,267,276
57230,44354,7334,21442,4892,37020,543,267,276
57235,44358,7334,21444,4892,37024,543,267,276
57240,44361,7334,21444,4892,37027,543,267,276
57245,44362,7334,21444,4892,37028,543,267,276
57250,44367,7335,21449,4893,37031,543,267,276
57255,44369,7337,21450,4895,37032,543,267,276
57260,44377,7337,21455,4895,37040,543,267,276
57265,44380,7337,21457,4895,37043,543,267,276
57270,44385,7337,21461,4895,37048,543,267,276
57275,44389,7337,21464,4895,37051,543,267,276
57280,44392,7338,21466,4896,37054,543,267,276
57285,44393,7339,21467,4897,37054,543,267,276
57290,44398,7340,21471,4897,37057,543,267,276
57295,44400,7342,21472,4899,37058,543,267,276
57300,44408,7342,21477,4899,37066,543,267,276
57305,44411,7342,21478,4899,37069,543,267,276
57310,44416,7342,21481,4899,37074,543,267,276
57315,44420,7342,21483,4899,37078,543,267,276
57320,44423,7342,21485,4899,37081,543,267,276
57325,44424,7342,21486,4899,37082,543,267,276
57330,44429,7342,21487,4899,37087,543,267,276
57335,44431,7343,21487,4899,37088,543,267,276
57340,44439,7343,21490,4899,37096,543,267,276
57345,44442,7343,21493,4899,37099,543,267,276
57350,44447,7344,21496,4900,37103,543,267,276
57355,44451,7344,21498,4900,37106,543,267,276
57360,44454,7346,21501,4902,37108,543,267,276
57365,44455,7346,21501,4902,37109,543,267,276
57370,44460,7347,21504,4903,37113,543,267,276
57375,44462,7348,21504,4903,37114,543,267,276
57380,44470,7349,21508,4904,37121,543,267,276
57385,44473,7349,21509,4904,37124,543,267,276
57390,44478,7350,21512,4905,37128,543,267,276
57395,44482,7350,21513,4905,37131,543,267,276
57400,44485,7351,21515,4906,37134,543,267,276
57405,44486,7352,21516,4907,37134,543,267,276
57410,44491,7353,21518,4907,37138,543,267,276
57415,44493,7354,21519,4907,37139,543,267,276
57420,44501,7354,21521,4907,37147,543,267,276
57425,44504,7355,21523,4908,37149,543,267,276
57430,44509,7356,21527,4908,37153,543,267,276
57435,44513,7356,21529,4908,37157,543,267,276
57440,44516,7356,21530,4908,37160,543,267,276
57445,44517,7356,21530,4908,37161,543,267,276
57450,44522,7356,21534,4908,37166,543,267,276
57455,44524,7357,21535,4908,37167,543,267,276
57460,44532,7357,21540,4908,37175,543,267,276
57465,44535,7357,21541,4908,37178,543,267,276
57470,44540,7358,21543,4908,37182,543,267,276
57475,44544,7358,21543,4908,37186,543,267,276
57480,44547,7359,21545,4909,37188,543,267,276
57485,44548,7359,21546,4909,37189,543,267,276
57490,44553,7359,21548,4909,37194,543,267,276
57495,44555,7360,21549,4910,37195,543,267,276
57500,44563,7360,21552,4910,37203,543,267,276
57505,44566,7361,21553,4911,37205,543,267,276
57510,44571,7362,21553,4911,37209,543,267,276
57515,44575,7362,21557,4911,37213,543,267,276
57520,44578,7362,21558,4911,37216,543,267,276
57525,44579,7362,21559,4911,37217,543,267,276
57530,44584,7363,21560,4911,37221,543,267,276
57535,44586,7364,21561,4911,37222,543,267,276
57540,44594,7364,21565,4911,37230,543,267,276
57545,44597,7365,21568,4912,37232,543,267,276
57550,44602,7366,21571,4913,37236,543,267,276
57555,44606,7366,21574,4913,37240,543,267,276
57560,44609,7366,21575,4913,37243,543,267,276
57565,44610,7367,21576,4914,37243,543,267,276
57570,44615,7368,21577,4915,37247,543,267,276
57575,44617,7369,21577,4915,37248,543,267,276
57580,44625,7369,21577,4915,37256,543,267,276
57585,44628,7370,21580,4916,37258,543,267,276
57590,44633,7371,21584,4917,37262,543,267,276
57595,44637,7371,21587,4917,37265,543,267,276
57600,44640,7372,21588,4918,37268,543,267,276
57605,44641,7372,21588,4918,37269,543,267,276
57610,44646,7373,21590,4919,37273,543,267,276
57615,44648,7374,21591,4920,37274,543,267,276
57620,44656,7374,21593,4920,37282,543,267,276
57625,44659,7375,21594,4921,37284,543,267,276
57630,44664,7376,21597,4922,37288,543,267,276
57635,44668,7376,21599,4922,37292,543,267,276
57640,44671,7376,21600,4922,37295,543,267,276
57645,44672,7376,21600,4922,37296,543,267,276
57650,44677,7376,21603,4922,37301,543,267,276
57655,44679,7377,21604,4922,37302,543,267,276
57660,44687,7378,21605,4923,37309,543,267,276
57665,44690,7379,21607,4924,37311,543,267,276
57670,44695,7380,21610,4924,37315,543,267,276
57675,44699,7380,21611,4924,37319,543,267,276
57680,44702,7380,21613,4924,37322,543,267,276
57685,44703,7380,21613,4924,37323,543,267,276
57690,44708,7380,21615,4924,37328,543,267,276
57695,44710,7381,21617,4925,37329,543,267,276
57700,44718,7382,21620,4926,37336,543,267,276
57705,44721,7383,21621,4927,37338,543,267,276
57710,44726,7384,21623,4928,37342,543,267,276
57715,44730,7384,21625,4928,37346,543,267,276
57720,44733,7384,21626,4928,37349,543,267,276
57725,44734,7384,21626,4928,37350,543,267,276
57730,44739,7385,21629,4929,37354,543,267,276
57735,44741,7386,21629,4929,37355,543,267,276
57740,44749,7387,21632,4930,37362,543,267,276
57745,44752,7387,21633,4930,37365,543,267,276
57750,44757,7388,21634,4930,37369,543,267,276
57755,44761,7388,21635,4930,37373,543,267,276
57760,44764,7388,21636,4930,37376,543,267,276
57765,44765,7389,21637,4931,37376,543,267,276
57770,44770,7390,21640,4931,37380,543,267,276
57775,44772,7391,21641,4931,37381,543,267,276
57780,44780,7392,21644,4932,37388,543,267,276
57785,44783,7392,21645,4932,37391,543,267,276
57790,44788,7392,21647,4932,37396,543,267,276
57795,44792,7392,21649,4932,37400,543,267,276
57800,44795,7392,21649,4932,37403,543,267,276
57805,44796,7392,21649,4932,37404,543,267,276
57810,44801,7392,21650,4932,37409,543,267,276
57815,44803,7393,21651,4933,37410,543,267,276
57820,44811,7393,21656,4933,37418,543,267,276
57825,44814,7393,21657,4933,37421,543,267,276
57830,44819,7393,21658,4933,37426,543,267,276
57835,44823,7393,21661,4933,37430,543,267,276
57840,44826,7393,21662,4933,37433,543,267,276
57845,44827,7393,21662,4933,37434,543,267,276
57850,44832,7393,21664,4933,37439,543,267,276
57855,44834,7394,21665,4933,37440,543,267,276
57860,44842,7394,21669,4933,37448,543,267,276
57865,44845,7395,21671,4934,37450,543,267,276
57870,44850,7395,21673,4934,37455,543,267,276
57875,44854,7395,21673,4934,37459,543,267,276
57880,44857,7395,21674,4934,37462,543,267,276
57885,44858,7395,21674,4934,37463,543,267,276
57890,44863,7396,21674,4934,37467,543,267,276
57895,44865,7397,21675,4934,37468,543,267,276
57900,44873,7399,21680,4936,37474,543,267,276
57905,44876,7400,21682,4937,37476,543,267,276
57910,44881,7401,21685,4937,37480,543,267,276
57915,44885,7401,21688,4937,37483,543,267,276
57920,44888,7402,21690,4938,37486,543,267,276
57925,44889,7402,21691,4938,37487,543,267,276
57930,44894,7403,21692,4938,37491,543,267,276
57935,44896,7404,21692,4938,37492,543,267,276
57940,44904,7404,21696,4938,37500,543,267,276
57945,44907,7405,21697,4939,37502,543,267,276
57950,44912,7406,21699,4940,37506,543,267,276
57955,44916,7406,21700,4940,37510,543,267,276
57960,44919,7406,21702,4940,37513,543,267,276
57965,44920,7406,21703,4940,37514,543,267,276
57970,44925,7407,21706,4940,37518,543,267,276
57975,44927,7408,21707,4941,37519,543,267,276
57980,44935,7409,21711,4942,37526,543,267,276
57985,44938,7410,21714,4943,37528,543,267,276
57990,44943,7410,21717,4943,37533,543,267,276
57995,44947,7410,21720,4943,37536,543,267,276
58000,44950,7411,21722,4944,37539,543,267,276
58005,44951,7411,21723,4944,37540,543,267,276
58010,44956,7412,21726,4945,37544,543,267,276
58015,44958,7413,21728,4946,37545,543,267,276
58020,44966,7413,21730,4946,37553,543,267,276
58025,44969,7413,21732,4946,37556,543,267,276
58030,44974,7413,21735,4946,37561,543,267,276
58035,44978,7413,21738,4946,37565,543,267,276
58040,44981,7413,21740,4946,37568,543,267,276
58045,44982,7413,21740,4946,37569,543,267,276
58050,44987,7414,21742,4947,37573,543,267,276
58055,44989,7415,21744,4948,37574,543,267,276
58060,44997,7416,21750,4949,37581,543,267,276
58065,45000,7416,21751,4949,37584,543,267,276
58070,45005,7417,21755,4950,37588,543,267,276
58075,45009,7417,21758,4950,37592,543,267,276
58080,45012,7418,21759,4951,37594,543,267,276
58085,45013,7419,21760,4952,37594,543,267,276
58090,45018,7420,21763,4953,37598,543,267,276
58095,45020,7421,21763,4953,37599,543,267,276
58100,45028,7422,21766,4954,37606,543,267,276
58105,45031,7422,21767,4954,37609,543,267,276
58110,45036,7423,21768,4955,37613,543,267,276
58115,45040,7423,21770,4955,37617,543,267,276
58120,45043,7423,21771,4955,37620,543,267,276
58125,45044,7423,21772,4955,37621,543,267,276
58130,45049,7424,21774,4955,37625,543,267,276
58135,45051,7425,21774,4955,37626,543,267,276
58140,45059,7425,21777,4955,37634,543,267,276
58145,45062,7425,21778,4955,37637,543,267,276
58150,45067,7426,21778,4955,37641,543,267,276
58155,45071,7426,21780,4955,37645,543,267,276
58160,45074,7426,21781,4955,37648,543,267,276
58165,45075,7426,21782,4955,37649,543,267,276
58170,45080,7427,21784,4956,37653,543,267,276
58175,45082,7428,21786,4957,37654,543,267,276
58180,45090,7429,21789,4958,37661,543,267,276
58185,45093,7429,21790,4958,37664,543,267,276
58190,45098,7430,21792,4958,37668,543,267,276
58195,45102,7430,21794,4958,37672,543,267,276
58200,45105,7431,21796,4959,37674,543,267,276
58205,45106,7431,21796,4959,37675,543,267,276
58210,45111,7432,21800,4960,37679,543,267,276
58215,45113,7433,21800,4960,37680,543,267,276
58220,45121,7434,21804,4961,37687,543,267,276
58225,45124,7435,21805,4962,37689,543,267,276
58230,45129,7435,21809,4962,37694,543,267,276
58235,45133,7435,21811,4962,37697,543,267,276
58240,45136,7436,21812,4963,37700,543,267,276
58245,45137,7436,21812,4963,37701,543,267,276
58250,45142,7437,21812,4963,37705,543,267,276
58255,45144,7438,21812,4963,37706,543,267,276
58260,45152,7439,21817,4964,37713,543,267,276
58265,45155,7439,21817,4964,37716,543,267,276
58270,45160,7439,21819,4964,37721,543,267,276
58275,45164,7439,21821,4964,37725,543,267,276
58280,45167,7439,21823,4964,37728,543,267,276
58285,45168,7439,21823,4964,37729,543,267,276
58290,45173,7439,21826,4964,37734,543,267,276
58295,45175,7440,21827,4965,37735,543,267,276
58300,45183,7440,21832,4965,37743,543,267,276
58305,45186,7440,21834,4965,37746,543,267,276
58310,45191,7441,21836,4965,37750,543,267,276
58315,45195,7441,21836,4965,37754,543,267,276
58320,45198,7442,21837,4966,37756,543,267,276
58325,45199,7442,21838,4966,37757,543,267,276
58330,45204,7442,21839,4966,37762,543,267,276
58335,45206,7443,21841,4967,37763,543,267,276
58340,45214,7443,21846,4967,37771,543,267,276
58345,45217,7444,21848,4968,37773,543,267,276
58350,45222,7445,21851,4968,37777,543,267,276
58355,45226,7445,21854,4968,37780,543,267,276
58360,45229,7446,21855,4969,37783,543,267,276
58365,45230,7446,21856,4969,37784,543,267,276
58370,45235,7447,21858,4969,37788,543,267,276
58375,45237,7448,21860,4970,37789,543,267,276
58380,45245,7449,21864,4971,37796,543,267,276
58385,45248,7449,21865,4971,37799,543,267,276
58390,45253,7449,21867,4971,37804,543,267,276
58395,45257,7449,21868,4971,37808,543,267,276
58400,45260,7449,21868,4971,37811,543,267,276
58405,45261,7449,21869,4971,37812,543,267,276
58410,45266,7450,21870,4972,37816,543,267,276
58415,45268,7451,21871,4973,37817,543,267,276
58420,45276,7451,21877,4973,37825,543,267,276
58425,45279,7451,21880,4973,37828,543,267,276
58430,45284,7451,21880,4973,37833,543,267,276
58435,45288,7451,21883,4973,37837,543,267,276
58440,45291,7451,21883,4973,37840,543,267,276
58445,45292,7451,21884,4973,37841,543,267,276
58450,45297,7452,21884,4973,37845,543,267,276
58455,45299,7453,21885,4974,37846,543,267,276
58460,45307,7453,21889,4974,37854,543,267,276
58465,45310,7453,21889,4974,37857,543,267,276
58470,45315,7453,21890,4974,37862,543,267,276
58475,45319,7453,21893,4974,37866,543,267,276
58480,45322,7453,21893,4974,37869,543,267,276
58485,45323,7453,21894,4974,37870,543,267,276
58490,45328,7454,21897,4974,37874,543,267,276
58495,45330,7455,21897,4974,37875,543,267,276
58500,45338,7456,21903,4975,37882,543,267,276
58505,45341,7457,21905,4976,37884,543,267,276
58510,45346,7458,21909,4977,37888,543,267,276
58515,45350,7458,21913,4977,37891,543,267,276
58520,45353,7460,21915,4978,37893,543,267,276
58525,45354,7460,21915,4978,37894,543,267,276
58530,45359,7461,21919,4979,37898,543,267,276
58535,45361,7462,21920,4980,37899,543,267,276
58540,45369,7463,21921,4981,37906,543,267,276
58545,45372,7464,21923,4982,37908,543,267,276
58550,45377,7465,21927,4983,37912,543,267,276
58555,45381,7465,21929,4983,37915,543,267,276
58560,45384,7467,21930,4984,37917,543,267,276
58565,45385,7467,21931,4984,37918,543,267,276
58570,45390,7468,21932,4984,37922,543,267,276
58575,45392,7469,21934,4985,37923,543,267,276
58580,45400,7469,21937,4985,37931,543,267,276
58585,45403,7470,21939,4986,37933,543,267,276
58590,45408,7470,21942,4986,37938,543,267,276
58595,45412,7470,21944,4986,37942,543,267,276
58600,45415,7471,21946,4987,37944,543,267,276
58605,45416,7471,21946,4987,37945,543,267,276
58610,45421,7472,21949,4987,37949,543,267,276
58615,45423,7473,21950,4988,37950,543,267,276
58620,45431,7474,21955,4989,37957,543,267,276
58625,45434,7475,21957,4989,37959,543,267,276
58630,45439,7475,21959,4989,37964,543,267,276
58635,45443,7475,21960,4989,37967,543,267,276
58640,45446,7477,21961,4991,37969,543,267,276
58645,45447,7477,21961,4991,37970,543,267,276
58650,45452,7478,21963,4992,37974,543,267,276
58655,45454,7479,21964,4992,37975,543,267,276
58660,45462,7479,21967,4992,37983,543,267,276
58665,45465,7480,21968,4993,37985,543,267,276
58670,45470,7480,21971,4993,37990,543,267,276
58675,45474,7480,21972,4993,37994,543,267,276
58680,45477,7481,21973,4993,37996,543,267,276
58685,45478,7481,21973,4993,37997,543,267,276
58690,45483,7482,21974,4993,38001,543,267,276
58695,45485,7483,21976,4994,38002,543,267,276
58700,45493,7483,21980,4994,38010,543,267,276
58705,45496,7484,21982,4994,38012,543,267,276
58710,45501,7484,21985,4994,38017,543,267,276
58715,45505,7484,21987,4994,38021,543,267,276
58720,45508,7485,21988,4995,38023,543,267,276
58725,45509,7485,21988,4995,38024,543,267,276
58730,45514,7486,21990,4995,38028,543,267,276
58735,45516,7487,21992,4996,38029,543,267,276
58740,45524,7487,21996,4996,38037,543,267,276
58745,45527,7488,21997,4996,38039,543,267,276
58750,45532,7488,21998,4996,38044,543,267,276
58755,45536,7488,22000,4996,38048,543,267,276
58760,45539,7489,22002,4996,38050,543,267,276
58765,45540,7489,22003,4996,38051,543,267,276
58770,45545,7490,22007,4997,38055,543,267,276
58775,45547,7491,22007,4997,38056,543,267,276
58780,45555,7492,22011,4998,38063,543,267,276
58785,45558,7493,22014,4999,38065,543,267,276
58790,45563,7493,22014,4999,38070,543,267,276
58795,45567,7493,22018,4999,38073,543,267,276
58800,45570,7495,22020,5001,38075,543,267,276
58805,45571,7495,22020,5001,38076,543,267,276
58810,45576,7496,22023,5002,38080,543,267,276
58815,45578,7497,22024,5002,38081,543,267,276
58820,45586,7498,22030,5003,38088,543,267,276
58825,45589,7499,22031,5003,38090,543,267,276
58830,45594,7499,22034,5003,38095,543,267,276
58835,45598,7499,22037,5003,38098,543,267,276
58840,45601,7501,22039,5005,38100,543,267,276
58845,45602,7501,22040,5005,38101,543,267,276
58850,45607,7502,22043,5006,38105,543,267,276
58855,45609,7503,22043,5006,38106,543,267,276
58860,45617,7504,22048,5007,38113,543,267,276
58865,45620,7504,22050,5007,38116,543,267,276
58870,45625,7504,22054,5007,38121,543,267,276
58875,45629,7504,22056,5007,38124,543,267,276
58880,45632,7506,22057,5008,38126,543,267,276
58885,45633,7506,22058,5008,38127,543,267,276
58890,45638,7507,22060,5008,38131,543,267,276
58895,45640,7508,22061,5008,38132,543,267,276
58900,45648,7508,22065,5008,38140,543,267,276
58905,45651,7508,22065,5008,38143,543,267,276
58910,45656,7508,22067,5008,38148,543,267,276
58915,45660,7508,22069,5008,38151,543,267,276
58920,45663,7510,22070,5009,38153,543,267,276
58925,45664,7510,22071,5009,38154,543,267,276
58930,45669,7511,22073,5010,38158,543,267,276
58935,45671,7512,22074,5010,38159,543,267,276
58940,45679,7512,22076,5010,38167,543,267,276
58945,45682,7512,22077,5010,38170,543,267,276
58950,45687,7512,22079,5010,38175,543,267,276
58955,45691,7512,22081,5010,38179,543,267,276
58960,45694,7513,22081,5010,38181,543,267,276
58965,45695,7513,22082,5010,38182,543,267,276
58970,45700,7514,22084,5011,38186,543,267,276
58975,45702,7515,22085,5011,38187,543,267,276
58980,45710,7516,22088,5012,38194,543,267,276
58985,45713,7517,22091,5013,38196,543,267,276
58990,45718,7517,22094,5013,38201,543,267,276
58995,45722,7517,22096,5013,38204,543,267,276
59000,45725,7519,22097,5014,38206,543,267,276
59005,45726,7519,22098,5014,38207,543,267,276
59010,45731,7520,22100,5014,38211,543,267,276
59015,45733,7521,22100,5014,38212,543,267,276
59020,45741,7521,22103,5014,38220,543,267,276
59025,45744,7522,22105,5015,38222,543,267,276
59030,45749,7522,22107,5015,38227,543,267,276
59035,45753,7522,22108,5015,38231,543,267,276
59040,45756,7523,22109,5015,38233,543,267,276
59045,45757,7523,22109,5015,38234,543,267,276
59050,45762,7524,22110,5016,38238,543,267,276
59055,45764,7525,22111,5017,38239,543,267,276
59060,45772,7526,22117,5018,38246,543,267,276
59065,45775,7527,22120,5019,38248,543,267,276
59070,45780,7527,22122,5019,38253,543,267,276
59075,45784,7527,22124,5019,38257,543,267,276
59080,45787,7528,22126,5020,38259,543,267,276
59085,45788,7528,22127,5020,38260,543,267,276
59090,45793,7529,22131,5021,38264,543,267,276
59095,45795,7530,22132,5021,38265,543,267,276
59100,45803,7530,22135,5021,38273,543,267,276
59105,45806,7531,22137,5022,38275,543,267,276
59110,45811,7531,22138,5022,38280,543,267,276
59115,45815,7531,22141,5022,38283,543,267,276
59120,45818,7533,22143,5023,38285,543,267,276
59125,45819,7533,22144,5023,38286,543,267,276
59130,45824,7534,22146,5024,38290,543,267,276
59135,45826,7535,22146,5024,38291,543,267,276
59140,45834,7535,22149,5024,38299,543,267,276
59145,45837,7536,22152,5025,38301,543,267,276
59150,45842,7536,22154,5025,38306,543,267,276
59155,45846,7536,22158,5025,38309,543,267,276
59160,45849,7538,22159,5026,38311,543,267,276
59165,45850,7538,22159,5026,38312,543,267,276
59170,45855,7539,22163,5027,38316,543,267,276
59175,45857,7540,22164,5028,38317,543,267,276
59180,45865,7541,22169,5029,38324,543,267,276
59185,45868,7542,22171,5030,38326,543,267,276
59190,45873,7542,22175,5030,38331,543,267,276
59195,45877,7542,22178,5030,38335,543,267,276
59200,45880,7543,22179,5030,38337,543,267,276
59205,45881,7543,22179,5030,38338,543,267,276
59210,45886,7544,22181,5031,38342,543,267,276
59215,45888,7545,22182,5032,38343,543,267,276
59220,45896,7545,22188,5032,38351,543,267,276
59225,45899,7546,22189,5032,38353,543,267,276
59230,45904,7546,22192,5032,38358,543,267,276
59235,45908,7546,22195,5032,38362,543,267,276
59240,45911,7547,22198,5033,38364,543,267,276
59245,45912,7547,22198,5033,38365,543,267,276
59250,45917,7548,22200,5033,38369,543,267,276
59255,45919,7549,22201,5033,38370,543,267,276
59260,45927,7550,22206,5034,38377,543,267,276
59265,45930,7551,22208,5035,38379,543,267,276
59270,45935,7551,22210,5035,38384,543,267,276
59275,45939,7551,22211,5035,38388,543,267,276
59280,45942,7552,22213,5035,38390,543,267,276
59285,45943,7552,22214,5035,38391,543,267,276
59290,45948,7553,22218,5036,38395,543,267,276
59295,45950,7554,22219,5036,38396,543,267,276
59300,45958,7555,22225,5037,38403,543,267,276
59305,45961,7556,22225,5037,38405,543,267,276
59310,45966,7556,22226,5037,38410,543,267,276
59315,45970,7556,22228,5037,38414,543,267,276
59320,45973,7557,22229,5038,38416,543,267,276
59325,45974,7557,22230,5038,38417,543,267,276
59330,45979,7558,22232,5038,38421,543,267,276
59335,45981,7559,22233,5039,38422,543,267,276
59340,45989,7559,22236,5039,38430,543,267,276
59345,45992,7559,22238,5039,38433,543,267,276
59350,45997,7559,22240,5039,38438,543,267,276
59355,46001,7559,22244,5039,38441,543,267,276
59360,46004,7561,22245,5041,38443,543,267,276
59365,46005,7561,22245,5041,38444,543,267,276
59370,46010,7562,22247,5041,38448,543,267,276
59375,46012,7563,22248,5041,38449,543,267,276
59380,46020,7563,22251,5041,38457,543,267,276
59385,46023,7563,22253,5041,38460,543,267,276
59390,46028,7563,22257,5041,38465,543,267,276
59395,46032,7563,22259,5041,38469,543,267,276
59400,46035,7564,22260,5042,38471,543,267,276
59405,46036,7564,22260,5042,38472,543,267,276
59410,46041,7565,22261,5042,38476,543,267,276
59415,46043,7566,22262,5043,38477,543,267,276
59420,46051,7566,22266,5043,38485,543,267,276
59425,46054,7566,22267,5043,38488,543,267,276
59430,46059,7566,22269,5043,38493,543,267,276
59435,46063,7566,22270,5043,38497,543,267,276
59440,46066,7567,22271,5043,38499,543,267,276
59445,46067,7567,22271,5043,38500,543,267,276
59450,46072,7568,22274,5044,38504,543,267,276
59455,46074,7569,22274,5044,38505,543,267,276
59460,46082,7569,22276,5044,38513,543,267,276
59465,46085,7570,22277,5044,38515,543,267,276
59470,46090,7570,22280,5044,38520,543,267,276
59475,46094,7570,22282,5044,38524,543,267,276
59480,46097,7571,22283,5044,38526,543,267,276
59485,46098,7571,22283,5044,38527,543,267,276
59490,46103,7572,22287,5045,38531,543,267,276
59495,46105,7573,22288,5046,38532,543,267,276
59500,46113,7574,22294,5047,38539,543,267,276
59505,46116,7575,22296,5047,38541,543,267,276
59510,46121,7575,22298,5047,38546,543,267,276
59515,46125,7575,22299,5047,38549,543,267,276
59520,46128,7577,22300,5048,38551,543,267,276
59525,46129,7577,22300,5048,38552,543,267,276
59530,46134,7578,22304,5049,38556,543,267,276
59535,46136,7579,22305,5049,38557,543,267,276
59540,46144,7580,22308,5050,38564,543,267,276
59545,46147,7581,22310,5051,38566,543,267,276
59550,46152,7581,22312,5051,38571,543,267,276
59555,46156,7581,22314,5051,38574,543,267,276
59560,46159,7583,22316,5053,38576,543,267,276
59565,46160,7583,22316,5053,38577,543,267,276
59570,46165,7584,22318,5053,38581,543,267,276
59575,46167,7585,22320,5054,38582,543,267,276
59580,46175,7586,22321,5055,38589,543,267,276
59585,46178,7587,22323,5055,38591,543,267,276
59590,46183,7587,22327,5055,38596,543,267,276
59595,46187,7587,22328,5055,38599,543,267,276
59600,46190,7589,22331,5057,38601,543,267,276
59605,46191,7589,22332,5057,38602,543,267,276
59610,46196,7590,22335,5057,38606,543,267,276
59615,46198,7591,22337,5058,38607,543,267,276
59620,46206,7592,22343,5059,38614,543,267,276
59625,46209,7593,22344,5059,38616,543,267,276
59630,46214,7593,22347,5059,38621,543,267,276
59635,46218,7593,22349,5059,38624,543,267,276
59640,46221,7595,22349,5060,38626,543,267,276
59645,46222,7595,22349,5060,38627,543,267,276
59650,46227,7596,22351,5061,38631,543,267,276
59655,46229,7597,22353,5062,38632,543,267,276
59660,46237,7598,22357,5063,38639,543,267,276
59665,46240,7599,22360,5064,38641,543,267,276
59670,46245,7599,22363,5064,38646,543,267,276
59675,46249,7599,22365,5064,38649,543,267,276
59680,46252,7601,22366,5066,38651,543,267,276
59685,46253,7601,22367,5066,38652,543,267,276
59690,46258,7602,22369,5067,38656,543,267,276
59695,46260,7603,22370,5067,38657,543,267,276
59700,46268,7604,22374,5068,38664,543,267,276
59705,46271,7605,22376,5069,38666,543,267,276
59710,46276,7605,22378,5069,38671,543,267,276
59715,46280,7605,22379,5069,38675,543,267,276
59720,46283,7606,22382,5070,38677,543,267,276
59725,46284,7606,22382,5070,38678,543,267,276
59730,46289,7607,22385,5071,38682,543,267,276
59735,46291,7608,22387,5072,38683,543,267,276
59740,46299,7609,22391,5073,38690,543,267,276
59745,46302,7610,22392,5073,38692,543,267,276
59750,46307,7610,22395,5073,38697,543,267,276
59755,46311,7610,22398,5073,38700,543,267,276
59760,46314,7612,22399,5074,38702,543,267,276
59765,46315,7612,22400,5074,38703,543,267,276
59770,46320,7613,22401,5074,38707,543,267,276
59775,46322,7614,22402,5075,38708,543,267,276
59780,46330,7614,22408,5075,38716,543,267,276
59785,46333,7615,22410,5075,38718,543,267,276
59790,46338,7615,22412,5075,38723,543,267,276
59795,46342,7615,22416,5075,38726,543,267,276
59800,46345,7617,22417,5077,38728,543,267,276
59805,46346,7617,22418,5077,38729,543,267,276
59810,46351,7618,22419,5077,38733,543,267,276
59815,46353,7619,22420,5078,38734,543,267,276
59820,46361,7620,22424,5079,38741,543,267,276
59825,46364,7621,22426,5080,38743,543,267,276
59830,46369,7621,22428,5080,38748,543,267,276
59835,46373,7621,22430,5080,38751,543,267,276
59840,46376,7623,22430,5081,38753,543,267,276
59845,46377,7623,22431,5081,38754,543,267,276
59850,46382,7624,22434,5081,38758,543,267,276
59855,46384,7625,22434,5081,38759,543,267,276
59860,46392,7625,22437,5081,38767,543,267,276
59865,46395,7626,22439,5081,38769,543,267,276
59870,46400,7626,22443,5081,38774,543,267,276
59875,46404,7626,22444,5081,38778,543,267,276
59880,46407,7627,22445,5081,38780,543,267,276
59885,46408,7627,22446,5081,38781,543,267,276
59890,46413,7628,22446,5081,38785,543,267,276
59895,46415,7629,22447,5081,38786,543,267,276
59900,46423,7630,22451,5082,38793,543,267,276
59905,46426,7631,22452,5082,38795,543,267,276
59910,46431,7631,22457,5082,38800,543,267,276
59915,46435,7631,22458,5082,38804,543,267,276
59920,46438,7632,22460,5083,38806,543,267,276
59925,46439,7632,22461,5083,38807,543,267,276
59930,46444,7633,22464,5084,38811,543,267,276
59935,46446,7634,22466,5085,38812,543,267,276
59940,46454,7634,22472,5085,38820,543,267,276
59945,46457,7635,22472,5085,38822,543,267,276
59950,46462,7635,22474,5085,38827,543,267,276
59955,46466,7635,22476,5085,38831,543,267,276
59960,46469,7636,22476,5085,38833,543,267,276
59965,46470,7636,22476,5085,38834,543,267,276
59970,46475,7636,22479,5085,38839,543,267,276
59975,46477,7637,22479,5085,38840,543,267,276
59980,46485,7637,22480,5085,38848,543,267,276
59985,46488,7638,22482,5085,38850,543,267,276
59990,46493,7638,22486,5085,38855,543,267,276
59995,46497,7638,22488,5085,38859,543,267,276
60000,46500,7639,22489,5086,38861,543,267,276
60005,46501,7639,22489,5086,38862,543,267,276
60010,46506,7639,22491,5086,38867,543,267,276
60015,46508,7640,22492,5087,38868,543,267,276
60020,46516,7640,22496,5087,38876,543,267,276
60025,46519,7641,22497,5087,38878,543,267,276
60030,46524,7641,22501,5087,38883,543,267,276
60035,46528,7641,22503,5087,38887,543,267,276
60040,46531,7642,22503,5087,38889,543,267,276
60045,46532,7642,22504,5087,38890,543,267,276
60050,46537,7642,22505,5087,38895,543,267,276
60055,46539,7643,22506,5087,38896,543,267,276
60060,46547,7643,22509,5087,38904,543,267,276
60065,46550,7644,22510,5087,38906,543,267,276
60070,46555,7644,22511,5087,38911,543,267,276
60075,46559,7644,22515,5087,38915,543,267,276
60080,46562,7645,22517,5088,38917,543,267,276
60085,46563,7645,22517,5088,38918,543,267,276
60090,46568,7645,22520,5088,38923,543,267,276
60095,46570,7646,22520,5088,38924,543,267,276
60100,46578,7646,22524,5088,38932,543,267,276
60105,46581,7647,22525,5088,38934,543,267,276
60110,46586,7647,22528,5088,38939,543,267,276
60115,46590,7647,22532,5088,38943,543,267,276
60120,46593,7648,22533,5088,38945,543,267,276
60125,46594,7648,22534,5088,38946,543,267,276
60130,46599,7648,22537,5088,38951,543,267,276
60135,46601,7649,22538,5088,38952,543,267,276
60140,46609,7649,22540,5088,38960,543,267,276
60145,46612,7650,22542,5089,38962,543,267,276
60150,46617,7650,22544,5089,38967,543,267,276
60155,46621,7650,22545,5089,38971,543,267,276
60160,46624,7651,22546,5089,38973,543,267,276
60165,46625,7651,22546,5089,38974,543,267,276
60170,46630,7651,22549,5089,38979,543,267,276
60175,46632,7652,22551,5090,38980,543,267,276
60180,46640,7652,22553,5090,38988,543,267,276
60185,46643,7652,22554,5090,38991,543,267,276
60190,46648,7652,22558,5090,38996,543,267,276
60195,46652,7652,22560,5090,39000,543,267,276
60200,46655,7653,22561,5090,39002,543,267,276
60205,46656,7653,22561,5090,39003,543,267,276
60210,46661,7653,22564,5090,39008,543,267,276
60215,46663,7654,22565,5090,39009,543,267,276
60220,46671,7654,22571,5090,39017,543,267,276
60225,46674,7654,22571,5090,39020,543,267,276
60230,46679,7654,22573,5090,39025,543,267,276
60235,46683,7654,22575,5090,39029,543,267,276
60240,46686,7655,22577,5091,39031,543,267,276
60245,46687,7655,22577,5091,39032,543,267,276
60250,46692,7655,22581,5091,39037,543,267,276
60255,46694,7656,22582,5091,39038,543,267,276
60260,46702,7656,22587,5091,39046,543,267,276
60265,46705,7656,22588,5091,39049,543,267,276
60270,46710,7656,22590,5091,39054,543,267,276
60275,46714,7656,22593,5091,39058,543,267,276
60280,46717,7657,22595,5092,39060,543,267,276
60285,46718,7657,22595,5092,39061,543,267,276
60290,46723,7657,22597,5092,39066,543,267,276
60295,46725,7658,22598,5092,39067,543,267,276
60300,46733,7658,22602,5092,39075,543,267,276
60305,46736,7659,22605,5093,39077,543,267,276
60310,46741,7659,22606,5093,39082,543,267,276
60315,46745,7659,22608,5093,39086,543,267,276
60320,46748,7660,22610,5094,39088,543,267,276
60325,46749,7660,22610,5094,39089,543,267,276
60330,46754,7660,22612,5094,39094,543,267,276
60335,46756,7661,22614,5095,39095,543,267,276
60340,46764,7661,22617,5095,39103,543,267,276
60345,46767,7662,22618,5096,39105,543,267,276
60350,46772,7662,22623,5096,39110,543,267,276
60355,46776,7662,22627,5096,39114,543,267,276
60360,46779,7663,22629,5097,39116,543,267,276
60365,46780,7663,22629,5097,39117,543,267,276
60370,46785,7663,22630,5097,39122,543,267,276
60375,46787,7664,22631,5098,39123,543,267,276
60380,46795,7664,22636,5098,39131,543,267,276
60385,46798,7665,22637,5098,39133,543,267,276
60390,46803,7665,22639,5098,39138,543,267,276
60395,46807,7665,22639,5098,39142,543,267,276
60400,46810,7666,22640,5099,39144,543,267,276
60405,46811,7666,22641,5099,39145,543,267,276
60410,46816,7666,22641,5099,39150,543,267,276
60415,46818,7667,22641,5099,39151,543,267,276
60420,46826,7667,22644,5099,39159,543,267,276
60425,46829,7668,22645,5099,39161,543,267,276
60430,46834,7668,22647,5099,39166,543,267,276
60435,46838,7668,22649,5099,39170,543,267,276
60440,46841,7669,22651,5100,39172,543,267,276
60445,46842,7669,22651,5100,39173,543,267,276
60450,46847,7669,22653,5100,39178,543,267,276
60455,46849,7670,22654,5100,39179,543,267,276
60460,46857,7670,22659,5100,39187,543,267,276
60465,46860,7671,22661,5100,39189,543,267,276
60470,46865,7671,22664,5100,39194,543,267,276
60475,46869,7671,22665,5100,39198,543,267,276
60480,46872,7672,22666,5100,39200,543,267,276
60485,46873,7672,22666,5100,39201,543,267,276
60490,46878,7672,22668,5100,39206,543,267,276
60495,46880,7673,22669,5101,39207,543,267,276
60500,46888,7673,22673,5101,39215,543,267,276
60505,46891,7673,22674,5101,39218,543,267,276
60510,46896,7673,22677,5101,39223,543,267,276
60515,46900,7673,22678,5101,39227,543,267,276
60520,46903,7674,22680,5102,39229,543,267,276
60525,46904,7674,22681,5102,39230,543,267,276
60530,46909,7674,22685,5102,39235,543,267,276
60535,46911,7675,22685,5102,39236,543,267,276
60540,46919,7675,22688,5102,39244,543,267,276
60545,46922,7675,22690,5102,39247,543,267,276
60550,46927,7675,22693,5102,39252,543,267,276
60555,46931,7675,22696,5102,39256,543,267,276
60560,46934,7676,22698,5102,39258,543,267,276
60565,46935,7676,22699,5102,39259,543,267,276
60570,46940,7676,22703,5102,39264,543,267,276
60575,46942,7677,22703,5102,39265,543,267,276
60580,46950,7677,22706,5102,39273,543,267,276
60585,46953,7677,22709,5102,39276,543,267,276
60590,46958,7677,22711,5102,39281,543,267,276
60595,46962,7677,22713,5102,39285,543,267,276
60600,46965,7678,22716,5103,39287,543,267,276
60605,46966,7678,22717,5103,39288,543,267,276
60610,46971,7678,22720,5103,39293,543,267,276
60615,46973,7679,22722,5104,39294,543,267,276
60620,46981,7679,22725,5104,39302,543,267,276
60625,46984,7680,22728,5105,39304,543,267,276
60630,46989,7680,22729,5105,39309,543,267,276
60635,46993,7680,22732,5105,39313,543,267,276
60640,46996,7681,22733,5105,39315,543,267,276
60645,46997,7681,22733,5105,39316,543,267,276
60650,47002,7681,22737,5105,39321,543,267,276
60655,47004,7682,22738,5105,39322,543,267,276
60660,47012,7682,22742,5105,39330,543,267,276
60665,47015,7683,22742,5105,39332,543,267,276
60670,47020,7683,22743,5105,39337,543,267,276
60675,47024,7683,22745,5105,39341,543,267,276
60680,47027,7684,22747,5106,39343,543,267,276
60685,47028,7684,22747,5106,39344,543,267,276
60690,47033,7684,22749,5106,39349,543,267,276
60695,47035,7685,22749,5106,39350,543,267,276
60700,47043,7685,22751,5106,39358,543,267,276
60705,47046,7686,22751,5106,39360,543,267,276
60710,47051,7686,22755,5106,39365,543,267,276
60715,47055,7686,22756,5106,39369,543,267,276
60720,47058,7687,22758,5107,39371,543,267,276
60725,47059,7687,22759,5107,39372,543,267,276
60730,47064,7687,22762,5107,39377,543,267,276
60735,47066,7688,22763,5107,39378,543,267,276
60740,47074,7688,22767,5107,39386,543,267,276
60745,47077,7689,22768,5108,39388,543,267,276
60750,47082,7689,22769,5108,39393,543,267,276
60755,47086,7689,22772,5108,39397,543,267,276
60760,47089,7690,22774,5108,39399,543,267,276
60765,47090,7690,22775,5108,39400,543,267,276
60770,47095,7690,22777,5108,39405,543,267,276
60775,47097,7691,22778,5109,39406,543,267,276
60780,47105,7691,22781,5109,39414,543,267,276
60785,47108,7691,22784,5109,39417,543,267,276
60790,47113,7691,22787,5109,39422,543,267,276
60795,47117,7691,22788,5109,39426,543,267,276
60800,47120,7692,22790,5110,39428,543,267,276
60805,47121,7692,22790,5110,39429,543,267,276
60810,47126,7692,22792,5110,39434,543,267,276
60815,47128,7693,22794,5111,39435,543,267,276
60820,47136,7693,22797,5111,39443,543,267,276
60825,47139,7693,22797,5111,39446,543,267,276
60830,47144,7693,22799,5111,39451,543,267,276
60835,47148,7693,22801,5111,39455,543,267,276
60840,47151,7694,22802,5111,39457,543,267,276
60845,47152,7694,22803,5111,39458,543,267,276
60850,47157,7694,22805,5111,39463,543,267,276
60855,47159,7695,22805,5111,39464,543,267,276
60860,47167,7695,22807,5111,39472,543,267,276
60865,47170,7695,22808,5111,39475,543,267,276
60870,47175,7695,22811,5111,39480,543,267,276
60875,47179,7695,22812,5111,39484,543,267,276
60880,47182,7696,22813,5111,39486,543,267,276
60885,47183,7696,22813,5111,39487,543,267,276
60890,47188,7696,22814,5111,39492,543,267,276
60895,47190,7697,22816,5112,39493,543,267,276
60900,47198,7697,22820,5112,39501,543,267,276
60905,47201,7698,22821,5113,39503,543,267,276
60910,47206,7698,22825,5113,39508,543,267,276
60915,47210,7698,22828,5113,39512,543,267,276
60920,47213,7699,22829,5113,39514,543,267,276
60925,47214,7699,22830,5113,39515,543,267,276
60930,47219,7699,22834,5113,39520,543,267,276
60935,47221,7700,22835,5113,39521,543,267,276
60940,47229,7700,22839,5113,39529,543,267,276
60945,47232,7701,22841,5114,39531,543,267,276
60950,47237,7701,22843,5114,39536,543,267,276
60955,47241,7701,22847,5114,39540,543,267,276
60960,47244,7702,22849,5115,39542,543,267,276
60965,47245,7702,22849,5115,39543,543,267,276
60970,47250,7702,22850,5115,39548,543,267,276
60975,47252,7703,22851,5115,39549,543,267,276
60980,47260,7703,22855,5115,39557,543,267,276
60985,47263,7704,22855,5115,39559,543,267,276
60990,47268,7704,22857,5115,39564,543,267,276
60995,47272,7704,22858,5115,39568,543,267,276
61000,47275,7705,22859,5115,39570,543,267,276
61005,47276,7705,22859,5115,39571,543,267,276
61010,47281,7705,22860,5115,39576,543,267,276
61015,47283,7706,22862,5116,39577,543,267,276
61020,47291,7706,22866,5116,39585,543,267,276
61025,47294,7707,22867,5116,39587,543,267,276
61030,47299,7707,22870,5116,39592,543,267,276
61035,47303,7707,22871,5116,39596,543,267,276
61040,47306,7708,22872,5117,39598,543,267,276
61045,47307,7708,22872,5117,39599,543,267,276
61050,47312,7708,22874,5117,39604,543,267,276
61055,47314,7709,22876,5118,39605,543,267,276
61060,47322,7709,22879,5118,39613,543,267,276
61065,47325,7710,22881,5118,39615,543,267,276
61070,47330,7710,22882,5118,39620,543,267,276
61075,47334,7710,22884,5118,39624,543,267,276
61080,47337,7711,22887,5119,39626,543,267,276
61085,47338,7711,22888,5119,39627,543,267,276
61090,47343,7711,22889,5119,39632,543,267,276
61095,47345,7712,22890,5120,39633,543,267,276
61100,47353,7712,22894,5120,39641,543,267,276
61105,47356,7712,22895,5120,39644,543,267,276
61110,47361,7712,22897,5120,39649,543,267,276
61115,47365,7712,22900,5120,39653,543,267,276
61120,47368,7713,22901,5121,39655,543,267,276
61125,47369,7713,22901,5121,39656,543,267,276
61130,47374,7713,22903,5121,39661,543,267,276
61135,47376,7714,22904,5121,39662,543,267,276
61140,47384,7714,22907,5121,39670,543,267,276
61145,47387,7714,22908,5121,39673,543,267,276
61150,47392,7714,22911,5121,39678,543,267,276
61155,47396,7714,22914,5121,39682,543,267,276
61160,47399,7715,22915,5121,39684,543,267,276
61165,47400,7715,22915,5121,39685,543,267,276
61170,47405,7715,22916,5121,39690,543,267,276
61175,47407,7716,22917,5122,39691,543,267,276
61180,47415,7716,22920,5122,39699,543,267,276
61185,47418,7716,22921,5122,39702,543,267,276
61190,47423,7716,22923,5122,39707,543,267,276
61195,47427,7716,22925,5122,39711,543,267,276
61200,47430,7717,22925,5122,39713,543,267,276
61205,47431,7717,22925,5122,39714,543,267,276
61210,47436,7717,22925,5122,39719,543,267,276
61215,47438,7718,22926,5123,39720,543,267,276
61220,47446,7718,22929,5123,39728,543,267,276
61225,47449,7719,22929,5123,39730,543,267,276
61230,47454,7719,22931,5123,39735,543,267,276
61235,47458,7719,22933,5123,39739,543,267,276
61240,47461,7720,22935,5123,39741,543,267,276
61245,47462,7720,22936,5123,39742,543,267,276
61250,47467,7720,22939,5123,39747,543,267,276
61255,47469,7721,22940,5123,39748,543,267,276
61260,47477,7721,22942,5123,39756,543,267,276
61265,47480,7722,22943,5123,39758,543,267,276
61270,47485,7722,22946,5123,39763,543,267,276
61275,47489,7722,22947,5123,39767,543,267,276
61280,47492,7723,22950,5124,39769,543,267,276
61285,47493,7723,22951,5124,39770,543,267,276
61290,47498,7723,22955,5124,39775,543,267,276
61295,47500,7724,22956,5125,39776,543,267,276
61300,47508,7724,22959,5125,39784,543,267,276
61305,47511,7725,22960,5125,39786,543,267,276
61310,47516,7725,22961,5125,39791,543,267,276
61315,47520,7725,22961,5125,39795,543,267,276
61320,47523,7726,22961,5125,39797,543,267,276
61325,47524,7726,22962,5125,39798,543,267,276
61330,47529,7726,22963,5125,39803,543,267,276
61335,47531,7727,22964,5125,39804,543,267,276
61340,47539,7727,22965,5125,39812,543,267,276
61345,47542,7728,22968,5126,39814,543,267,276
61350,47547,7728,22968,5126,39819,543,267,276
61355,47551,7728,22970,5126,39823,543,267,276
61360,47554,7729,22971,5126,39825,543,267,276
61365,47555,7729,22972,5126,39826,543,267,276
61370,47560,7729,22974,5126,39831,543,267,276
61375,47562,7730,22974,5126,39832,543,267,276
61380,47570,7730,22976,5126,39840,543,267,276
61385,47573,7730,22978,5126,39843,543,267,276
61390,47578,7730,22982,5126,39848,543,267,276
61395,47582,7730,22983,5126,39852,543,267,276
61400,47585,7731,22985,5127,39854,543,267,276
61405,47586,7731,22986,5127,39855,543,267,276
61410,47591,7731,22988,5127,39860,543,267,276
61415,47593,7732,22989,5127,39861,543,267,276
61420,47601,7732,22994,5127,39869,543,267,276
61425,47604,7732,22997,5127,39872,543,267,276
61430,47609,7732,22999,5127,39877,543,267,276
61435,47613,7732,23001,5127,39881,543,267,276
61440,47616,7733,23004,5128,39883,543,267,276
61445,47617,7733,23004,5128,39884,543,267,276
61450,47622,7733,23005,5128,39889,543,267,276
61455,47624,7734,23007,5129,39890,543,267,276
61460,47632,7734,23011,5129,39898,543,267,276
61465,47635,7734,23014,5129,39901,543,267,276
61470,47640,7734,23017,5129,39906,543,267,276
61475,47644,7734,23018,5129,39910,543,267,276
61480,47647,7735,23019,5130,39912,543,267,276
61485,47648,7735,23019,5130,39913,543,267,276
61490,47653,7735,23022,5130,39918,543,267,276
61495,47655,7736,23023,5131,39919,543,267,276
61500,47663,7736,23026,5131,39927,543,267,276
61505,47666,7737,23028,5132,39929,543,267,276
61510,47671,7737,23029,5132,39934,543,267,276
61515,47675,7737,23032,5132,39938,543,267,276
61520,47678,7738,23035,5133,39940,543,267,276
61525,47679,7738,23036,5133,39941,543,267,276
61530,47684,7738,23039,5133,39946,543,267,276
61535,47686,7739,23040,5133,39947,543,267,276
61540,47694,7739,23044,5133,39955,543,267,276
61545,47697,7740,23045,5133,39957,543,267,276
61550,47702,7740,23048,5133,39962,543,267,276
61555,47706,7740,23051,5133,39966,543,267,276
61560,47709,7741,23052,5133,39968,543,267,276
61565,47710,7741,23053,5133,39969,543,267,276
61570,47715,7741,23057,5133,39974,543,267,276
61575,47717,7742,23058,5133,39975,543,267,276
61580,47725,7742,23062,5133,39983,543,267,276
61585,47728,7743,23065,5134,39985,543,267,276
61590,47733,7743,23068,5134,39990,543,267,276
61595,47737,7743,23070,5134,39994,543,267,276
61600,47740,7744,23071,5135,39996,543,267,276
61605,47741,7744,23072,5135,39997,543,267,276
61610,47746,7744,23076,5135,40002,543,267,276
61615,47748,7745,23077,5136,40003,543,267,276
61620,47756,7745,23081,5136,40011,543,267,276
61625,47759,7746,23083,5136,40013,543,267,276
61630,47764,7746,23086,5136,40018,543,267,276
61635,47768,7746,23087,5136,40022,543,267,276
61640,47771,7747,23089,5136,40024,543,267,276
61645,47772,7747,23089,5136,40025,543,267,276
61650,47777,7747,23092,5136,40030,543,267,276
61655,47779,7748,23093,5137,40031,543,267,276
61660,47787,7748,23096,5137,40039,543,267,276
61665,47790,7749,23097,5138,40041,543,267,276
61670,47795,7749,23101,5138,40046,543,267,276
61675,47799,7749,23104,5138,40050,543,267,276
61680,47802,7750,23105,5138,40052,543,267,276
61685,47803,7750,23106,5138,40053,543,267,276
61690,47808,7750,23108,5138,40058,543,267,276
61695,47810,7751,23109,5139,40059,543,267,276
61700,47818,7751,23112,5139,40067,543,267,276
61705,47821,7751,23114,5139,40070,543,267,276
61710,47826,7751,23117,5139,40075,543,267,276
61715,47830,7751,23120,5139,40079,543,267,276
61720,47833,7752,23122,5139,40081,543,267,276
61725,47834,7752,23123,5139,40082,543,267,276
61730,47839,7752,23125,5139,40087,543,267,276
61735,47841,7753,23126,5140,40088,543,267,276
61740,47849,7753,23130,5140,40096,543,267,276
61745,47852,7753,23131,5140,40099,543,267,276
61750,47857,7753,23133,5140,40104,543,267,276
61755,47861,7753,23135,5140,40108,543,267,276
61760,47864,7754,23137,5140,40110,543,267,276
61765,47865,7754,23138,5140,40111,543,267,276
61770,47870,7754,23139,5140,40116,543,267,276
61775,47872,7755,23140,5140,40117,543,267,276
61780,47880,7755,23143,5140,40125,543,267,276
61785,47883,7755,23143,5140,40128,543,267,276
61790,47888,7755,23144,5140,40133,543,267,276
61795,47892,7755,23145,5140,40137,543,267,276
61800,47895,7756,23146,5141,40139,543,267,276
61805,47896,7756,23146,5141,40140,543,267,276
61810,47901,7756,23148,5141,40145,543,267,276
61815,47903,7757,23149,5142,40146,543,267,276
61820,47911,7757,23149,5142,40154,543,267,276
61825,47914,7758,23150,5142,40156,543,267,276
61830,47919,7758,23153,5142,40161,543,267,276
61835,47923,7758,23156,5142,40165,543,267,276
61840,47926,7759,23157,5142,40167,543,267,276
61845,47927,7759,23157,5142,40168,543,267,276
61850,47932,7759,23159,5142,40173,543,267,276
61855,47934,7760,23160,5142,40174,543,267,276
61860,47942,7760,23166,5142,40182,543,267,276
61865,47945,7761,23167,5142,40184,543,267,276
61870,47950,7761,23170,5142,40189,543,267,276
61875,47954,7761,23172,5142,40193,543,267,276
61880,47957,7762,23174,5143,40195,543,267,276
61885,47958,7762,23174,5143,40196,543,267,276
61890,47963,7762,23177,5143,40201,543,267,276
61895,47965,7763,23178,5143,40202,543,267,276
61900,47973,7763,23180,5143,40210,543,267,276
61905,47976,7764,23181,5144,40212,543,267,276
61910,47981,7764,23184,5144,40217,543,267,276
61915,47985,7764,23186,5144,40221,543,267,276
61920,47988,7765,23188,5145,40223,543,267,276
61925,47989,7765,23189,5145,40224,543,267,276
61930,47994,7765,23192,5145,40229,543,267,276
61935,47996,7766,23192,5145,40230,543,267,276
61940,48004,7766,23195,5145,40238,543,267,276
61945,48007,7767,23196,5146,40240,543,267,276
61950,48012,7767,23200,5146,40245,543,267,276
61955,48016,7767,23202,5146,40249,543,267,276
61960,48019,7768,23203,5146,40251,543,267,276
61965,48020,7768,23204,5146,40252,543,267,276
61970,48025,7768,23206,5146,40257,543,267,276
61975,48027,7769,23206,5146,40258,543,267,276
61980,48035,7769,23209,5146,40266,543,267,276
61985,48038,7769,23212,5146,40269,543,267,276
61990,48043,7769,23216,5146,40274,543,267,276
61995,48047,7769,23217,5146,40278,543,267,276
62000,48050,7770,23219,5147,40280,543,267,276
62005,48051,7770,23219,5147,40281,543,267,276
62010,48056,7770,23222,5147,40286,543,267,276
62015,48058,7771,23224,5148,40287,543,267,276
62020,48066,7771,23226,5148,40295,543,267,276
62025,48069,7771,23228,5148,40298,543,267,276
62030,48074,7771,23231,5148,40303,543,267,276
62035,48078,7771,23232,5148,40307,543,267,276
62040,48081,7772,23234,5149,40309,543,267,276
62045,48082,7772,23235,5149,40310,543,267,276
62050,48087,7772,23235,5149,40315,543,267,276
62055,48089,7773,23235,5149,40316,543,267,276
62060,48097,7773,23241,5149,40324,543,267,276
62065,48100,7773,23243,5149,40327,543,267,276
62070,48105,7773,23246,5149,40332,543,267,276
62075,48109,7773,23246,5149,40336,543,267,276
62080,48112,7774,23249,5150,40338,543,267,276
62085,48113,7774,23249,5150,40339,543,267,276
62090,48118,7774,23252,5150,40344,543,267,276
62095,48120,7775,23253,5151,40345,543,267,276
62100,48128,7775,23256,5151,40353,543,267,276
62105,48131,7776,23259,5152,40355,543,267,276
62110,48136,7776,23262,5152,40360,543,267,276
62115,48140,7776,23265,5152,40364,543,267,276
62120,48143,7777,23266,5152,40366,543,267,276
62125,48144,7777,23267,5152,40367,543,267,276
62130,48149,7777,23271,5152,40372,543,267,276
62135,48151,7778,23272,5152,40373,543,267,276
62140,48159,7778,23277,5152,40381,543,267,276
62145,48162,7779,23277,5152,40383,543,267,276
62150,48167,7779,23281,5152,40388,543,267,276
62155,48171,7779,23285,5152,40392,543,267,276
62160,48174,7780,23286,5152,40394,543,267,276
62165,48175,7780,23287,5152,40395,543,267,276
62170,48180,7780,23289,5152,40400,543,267,276
62175,48182,7781,23290,5153,40401,543,267,276
62180,48190,7781,23291,5153,40409,543,267,276
62185,48193,7782,23293,5153,40411,543,267,276
62190,48198,7782,23295,5153,40416,543,267,276
62195,48202,7782,23296,5153,40420,543,267,276
62200,48205,7783,23296,5153,40422,543,267,276
62205,48206,7783,23297,5153,40423,543,267,276
62210,48211,7783,23297,5153,40428,543,267,276
62215,48213,7784,23299,5154,40429,543,267,276
62220,48221,7784,23302,5154,40437,543,267,276
62225,48224,7785,23302,5154,40439,543,267,276
62230,48229,7785,23304,5154,40444,543,267,276
62235,48233,7785,23306,5154,40448,543,267,276
62240,48236,7786,23307,5154,40450,543,267,276
62245,48237,7786,23308,5154,40451,543,267,276
62250,48242,7786,23313,5154,40456,543,267,276
62255,48244,7787,23314,5155,40457,543,267,276
62260,48252,7787,23317,5155,40465,543,267,276
62265,48255,7788,23318,5155,40467,543,267,276
62270,48260,7788,23322,5155,40472,543,267,276
62275,48264,7788,23323,5155,40476,543,267,276
62280,48267,7789,23324,5155,40478,543,267,276
62285,48268,7789,23325,5155,40479,543,267,276
62290,48273,7789,23329,5155,40484,543,267,276
62295,48275,7790,23330,5155,40485,543,267,276
62300,48283,7790,23333,5155,40493,543,267,276
62305,48286,7790,23335,5155,40496,543,267,276
62310,48291,7790,23337,5155,40501,543,267,276
62315,48295,7790,23338,5155,40505,543,267,276
62320,48298,7791,23340,5156,40507,543,267,276
62325,48299,7791,23341,5156,40508,543,267,276
62330,48304,7791,23342,5156,40513,543,267,276
62335,48306,7792,23343,5157,40514,543,267,276
62340,48314,7792,23348,5157,40522,543,267,276
62345,48317,7792,23350,5157,40525,543,267,276
62350,48322,7792,23352,5157,40530,543,267,276
62355,48326,7792,23353,5157,40534,543,267,276
62360,48329,7793,23355,5158,40536,543,267,276
62365,48330,7793,23356,5158,40537,543,267,276
62370,48335,7793,23357,5158,40542,543,267,276
62375,48337,7794,23358,5158,40543,543,267,276
62380,48345,7794,23364,5158,40551,543,267,276
62385,48348,7794,23365,5158,40554,543,267,276
62390,48353,7794,23369,5158,40559,543,267,276
62395,48357,7794,23371,5158,40563,543,267,276
62400,48360,7795,23372,5159,40565,543,267,276
62405,48361,7795,23373,5159,40566,543,267,276
62410,48366,7795,23374,5159,40571,543,267,276
62415,48368,7796,23374,5159,40572,543,267,276
62420,48376,7796,23376,5159,40580,543,267,276
62425,48379,7797,23377,5159,40582,543,267,276
62430,48384,7797,23380,5159,40587,543,267,276
62435,48388,7797,23381,5159,40591,543,267,276
62440,48391,7798,23382,5159,40593,543,267,276
62445,48392,7798,23382,5159,40594,543,267,276
62450,48397,7798,23385,5159,40599,543,267,276
62455,48399,7799,23385,5159,40600,543,267,276
62460,48407,7799,23389,5159,40608,543,267,276
62465,48410,7800,23389,5159,40610,543,267,276
62470,48415,7800,23390,5159,40615,543,267,276
62475,48419,7800,23394,5159,40619,543,267,276
62480,48422,7801,23396,5160,40621,543,267,276
62485,48423,7801,23397,5160,40622,543,267,276
62490,48428,7801,23399,5160,40627,543,267,276
62495,48430,7802,23399,5160,40628,543,267,276
62500,48438,7802,23404,5160,40636,543,267,276
62505,48441,7803,23405,5161,40638,543,267,276
62510,48446,7803,23408,5161,40643,543,267,276
62515,48450,7803,23411,5161,40647,543,267,276
62520,48453,7803,23411,5161,40650,543,267,276
62525,48454,7803,23412,5161,40651,543,267,276
62530,48459,7803,23415,5161,40656,543,267,276
62535,48461,7803,23416,5161,40658,543,267,276
62540,48469,7803,23420,5161,40666,543,267,276
62545,48472,7803,23422,5161,40669,543,267,276
62550,48477,7803,23424,5161,40674,543,267,276
62555,48481,7803,23426,5161,40678,543,267,276
62560,48484,7803,23428,5161,40681,543,267,276
62565,48485,7803,23428,5161,40682,543,267,276
62570,48490,7803,23431,5161,40687,543,267,276
62575,48492,7803,23432,5161,40689,543,267,276
62580,48500,7803,23436,5161,40697,543,267,276
62585,48503,7803,23437,5161,40700,543,267,276
62590,48508,7803,23439,5161,40705,543,267,276
62595,48512,7803,23442,5161,40709,543,267,276
62600,48515,7803,23443,5161,40712,543,267,276
62605,48516,7803,23443,5161,40713,543,267,276
62610,48521,7803,23446,5161,40718,543,267,276
62615,48523,7803,23447,5161,40720,543,267,276
62620,48531,7803,23451,5161,40728,543,267,276
62625,48534,7803,23453,5161,40731,543,267,276
62630,48539,7803,23456,5161,40736,543,267,276
62635,48543,7803,23458,5161,40740,543,267,276
62640,48546,7803,23460,5161,40743,543,267,276
62645,48547,7803,23460,5161,40744,543,267,276
62650,48552,7803,23462,5161,40749,543,267,276
62655,48554,7803,23464,5161,40751,543,267,276
62660,48562,7803,23467,5161,40759,543,267,276
62665,48565,7803,23470,5161,40762,543,267,276
62670,48570,7803,23471,5161,40767,543,267,276
62675,48574,7803,23471,5161,40771,543,267,276
62680,48577,7803,23472,5161,40774,543,267,276
62685,48578,7803,23473,5161,40775,543,267,276
62690,48583,7803,23473,5161,40780,543,267,276
62695,48585,7803,23474,5161,40782,543,267,276
62700,48593,7803,23477,5161,40790,543,267,276
62705,48596,7803,23479,5161,40793,543,267,276
62710,48601,7803,23482,5161,40798,543,267,276
62715,48605,7803,23482,5161,40802,543,267,276
62720,48608,7803,23483,5161,40805,543,267,276
62725,48609,7803,23483,5161,40806,543,267,276
62730,48614,7803,23487,5161,40811,543,267,276
62735,48616,7803,23489,5161,40813,543,267,276
62740,48624,7803,23493,5161,40821,543,267,276
62745,48627,7803,23494,5161,40824,543,267,276
62750,48632,7803,23496,5161,40829,543,267,276
62755,48636,7803,23500,5161,40833,543,267,276
62760,48639,7803,23501,5161,40836,543,267,276
62765,48640,7803,23501,5161,40837,543,267,276
62770,48645,7803,23505,5161,40842,543,267,276
62775,48647,7803,23505,5161,40844,543,267,276
62780,48655,7803,23509,5161,40852,543,267,276
62785,48658,7803,23511,5161,40855,543,267,276
62790,48663,7803,23513,5161,40860,543,267,276
62795,48667,7803,23514,5161,40864,543,267,276
62800,48670,7803,23516,5161,40867,543,267,276
62805,48671,7803,23516,5161,40868,543,267,276
62810,48676,7803,23520,5161,40873,543,267,276
62815,48678,7803,23522,5161,40875,543,267,276
62820,48686,7803,23527,5161,40883,543,267,276
62825,48689,7803,23527,5161,40886,543,267,276
62830,48694,7803,23530,5161,40891,543,267,276
62835,48698,7803,23531,5161,40895,543,267,276
62840,48701,7803,23534,5161,40898,543,267,276
62845,48702,7803,23534,5161,40899,543,267,276
62850,48707,7803,23536,5161,40904,543,267,276
62855,48709,7803,23537,5161,40906,543,267,276
62860,48717,7803,23541,5161,40914,543,267,276
62865,48720,7803,23542,5161,40917,543,267,276
62870,48725,7803,23545,5161,40922,543,267,276
62875,48729,7803,23547,5161,40926,543,267,276
62880,48732,7803,23550,5161,40929,543,267,276
62885,48733,7803,23551,5161,40930,543,267,276
62890,48738,7803,23554,5161,40935,543,267,276
62895,48740,7803,23555,5161,40937,543,267,276
62900,48748,7803,23560,5161,40945,543,267,276
62905,48751,7803,23561,5161,40948,543,267,276
62910,48756,7803,23563,5161,40953,543,267,276
62915,48760,7803,23564,5161,40957,543,267,276
62920,48763,7803,23566,5161,40960,543,267,276
62925,48764,7803,23566,5161,40961,543,267,276
62930,48769,7803,23570,5161,40966,543,267,276
62935,48771,7803,23570,5161,40968,543,267,276
62940,48779,7803,23574,5161,40976,543,267,276
62945,48782,7803,23576,5161,40979,543,267,276
62950,48787,7803,23577,5161,40984,543,267,276
62955,48791,7803,23579,5161,40988,543,267,276
62960,48794,7803,23579,5161,40991,543,267,276
62965,48795,7803,23580,5161,40992,543,267,276
62970,48800,7803,23580,5161,40997,543,267,276
62975,48802,7803,23581,5161,40999,543,267,276
62980,48810,7803,23584,5161,41007,543,267,276
62985,48813,7803,23586,5161,41010,543,267,276
62990,48818,7803,23589,5161,41015,543,267,276
62995,48822,7803,23591,5161,41019,543,267,276
63000,48825,7803,23594,5161,41022,543,267,276
63005,48826,7803,23594,5161,41023,543,267,276
63010,48831,7803,23598,5161,41028,543,267,276
63015,48833,7803,23599,5161,41030,543,267,276
63020,48841,7803,23602,5161,41038,543,267,276
63025,48844,7803,23604,5161,41041,543,267,276
63030,48849,7803,23605,5161,41046,543,267,276
63035,48853,7803,23607,5161,41050,543,267,276
63040,48856,7803,23607,5161,41053,543,267,276
63045,48857,7803,23607,5161,41054,543,267,276
63050,48862,7803,23608,5161,41059,543,267,276
63055,48864,7803,23608,5161,41061,543,267,276
63060,48872,7803,23610,5161,41069,543,267,276
63065,48875,7803,23611,5161,41072,543,267,276
63070,48880,7803,23613,5161,41077,543,267,276
63075,48884,7803,23616,5161,41081,543,267,276
63080,48887,7803,23617,5161,41084,543,267,276
63085,48888,7803,23617,5161,41085,543,267,276
63090,48893,7803,23619,5161,41090,543,267,276
63095,48895,7803,23619,5161,41092,543,267,276
63100,48903,7803,23623,5161,41100,543,267,276
63105,48906,7803,23623,5161,41103,543,267,276
63110,48911,7803,23624,5161,41108,543,267,276
63115,48915,7803,23627,5161,41112,543,267,276
63120,48918,7803,23628,5161,41115,543,267,276
63125,48919,7803,23628,5161,41116,543,267,276
63130,48924,7803,23630,5161,41121,543,267,276
63135,48926,7803,23631,5161,41123,543,267,276
63140,48934,7803,23638,5161,41131,543,267,276
63145,48937,7803,23640,5161,41134,543,267,276
63150,48942,7803,23641,5161,41139,543,267,276
63155,48946,7803,23642,5161,41143,543,267,276
63160,48949,7803,23642,5161,41146,543,267,276
63165,48950,7803,23643,5161,41147,543,267,276
63170,48955,7803,23647,5161,41152,543,267,276
63175,48957,7803,23649,5161,41154,543,267,276
63180,48965,7803,23651,5161,41162,543,267,276
63185,48968,7803,23653,5161,41165,543,267,276
63190,48973,7803,23654,5161,41170,543,267,276
63195,48977,7803,23656,5161,41174,543,267,276
63200,48980,7803,23656,5161,41177,543,267,276
63205,48981,7803,23656,5161,41178,543,267,276
63210,48986,7803,23657,5161,41183,543,267,276
63215,48988,7803,23657,5161,41185,543,267,276
63220,48996,7803,23661,5161,41193,543,267,276
63225,48999,7803,23662,5161,41196,543,267,276
63230,49004,7803,23665,5161,41201,543,267,276
63235,49008,7803,23669,5161,41205,543,267,276
63240,49011,7803,23672,5161,41208,543,267,276
63245,49012,7803,23673,5161,41209,543,267,276
63250,49017,7803,23677,5161,41214,543,267,276
63255,49019,7803,23679,5161,41216,543,267,276
63260,49027,7803,23681,5161,41224,543,267,276
63265,49030,7803,23683,5161,41227,543,267,276
63270,49035,7803,23685,5161,41232,543,267,276
63275,49039,7803,23686,5161,41236,543,267,276
63280,49042,7803,23688,5161,41239,543,267,276
63285,49043,7803,23688,5161,41240,543,267,276
63290,49048,7803,23693,5161,41245,543,267,276
63295,49050,7803,23694,5161,41247,543,267,276
63300,49058,7803,23700,5161,41255,543,267,276
63305,49061,7803,23702,5161,41258,543,267,276
63310,49066,7803,23704,5161,41263,543,267,276
63315,49070,7803,23705,5161,41267,543,267,276
63320,49073,7803,23706,5161,41270,543,267,276
63325,49074,7803,23706,5161,41271,543,267,276
63330,49079,7803,23709,5161,41276,543,267,276
63335,49081,7803,23710,5161,41278,543,267,276
63340,49089,7803,23715,5161,41286,543,267,276
63345,49092,7803,23716,5161,41289,543,267,276
63350,49097,7803,23720,5161,41294,543,267,276
63355,49101,7803,23723,5161,41298,543,267,276
63360,49104,7803,23725,5161,41301,543,267,276
63365,49105,7803,23725,5161,41302,543,267,276
63370,49110,7803,23727,5161,41307,543,267,276
63375,49112,7803,23729,5161,41309,543,267,276
63380,49120,7803,23733,5161,41317,543,267,276
63385,49123,7803,23734,5161,41320,543,267,276
63390,49128,7803,23737,5161,41325,543,267,276
63395,49132,7803,23739,5161,41329,543,267,276
63400,49135,7803,23740,5161,41332,543,267,276
63405,49136,7803,23741,5161,41333,543,267,276
63410,49141,7803,23743,5161,41338,543,267,276
63415,49143,7803,23743,5161,41340,543,267,276
63420,49151,7803,23748,5161,41348,543,267,276
63425,49154,7803,23749,5161,41351,543,267,276
63430,49159,7803,23753,5161,41356,543,267,276
63435,49163,7803,23757,5161,41360,543,267,276
63440,49166,7803,23760,5161,41363,543,267,276
63445,49167,7803,23761,5161,41364,543,267,276
63450,49172,7803,23762,5161,41369,543,267,276
63455,49174,7803,23762,5161,41371,543,267,276
63460,49182,7803,23764,5161,41379,543,267,276
63465,49185,7803,23766,5161,41382,543,267,276
63470,49190,7803,23769,5161,41387,543,267,276
63475,49194,7803,23770,5161,41391,543,267,276
63480,49197,7803,23770,5161,41394,543,267,276
63485,49198,7803,23770,5161,41395,543,267,276
63490,49203,7803,23772,5161,41400,543,267,276
63495,49205,7803,23774,5161,41402,543,267,276
63500,49213,7803,23776,5161,41410,543,267,276
63505,49216,7803,23777,5161,41413,543,267,276
63510,49221,7803,23781,5161,41418,543,267,276
63515,49225,7803,23784,5161,41422,543,267,276
63520,49228,7803,23786,5161,41425,543,267,276
63525,49229,7803,23786,5161,41426,543,267,276
63530,49234,7803,23790,5161,41431,543,267,276
63535,49236,7803,23792,5161,41433,543,267,276
63540,49244,7803,23796,5161,41441,543,267,276
63545,49247,7803,23796,5161,41444,543,267,276
63550,49252,7803,23797,5161,41449,543,267,276
63555,49256,7803,23799,5161,41453,543,267,276
63560,49259,7803,23802,5161,41456,543,267,276
63565,49260,7803,23803,5161,41457,543,267,276
63570,49265,7803,23806,5161,41462,543,267,276
63575,49267,7803,23806,5161,41464,543,267,276
63580,49275,7803,23811,5161,41472,543,267,276
63585,49278,7803,23812,5161,41475,543,267,276
63590,49283,7803,23815,5161,41480,543,267,276
63595,49287,7803,23816,5161,41484,543,267,276
63600,49290,7803,23817,5161,41487,543,267,276
63605,49291,7803,23817,5161,41488,543,267,276
63610,49296,7803,23820,5161,41493,543,267,276
63615,49298,7803,23820,5161,41495,543,267,276
63620,49306,7803,23823,5161,41503,543,267,276
63625,49309,7803,23825,5161,41506,543,267,276
63630,49314,7803,23827,5161,41511,543,267,276
63635,49318,7803,23828,5161,41515,543,267,276
63640,49321,7803,23830,5161,41518,543,267,276
63645,49322,7803,23831,5161,41519,543,267,276
63650,49327,7803,23833,5161,41524,543,267,276
63655,49329,7803,23833,5161,41526,543,267,276
63660,49337,7803,23835,5161,41534,543,267,276
63665,49340,7803,23837,5161,41537,543,267,276
63670,49345,7803,23839,5161,41542,543,267,276
63675,49349,7803,23840,5161,41546,543,267,276
63680,49352,7803,23842,5161,41549,543,267,276
63685,49353,7803,23842,5161,41550,543,267,276
63690,49358,7803,23845,5161,41555,543,267,276
63695,49360,7803,23847,5161,41557,543,267,276
63700,49368,7803,23850,5161,41565,543,267,276
63705,49371,7803,23852,5161,41568,543,267,276
63710,49376,7803,23855,5161,41573,543,267,276
63715,49380,7803,23858,5161,41577,543,267,276
63720,49383,7803,23860,5161,41580,543,267,276
63725,49384,7803,23860,5161,41581,543,267,276
63730,49389,7803,23864,5161,41586,543,267,276
63735,49391,7803,23864,5161,41588,543,267,276
63740,49399,7803,23869,5161,41596,543,267,276
63745,49402,7803,23869,5161,41599,543,267,276
63750,49407,7803,23873,5161,41604,543,267,276
63755,49411,7803,23876,5161,41608,543,267,276
63760,49414,7803,23876,5161,41611,543,267,276
63765,49415,7803,23877,5161,41612,543,267,276
63770,49420,7803,23881,5161,41617,543,267,276
63775,49422,7803,23883,5161,41619,543,267,276
63780,49430,7803,23884,5161,41627,543,267,276
63785,49433,7803,23886,5161,41630,543,267,276
63790,49438,7803,23888,5161,41635,543,267,276
63795,49442,7803,23890,5161,41639,543,267,276
63800,49445,7803,23892,5161,41642,543,267,276
63805,49446,7803,23893,5161,41643,543,267,276
63810,49451,7803,23894,5161,41648,543,267,276
63815,49453,7803,23895,5161,41650,543,267,276
63820,49461,7803,23899,5161,41658,543,267,276
63825,49464,7803,23901,5161,41661,543,267,276
63830,49469,7803,23902,5161,41666,543,267,276
63835,49473,7803,23903,5161,41670,543,267,276
63840,49476,7803,23904,5161,41673,543,267,276
63845,49477,7803,23904,5161,41674,543,267,276
63850,49482,7803,23908,5161,41679,543,267,276
63855,49484,7803,23909,5161,41681,543,267,276
63860,49492,7803,23912,5161,41689,543,267,276
63865,49495,7803,23913,5161,41692,543,267,276
63870,49500,7803,23916,5161,41697,543,267,276
63875,49504,7803,23918,5161,41701,543,267,276
63880,49507,7803,23920,5161,41704,543,267,276
63885,49508,7803,23921,5161,41705,543,267,276
63890,49513,7803,23923,5161,41710,543,267,276
63895,49515,7803,23923,5161,41712,543,267,276
63900,49523,7803,23928,5161,41720,543,267,276
63905,49526,7803,23930,5161,41723,543,267,276
63910,49531,7803,23930,5161,41728,543,267,276
63915,49535,7803,23931,5161,41732,543,267,276
63920,49538,7803,23932,5161,41735,543,267,276
63925,49539,7803,23933,5161,41736,543,267,276
63930,49544,7803,23937,5161,41741,543,267,276
63935,49546,7803,23939,5161,41743,543,267,276
63940,49554,7803,23942,5161,41751,543,267,276
63945,49557,7803,23944,5161,41754,543,267,276
63950,49562,7803,23945,5161,41759,543,267,276
63955,49566,7803,23947,5161,41763,543,267,276
63960,49569,7803,23948,5161,41766,543,267,276
63965,49570,7803,23948,5161,41767,543,267,276
63970,49575,7803,23950,5161,41772,543,267,276
63975,49577,7803,23950,5161,41774,543,267,276
63980,49585,7803,23954,5161,41782,543,267,276
63985,49588,7803,23955,5161,41785,543,267,276
63990,49593,7803,23959,5161,41790,543,267,276
63995,49597,7803,23963,5161,41794,543,267,276
64000,49600,7803,23965,5161,41797,543,267,276
64005,49601,7803,23965,5161,41798,543,267,276
64010,49606,7803,23968,5161,41803,543,267,276
64015,49608,7803,23969,5161,41805,543,267,276
64020,49616,7803,23971,5161,41813,543,267,276
64025,49619,7803,23972,5161,41816,543,267,276
64030,49624,7803,23976,5161,41821,543,267,276
64035,49628,7803,23977,5161,41825,543,267,276
64040,49631,7803,23979,5161,41828,543,267,276
64045,49632,7803,23980,5161,41829,543,267,276
64050,49637,7803,23982,5161,41834,543,267,276
64055,49639,7803,23982,5161,41836,543,267,276
64060,49647,7803,23985,5161,41844,543,267,276
64065,49650,7803,23987,5161,41847,543,267,276
64070,49655,7803,23991,5161,41852,543,267,276
64075,49659,7803,23992,5161,41856,543,267,276
64080,49662,7803,23993,5161,41859,543,267,276
64085,49663,7803,23994,5161,41860,543,267,276
64090,49668,7803,23998,5161,41865,543,267,276
64095,49670,7803,23999,5161,41867,543,267,276
64100,49678,7803,24004,5161,41875,543,267,276
64105,49681,7803,24006,5161,41878,543,267,276
64110,49686,7803,24008,5161,41883,543,267,276
64115,49690,7803,24010,5161,41887,543,267,276
64120,49693,7803,24012,5161,41890,543,267,276
64125,49694,7803,24013,5161,41891,543,267,276
64130,49699,7803,24015,5161,41896,543,267,276
64135,49701,7803,24017,5161,41898,543,267,276
64140,49709,7803,24022,5161,41906,543,267,276
64145,49712,7803,24023,5161,41909,543,267,276
64150,49717,7803,24024,5161,41914,543,267,276
64155,49721,7803,24026,5161,41918,543,267,276
64160,49724,7803,24028,5161,41921,543,267,276
64165,49725,7803,24028,5161,41922,543,267,276
64170,49730,7803,24030,5161,41927,543,267,276
64175,49732,7803,24031,5161,41929,543,267,276
64180,49740,7803,24035,5161,41937,543,267,276
64185,49743,7803,24036,5161,41940,543,267,276
64190,49748,7803,24038,5161,41945,543,267,276
64195,49752,7803,24040,5161,41949,543,267,276
64200,49755,7803,24040,5161,41952,543,267,276
64205,49756,7803,24040,5161,41953,543,267,276
64210,49761,7803,24042,5161,41958,543,267,276
64215,49763,7803,24044,5161,41960,543,267,276
64220,49771,7803,24045,5161,41968,543,267,276
64225,49774,7803,24048,5161,41971,543,267,276
64230,49779,7803,24050,5161,41976,543,267,276
64235,49783,7803,24053,5161,41980,543,267,276
64240,49786,7803,24054,5161,41983,543,267,276
64245,49787,7803,24055,5161,41984,543,267,276
64250,49792,7803,24058,5161,41989,543,267,276
64255,49794,7803,24059,5161,41991,543,267,276
64260,49802,7803,24063,5161,41999,543,267,276
64265,49805,7803,24065,5161,42002,543,267,276
64270,49810,7803,24067,5161,42007,543,267,276
64275,49814,7803,24067,5161,42011,543,267,276
64280,49817,7803,24069,5161,42014,543,267,276
64285,49818,7803,24069,5161,42015,543,267,276
64290,49823,7803,24072,5161,42020,543,267,276
64295,49825,7803,24074,5161,42022,543,267,276
64300,49833,7803,24076,5161,42030,543,267,276
64305,49836,7803,24078,5161,42033,543,267,276
64310,49841,7803,24081,5161,42038,543,267,276
64315,49845,7803,24082,5161,42042,543,267,276
64320,49848,7803,24083,5161,42045,543,267,276
64325,49849,7803,24083,5161,42046,543,267,276
64330,49854,7803,24086,5161,42051,543,267,276
64335,49856,7803,24086,5161,42053,543,267,276
64340,49864,7803,24087,5161,42061,543,267,276
64345,49867,7803,24088,5161,42064,543,267,276
64350,49872,7803,24091,5161,42069,543,267,276
64355,49876,7803,24092,5161,42073,543,267,276
64360,49879,7803,24092,5161,42076,543,267,276
64365,49880,7803,24092,5161,42077,543,267,276
64370,49885,7803,24096,5161,42082,543,267,276
64375,49887,7803,24097,5161,42084,543,267,276
64380,49895,7803,24102,5161,42092,543,267,276
64385,49898,7803,24103,5161,42095,543,267,276
64390,49903,7803,24104,5161,42100,543,267,276
64395,49907,7803,24107,5161,42104,543,267,276
64400,49910,7803,24108,5161,42107,543,267,276
64405,49911,7803,24108,5161,42108,543,267,276
64410,49916,7803,24110,5161,42113,543,267,276
64415,49918,7803,24112,5161,42115,543,267,276
64420,49926,7803,24117,5161,42123,543,267,276
64425,49929,7803,24118,5161,42126,543,267,276
64430,49934,7803,24120,5161,42131,543,267,276
64435,49938,7803,24123,5161,42135,543,267,276
64440,49941,7803,24125,5161,42138,543,267,276
64445,49942,7803,24125,5161,42139,543,267,276
64450,49947,7803,24128,5161,42144,543,267,276
64455,49949,7803,24129,5161,42146,543,267,276
64460,49957,7803,24134,5161,42154,543,267,276
64465,49960,7803,24137,5161,42157,543,267,276
64470,49965,7803,24140,5161,42162,543,267,276
64475,49969,7803,24141,5161,42166,543,267,276
64480,49972,7803,24142,5161,42169,543,267,276
64485,49973,7803,24142,5161,42170,543,267,276
64490,49978,7803,24145,5161,42175,543,267,276
64495,49980,7803,24147,5161,42177,543,267,276
64500,49988,7803,24150,5161,42185,543,267,276
64505,49991,7803,24151,5161,42188,543,267,276
64510,49996,7803,24152,5161,42193,543,267,276
64515,50000,7803,24152,5161,42197,543,267,276
64520,50003,7803,24154,5161,42200,543,267,276
64525,50004,7803,24155,5161,42201,543,267,276
64530,50009,7803,24159,5161,42206,543,267,276
64535,50011,7803,24159,5161,42208,543,267,276
64540,50019,7803,24163,5161,42216,543,267,276
64545,50022,7803,24164,5161,42219,543,267,276
64550,50027,7803,24166,5161,42224,543,267,276
64555,50031,7803,24168,5161,42228,543,267,276
64560,50034,7803,24168,5161,42231,543,267,276
64565,50035,7803,24169,5161,42232,543,267,276
64570,50040,7803,24169,5161,42237,543,267,276
64575,50042,7803,24169,5161,42239,543,267,276
64580,50050,7803,24173,5161,42247,543,267,276
64585,50053,7803,24174,5161,42250,543,267,276
64590,50058,7803,24177,5161,42255,543,267,276
64595,50062,7803,24179,5161,42259,543,267,276
64600,50065,7803,24179,5161,42262,543,267,276
64605,50066,7803,24180,5161,42263,543,267,276
64610,50071,7803,24181,5161,42268,543,267,276
64615,50073,7803,24183,5161,42270,543,267,276
64620,50081,7803,24185,5161,42278,543,267,276
64625,50084,7803,24187,5161,42281,543,267,276
64630,50089,7803,24187,5161,42286,543,267,276
64635,50093,7803,24190,5161,42290,543,267,276
64640,50096,7803,24191,5161,42293,543,267,276
64645,50097,7803,24191,5161,42294,543,267,276
64650,50102,7803,24193,5161,42299,543,267,276
64655,50104,7803,24194,5161,42301,543,267,276
64660,50112,7803,24196,5161,42309,543,267,276
64665,50115,7803,24197,5161,42312,543,267,276
64670,50120,7803,24199,5161,42317,543,267,276
64675,50124,7803,24201,5161,42321,543,267,276
64680,50127,7803,24203,5161,42324,543,267,276
64685,50128,7803,24204,5161,42325,543,267,276
64690,50133,7803,24207,5161,42330,543,267,276
64695,50135,7803,24208,5161,42332,543,267,276
64700,50143,7803,24213,5161,42340,543,267,276
64705,50146,7803,24215,5161,42343,543,267,276
64710,50151,7803,24216,5161,42348,543,267,276
64715,50155,7803,24218,5161,42352,543,267,276
64720,50158,7803,24220,5161,42355,543,267,276
64725,50159,7803,24221,5161,42356,543,267,276
64730,50164,7803,24224,5161,42361,543,267,276
64735,50166,7803,24225,5161,42363,543,267,276
64740,50174,7803,24227,5161,42371,543,267,276
64745,50177,7803,24228,5161,42374,543,267,276
64750,50182,7803,24229,5161,42379,543,267,276
64755,50186,7803,24231,5161,42383,543,267,276
64760,50189,7803,24232,5161,42386,543,267,276
64765,50190,7803,24232,5161,42387,543,267,276
64770,50195,7803,24235,5161,42392,543,267,276
64775,50197,7803,24236,5161,42394,543,267,276
64780,50205,7803,24239,5161,42402,543,267,276
64785,50208,7803,24241,5161,42405,543,267,276
64790,50213,7803,24241,5161,42410,543,267,276
64795,50217,7803,24242,5161,42414,543,267,276
64800,50220,7803,24244,5161,42417,543,267,276
64805,50221,7803,24245,5161,42418,543,267,276
64810,50226,7803,24249,5161,42423,543,267,276
64815,50228,7803,24250,5161,42425,543,267,276
64820,50236,7803,24254,5161,42433,543,267,276
64825,50239,7803,24256,5161,42436,543,267,276
64830,50244,7803,24259,5161,42441,543,267,276
64835,50248,7803,24262,5161,42445,543,267,276
64840,50251,7803,24265,5161,42448,543,267,276
64845,50252,7803,24265,5161,42449,543,267,276
64850,50257,7803,24269,5161,42454,543,267,276
64855,50259,7803,24270,5161,42456,543,267,276
64860,50267,7803,24274,5161,42464,543,267,276
64865,50270,7803,24275,5161,42467,543,267,276
64870,50275,7803,24279,5161,42472,543,267,276
64875,50279,7803,24281,5161,42476,543,267,276
64880,50282,7803,24282,5161,42479,543,267,276
64885,50283,7803,24283,5161,42480,543,267,276
64890,50288,7803,24285,5161,42485,543,267,276
64895,50290,7803,24287,5161,42487,543,267,276
64900,50298,7803,24289,5161,42495,543,267,276
64905,50301,7803,24290,5161,42498,543,267,276
64910,50306,7803,24292,5161,42503,543,267,276
64915,50310,7803,24296,5161,42507,543,267,276
64920,50313,7803,24297,5161,42510,543,267,276
64925,50314,7803,24298,5161,42511,543,267,276
64930,50319,7803,24301,5161,42516,543,267,276
64935,50321,7803,24302,5161,42518,543,267,276
64940,50329,7803,24304,5161,42526,543,267,276
64945,50332,7803,24306,5161,42529,543,267,276
64950,50337,7803,24310,5161,42534,543,267,276
64955,50341,7803,24311,5161,42538,543,267,276
64960,50344,7803,24312,5161,42541,543,267,276
64965,50345,7803,24312,5161,42542,543,267,276
64970,50350,7803,24314,5161,42547,543,267,276
64975,50352,7803,24316,5161,42549,543,267,276
64980,50360,7803,24320,5161,42557,543,267,276
64985,50363,7803,24322,5161,42560,543,267,276
64990,50368,7803,24324,5161,42565,543,267,276
64995,50372,7803,24327,5161,42569,543,267,276
65000,50375,7803,24328,5161,42572,543,267,276
65005,50376,7803,24329,5161,42573,543,267,276
65010,50381,7803,24332,5161,42578,543,267,276
65015,50383,7803,24333,5161,42580,543,267,276
65020,50391,7803,24336,5161,42588,543,267,276
65025,50394,7803,24338,5161,42591,543,267,276
65030,50399,7803,24340,5161,42596,543,267,276
65035,50403,7803,24342,5161,42600,543,267,276
65040,50406,7803,24343,5161,42603,543,267,276
65045,50407,7803,24343,5161,42604,543,267,276
65050,50412,7803,24347,5161,42609,543,267,276
65055,50414,7803,24349,5161,42611,543,267,276
65060,50422,7803,24352,5161,42619,543,267,276
65065,50425,7803,24353,5161,42622,543,267,276
65070,50430,7803,24357,5161,42627,543,267,276
65075,50434,7803,24358,5161,42631,543,267,276
65080,50437,7803,24360,5161,42634,543,267,276
65085,50438,7803,24361,5161,42635,543,267,276
65090,50443,7803,24363,5161,42640,543,267,276
65095,50445,7803,24364,5161,42642,543,267,276
65100,50453,7803,24369,5161,42650,543,267,276
65105,50456,7803,24370,5161,42653,543,267,276
65110,50461,7803,24373,5161,42658,543,267,276
65115,50465,7803,24375,5161,42662,543,267,276
65120,50468,7803,24377,5161,42665,543,267,276
65125,50469,7803,24378,5161,42666,543,267,276
65130,50474,7803,24380,5161,42671,543,267,276
65135,50476,7803,24381,5161,42673,543,267,276
65140,50484,7803,24384,5161,42681,543,267,276
65145,50487,7803,24386,5161,42684,543,267,276
65150,50492,7803,24386,5161,42689,543,267,276
65155,50496,7803,24389,5161,42693,543,267,276
65160,50499,7803,24391,5161,42696,543,267,276
65165,50500,7803,24391,5161,42697,543,267,276
65170,50505,7803,24395,5161,42702,543,267,276
65175,50507,7803,24395,5161,42704,543,267,276
65180,50515,7803,24397,5161,42712,543,267,276
65185,50518,7803,24397,5161,42715,543,267,276
65190,50523,7803,24399,5161,42720,543,267,276
65195,50527,7803,24400,5161,42724,543,267,276
65200,50530,7803,24402,5161,42727,543,267,276
65205,50531,7803,24402,5161,42728,543,267,276
65210,50536,7803,24403,5161,42733,543,267,276
65215,50538,7803,24404,5161,42735,543,267,276
65220,50546,7803,24408,5161,42743,543,267,276
65225,50549,7803,24409,5161,42746,543,267,276
65230,50554,7803,24411,5161,42751,543,267,276
65235,50558,7803,24412,5161,42755,543,267,276
65240,50561,7803,24414,5161,42758,543,267,276
65245,50562,7803,24414,5161,42759,543,267,276
65250,50567,7803,24417,5161,42764,543,267,276
65255,50569,7803,24418,5161,42766,543,267,276
65260,50577,7803,24419,5161,42774,543,267,276
65265,50580,7803,24421,5161,42777,543,267,276
65270,50585,7803,24423,5161,42782,543,267,276
65275,50589,7803,24425,5161,42786,543,267,276
65280,50592,7803,24426,5161,42789,543,267,276
65285,50593,7803,24427,5161,42790,543,267,276
65290,50598,7803,24429,5161,42795,543,267,276
65295,50600,7803,24430,5161,42797,543,267,276
65300,50608,7803,24436,5161,42805,543,267,276
65305,50611,7803,24439,5161,42808,543,267,276
65310,50616,7803,24443,5161,42813,543,267,276
65315,50620,7803,24444,5161,42817,543,267,276
65320,50623,7803,24445,5161,42820,543,267,276
65325,50624,7803,24446,5161,42821,543,267,276
65330,50629,7803,24447,5161,42826,543,267,276
65335,50631,7803,24447,5161,42828,543,267,276
65340,50639,7803,24450,5161,42836,543,267,276
65345,50642,7803,24451,5161,42839,543,267,276
65350,50647,7803,24454,5161,42844,543,267,276
65355,50651,7803,24456,5161,42848,543,267,276
65360,50654,7803,24457,5161,42851,543,267,276
65365,50655,7803,24457,5161,42852,543,267,276
65370,50660,7803,24460,5161,42857,543,267,276
65375,50662,7803,24462,5161,42859,543,267,276
65380,50670,7803,24466,5161,42867,543,267,276
65385,50673,7803,24467,5161,42870,543,267,276
65390,50678,7803,24469,5161,42875,543,267,276
65395,50682,7803,24473,5161,42879,543,267,276
65400,50685,7803,24475,5161,42882,543,267,276
65405,50686,7803,24476,5161,42883,543,267,276
65410,50691,7803,24477,5161,42888,543,267,276
65415,50693,7803,24477,5161,42890,543,267,276
65420,50701,7803,24481,5161,42898,543,267,276
65425,50704,7803,24483,5161,42901,543,267,276
65430,50709,7803,24485,5161,42906,543,267,276
65435,50713,7803,24488,5161,42910,543,267,276
65440,50716,7803,24490,5161,42913,543,267,276
65445,50717,7803,24490,5161,42914,543,267,276
65450,50722,7803,24494,5161,42919,543,267,276
65455,50724,7803,24495,5161,42921,543,267,276
65460,50732,7803,24501,5161,42929,543,267,276
65465,50735,7803,24502,5161,42932,543,267,276
65470,50740,7803,24504,5161,42937,543,267,276
65475,50744,7803,24508,5161,42941,543,267,276
65480,50747,7803,24510,5161,42944,543,267,276
65485,50748,7803,24510,5161,42945,543,267,276
65490,50753,7803,24512,5161,42950,543,267,276
65495,50755,7803,24512,5161,42952,543,267,276
65500,50763,7803,24514,5161,42960,543,267,276
65505,50766,7803,24514,5161,42963,543,267,276
65510,50771,7803,24516,5161,42968,543,267,276
65515,50775,7803,24518,5161,42972,543,267,276
65520,50778,7803,24519,5161,42975,543,267,276
65525,50779,7803,24519,5161,42976,543,267,276
65530,50784,7803,24522,5161,42981,543,267,276
65535,50786,7803,24522,5161,42983,543,267,276
65540,50794,7803,24526,5161,42991,543,267,276
65545,50797,7803,24528,5161,42994,543,267,276
65550,50802,7803,24531,5161,42999,543,267,276
65555,50806,7803,24533,5161,43003,543,267,276
65560,50809,7803,24536,5161,43006,543,267,276
65565,50810,7803,24537,5161,43007,543,267,276
65570,50815,7803,24540,5161,43012,543,267,276
65575,50817,7803,24542,5161,43014,543,267,276
65580,50825,7803,24546,5161,43022,543,267,276
65585,50828,7803,24548,5161,43025,543,267,276
65590,50833,7803,24551,5161,43030,543,267,276
65595,50837,7803,24553,5161,43034,543,267,276
65600,50840,7803,24553,5161,43037,543,267,276
65605,50841,7803,24554,5161,43038,543,267,276
65610,50846,7803,24557,5161,43043,543,267,276
65615,50848,7803,24558,5161,43045,543,267,276
65620,50856,7803,24562,5161,43053,543,267,276
65625,50859,7803,24564,5161,43056,543,267,276
65630,50864,7803,24566,5161,43061,543,267,276
65635,50868,7803,24568,5161,43065,543,267,276
65640,50871,7803,24570,5161,43068,543,267,276
65645,50872,7803,24571,5161,43069,543,267,276
65650,50877,7803,24574,5161,43074,543,267,276
65655,50879,7803,24575,5161,43076,543,267,276
65660,50887,7803,24579,5161,43084,543,267,276
65665,50890,7803,24581,5161,43087,543,267,276
65670,50895,7803,24582,5161,43092,543,267,276
65675,50899,7803,24585,5161,43096,543,267,276
65680,50902,7803,24585,5161,43099,543,267,276
65685,50903,7803,24585,5161,43100,543,267,276
65690,50908,7803,24587,5161,43105,543,267,276
65695,50910,7803,24588,5161,43107,543,267,276
65700,50918,7803,24590,5161,43115,543,267,276
65705,50921,7803,24590,5161,43118,543,267,276
65710,50926,7803,24593,5161,43123,543,267,276
65715,50930,7803,24596,5161,43127,543,267,276
65720,50933,7803,24597,5161,43130,543,267,276
65725,50934,7803,24597,5161,43131,543,267,276
65730,50939,7803,24598,5161,43136,543,267,276
65735,50941,7803,24600,5161,43138,543,267,276
65740,50949,7803,24602,5161,43146,543,267,276
65745,50952,7803,24604,5161,43149,543,267,276
65750,50957,7803,24606,5161,43154,543,267,276
65755,50961,7803,24606,5161,43158,543,267,276
65760,50964,7803,24609,5161,43161,543,267,276
65765,50965,7803,24609,5161,43162,543,267,276
65770,50970,7803,24614,5161,43167,543,267,276
65775,50972,7803,24615,5161,43169,543,267,276
65780,50980,7803,24618,5161,43177,543,267,276
65785,50983,7803,24620,5161,43180,543,267,276
65790,50988,7803,24622,5161,43185,543,267,276
65795,50992,7803,24625,5161,43189,543,267,276
65800,50995,7803,24625,5161,43192,543,267,276
65805,50996,7803,24626,5161,43193,543,267,276
65810,51001,7803,24631,5161,43198,543,267,276
65815,51003,7803,24631,5161,43200,543,267,276
65820,51011,7803,24633,5161,43208,543,267,276
65825,51014,7803,24633,5161,43211,543,267,276
65830,51019,7803,24637,5161,43216,543,267,276
65835,51023,7803,24639,5161,43220,543,267,276
65840,51026,7803,24640,5161,43223,543,267,276
65845,51027,7803,24641,5161,43224,543,267,276
65850,51032,7803,24641,5161,43229,543,267,276
65855,51034,7803,24642,5161,43231,543,267,276
65860,51042,7803,24646,5161,43239,543,267,276
65865,51045,7803,24648,5161,43242,543,267,276
65870,51050,7803,24651,5161,43247,543,267,276
65875,51054,7803,24653,5161,43251,543,267,276
65880,51057,7803,24655,5161,43254,543,267,276
65885,51058,7803,24656,5161,43255,543,267,276
65890,51063,7803,24659,5161,43260,543,267,276
65895,51065,7803,24661,5161,43262,543,267,276
65900,51073,7803,24664,5161,43270,543,267,276
65905,51076,7803,24666,5161,43273,543,267,276
65910,51081,7803,24667,5161,43278,543,267,276
65915,51085,7803,24671,5161,43282,543,267,276
65920,51088,7803,24673,5161,43285,543,267,276
65925,51089,7803,24673,5161,43286,543,267,276
65930,51094,7803,24675,5161,43291,543,267,276
65935,51096,7803,24676,5161,43293,543,267,276
65940,51104,7803,24680,5161,43301,543,267,276
65945,51107,7803,24681,5161,43304,543,267,276
65950,51112,7803,24684,5161,43309,543,267,276
65955,51116,7803,24686,5161,43313,543,267,276
65960,51119,7803,24687,5161,43316,543,267,276
65965,51120,7803,24687,5161,43317,543,267,276
65970,51125,7803,24689,5161,43322,543,267,276
65975,51127,7803,24689,5161,43324,543,267,276
65980,51135,7803,24692,5161,43332,543,267,276
65985,51138,7803,24692,5161,43335,543,267,276
65990,51143,7803,24695,5161,43340,543,267,276
65995,51147,7803,24697,5161,43344,543,267,276
66000,51150,7803,24700,5161,43347,543,267,276
66005,51151,7803,24700,5161,43348,543,267,276
66010,51156,7803,24702,5161,43353,543,267,276
66015,51158,7803,24703,5161,43355,543,267,276
66020,51166,7803,24709,5161,43363,543,267,276
66025,51169,7803,24712,5161,43366,543,267,276
66030,51174,7803,24716,5161,43371,543,267,276
66035,51178,7803,24717,5161,43375,543,267,276
66040,51181,7803,24718,5161,43378,543,267,276
66045,51182,7803,24718,5161,43379,543,267,276
66050,51187,7803,24720,5161,43384,543,267,276
66055,51189,7803,24722,5161,43386,543,267,276
66060,51197,7803,24725,5161,43394,543,267,276
66065,51200,7803,24726,5161,43397,543,267,276
66070,51205,7803,24729,5161,43402,543,267,276
66075,51209,7803,24732,5161,43406,543,267,276
66080,51212,7803,24733,5161,43409,543,267,276
66085,51213,7803,24734,5161,43410,543,267,276
66090,51218,7803,24737,5161,43415,543,267,276
66095,51220,7803,24737,5161,43417,543,267,276
66100,51228,7803,24740,5161,43425,543,267,276
66105,51231,7803,24740,5161,43428,543,267,276
66110,51236,7803,24743,5161,43433,543,267,276
66115,51240,7803,24745,5161,43437,543,267,276
66120,51243,7803,24747,5161,43440,543,267,276
66125,51244,7803,24747,5161,43441,543,267,276
66130,51249,7803,24749,5161,43446,543,267,276
66135,51251,7803,24749,5161,43448,543,267,276
66140,51259,7803,24752,5161,43456,543,267,276
66145,51262,7803,24755,5161,43459,543,267,276
66150,51267,7803,24760,5161,43464,543,267,276
66155,51271,7803,24760,5161,43468,543,267,276
66160,51274,7803,24761,5161,43471,543,267,276
66165,51275,7803,24762,5161,43472,543,267,276
66170,51280,7803,24765,5161,43477,543,267,276
66175,51282,7803,24766,5161,43479,543,267,276
66180,51290,7803,24770,5161,43487,543,267,276
66185,51293,7803,24770,5161,43490,543,267,276
66190,51298,7803,24773,5161,43495,543,267,276
66195,51302,7803,24776,5161,43499,543,267,276
66200,51305,7803,24779,5161,43502,543,267,276
66205,51306,7803,24780,5161,43503,543,267,276
66210,51311,7803,24782,5161,43508,543,267,276
66215,51313,7803,24782,5161,43510,543,267,276
66220,51321,7803,24787,5161,43518,543,267,276
66225,51324,7803,24790,5161,43521,543,267,276
66230,51329,7803,24791,5161,43526,543,267,276
66235,51333,7803,24793,5161,43530,543,267,276
66240,51336,7803,24794,5161,43533,543,267,276
66245,51337,7803,24795,5161,43534,543,267,276
66250,51342,7803,24799,5161,43539,543,267,276
66255,51344,7803,24799,5161,43541,543,267,276
66260,51352,7803,24800,5161,43549,543,267,276
66265,51355,7803,24803,5161,43552,543,267,276
66270,51360,7803,24804,5161,43557,543,267,276
66275,51364,7803,24807,5161,43561,543,267,276
66280,51367,7803,24809,5161,43564,543,267,276
66285,51368,7803,24809,5161,43565,543,267,276
66290,51373,7803,24810,5161,43570,543,267,276
66295,51375,7803,24811,5161,43572,543,267,276
66300,51383,7803,24815,5161,43580,543,267,276
66305,51386,7803,24816,5161,43583,543,267,276
66310,51391,7803,24818,5161,43588,543,267,276
66315,51395,7803,24820,5161,43592,543,267,276
66320,51398,7803,24822,5161,43595,543,267,276
66325,51399,7803,24822,5161,43596,543,267,276
66330,51404,7803,24823,5161,43601,543,267,276
66335,51406,7803,24823,5161,43603,543,267,276
66340,51414,7803,24827,5161,43611,543,267,276
66345,51417,7803,24828,5161,43614,543,267,276
66350,51422,7803,24833,5161,43619,543,267,276
66355,51426,7803,24836,5161,43623,543,267,276
66360,51429,7803,24838,5161,43626,543,267,276
66365,51430,7803,24839,5161,43627,543,267,276
66370,51435,7803,24841,5161,43632,543,267,276
66375,51437,7803,24842,5161,43634,543,267,276
66380,51445,7803,24847,5161,43642,543,267,276
66385,51448,7803,24848,5161,43645,543,267,276
66390,51453,7803,24849,5161,43650,543,267,276
66395,51457,7803,24851,5161,43654,543,267,276
66400,51460,7803,24852,5161,43657,543,267,276
66405,51461,7803,24853,5161,43658,543,267,276
66410,51466,7803,24855,5161,43663,543,267,276
66415,51468,7803,24855,5161,43665,543,267,276
66420,51476,7803,24858,5161,43673,543,267,276
66425,51479,7803,24859,5161,43676,543,267,276
66430,51484,7803,24862,5161,43681,543,267,276
66435,51488,7803,24864,5161,43685,543,267,276
66440,51491,7803,24866,5161,43688,543,267,276
66445,51492,7803,24867,5161,43689,543,267,276
66450,51497,7803,24867,5161,43694,543,267,276
66455,51499,7803,24869,5161,43696,543,267,276
66460,51507,7803,24872,5161,43704,543,267,276
66465,51510,7803,24872,5161,43707,543,267,276
66470,51515,7803,24874,5161,43712,543,267,276
66475,51519,7803,24875,5161,43716,543,267,276
66480,51522,7803,24877,5161,43719,543,267,276
66485,51523,7803,24877,5161,43720,543,267,276
66490,51528,7803,24878,5161,43725,543,267,276
66495,51530,7803,24880,5161,43727,543,267,276
66500,51538,7803,24883,5161,43735,543,267,276
66505,51541,7803,24885,5161,43738,543,267,276
66510,51546,7803,24886,5161,43743,543,267,276
66515,51550,7803,24888,5161,43747,543,267,276
66520,51553,7803,24889,5161,43750,543,267,276
66525,51554,7803,24890,5161,43751,543,267,276
66530,51559,7803,24893,5161,43756,543,267,276
66535,51561,7803,24893,5161,43758,543,267,276
66540,51569,7803,24898,5161,43766,543,267,276
66545,51572,7803,24899,5161,43769,543,267,276
66550,51577,7803,24902,5161,43774,543,267,276
66555,51581,7803,24903,5161,43778,543,267,276
66560,51584,7803,24903,5161,43781,543,267,276
66565,51585,7803,24904,5161,43782,543,267,276
66570,51590,7803,24908,5161,43787,543,267,276
66575,51592,7803,24909,5161,43789,543,267,276
66580,51600,7803,24914,5161,43797,543,267,276
66585,51603,7803,24916,5161,43800,543,267,276
66590,51608,7803,24917,5161,43805,543,267,276
66595,51612,7803,24919,5161,43809,543,267,276
66600,51615,7803,24920,5161,43812,543,267,276
66605,51616,7803,24920,5161,43813,543,267,276
66610,51621,7803,24921,5161,43818,543,267,276
66615,51623,7803,24922,5161,43820,543,267,276
66620,51631,7803,24925,5161,43828,543,267,276
66625,51634,7803,24926,5161,43831,543,267,276
66630,51639,7803,24928,5161,43836,543,267,276
66635,51643,7803,24930,5161,43840,543,267,276
66640,51646,7803,24931,5161,43843,543,267,276
66645,51647,7803,24932,5161,43844,543,267,276
66650,51652,7803,24935,5161,43849,543,267,276
66655,51654,7803,24935,5161,43851,543,267,276
66660,51662,7803,24940,5161,43859,543,267,276
66665,51665,7803,24941,5161,43862,543,267,276
66670,51670,7803,24942,5161,43867,543,267,276
66675,51674,7803,24945,5161,43871,543,267,276
66680,51677,7803,24946,5161,43874,543,267,276
66685,51678,7803,24946,5161,43875,543,267,276
66690,51683,7803,24948,5161,43880,543,267,276
66695,51685,7803,24950,5161,43882,543,267,276
66700,51693,7803,24953,5161,43890,543,267,276
66705,51696,7803,24955,5161,43893,543,267,276
66710,51701,7803,24957,5161,43898,543,267,276
66715,51705,7803,24958,5161,43902,543,267,276
66720,51708,7803,24959,5161,43905,543,267,276
66725,51709,7803,24960,5161,43906,543,267,276
66730,51714,7803,24961,5161,43911,543,267,276
66735,51716,7803,24962,5161,43913,543,267,276
66740,51724,7803,24966,5161,43921,543,267,276
66745,51727,7803,24968,5161,43924,543,267,276
66750,51732,7803,24971,5161,43929,543,267,276
66755,51736,7803,24973,5161,43933,543,267,276
66760,51739,7803,24975,5161,43936,543,267,276
66765,51740,7803,24975,5161,43937,543,267,276
66770,51745,7803,24978,5161,43942,543,267,276
66775,51747,7803,24979,5161,43944,543,267,276
66780,51755,7803,24982,5161,43952,543,267,276
66785,51758,7803,24984,5161,43955,543,267,276
66790,51763,7803,24988,5161,43960,543,267,276
66795,51767,7803,24990,5161,43964,543,267,276
66800,51770,7803,24993,5161,43967,543,267,276
66805,51771,7803,24994,5161,43968,543,267,276
66810,51776,7803,24995,5161,43973,543,267,276
66815,51778,7803,24995,5161,43975,543,267,276
66820,51786,7803,25000,5161,43983,543,267,276
66825,51789,7803,25001,5161,43986,543,267,276
66830,51794,7803,25005,5161,43991,543,267,276
66835,51798,7803,25006,5161,43995,543,267,276
66840,51801,7803,25008,5161,43998,543,267,276
66845,51802,7803,25008,5161,43999,543,267,276
66850,51807,7803,25010,5161,44004,543,267,276
66855,51809,7803,25010,5161,44006,543,267,276
66860,51817,7803,25014,5161,44014,543,267,276
66865,51820,7803,25015,5161,44017,543,267,276
66870,51825,7803,25019,5161,44022,543,267,276
66875,51829,7803,25023,5161,44026,543,267,276
66880,51832,7803,25024,5161,44029,543,267,276
66885,51833,7803,25025,5161,44030,543,267,276
66890,51838,7803,25028,5161,44035,543,267,276
66895,51840,7803,25030,5161,44037,543,267,276
66900,51848,7803,25036,5161,44045,543,267,276
66905,51851,7803,25037,5161,44048,543,267,276
66910,51856,7803,25040,5161,44053,543,267,276
66915,51860,7803,25042,5161,44057,543,267,276
66920,51863,7803,25043,5161,44060,543,267,276
66925,51864,7803,25043,5161,44061,543,267,276
66930,51869,7803,25045,5161,44066,543,267,276
66935,51871,7803,25046,5161,44068,543,267,276
66940,51879,7803,25048,5161,44076,543,267,276
66945,51882,7803,25050,5161,44079,543,267,276
66950,51887,7803,25051,5161,44084,543,267,276
66955,51891,7803,25053,5161,44088,543,267,276
66960,51894,7803,25054,5161,44091,543,267,276
66965,51895,7803,25055,5161,44092,543,267,276
66970,51900,7803,25057,5161,44097,543,267,276
66975,51902,7803,25057,5161,44099,543,267,276
66980,51910,7803,25061,5161,44107,543,267,276
66985,51913,7803,25063,5161,44110,543,267,276
66990,51918,7803,25066,5161,44115,543,267,276
66995,51922,7803,25067,5161,44119,543,267,276
67000,51925,7803,25068,5161,44122,543,267,276
67005,51926,7803,25069,5161,44123,543,267,276
67010,51931,7803,25072,5161,44128,543,267,276
67015,51933,7803,25072,5161,44130,543,267,276
67020,51941,7803,25075,5161,44138,543,267,276
67025,51944,7803,25077,5161,44141,543,267,276
67030,51949,7803,25078,5161,44146,543,267,276
67035,51953,7803,25081,5161,44150,543,267,276
67040,51956,7803,25084,5161,44153,543,267,276
67045,51957,7803,25084,5161,44154,543,267,276
67050,51962,7803,25086,5161,44159,543,267,276
67055,51964,7803,25088,5161,44161,543,267,276
67060,51972,7803,25092,5161,44169,543,267,276
67065,51975,7803,25093,5161,44172,543,267,276
67070,51980,7803,25096,5161,44177,543,267,276
67075,51984,7803,25099,5161,44181,543,267,276
67080,51987,7803,25099,5161,44184,543,267,276
67085,51988,7803,25099,5161,44185,543,267,276
67090,51993,7803,25102,5161,44190,543,267,276
67095,51995,7803,25103,5161,44192,543,267,276
67100,52003,7803,25105,5161,44200,543,267,276
67105,52006,7803,25106,5161,44203,543,267,276
67110,52011,7803,25109,5161,44208,543,267,276
67115,52015,7803,25112,5161,44212,543,267,276
67120,52018,7803,25112,5161,44215,543,267,276
67125,52019,7803,25112,5161,44216,543,267,276
67130,52024,7803,25116,5161,44221,543,267,276
67135,52026,7803,25117,5161,44223,543,267,276
67140,52034,7803,25120,5161,44231,543,267,276
67145,52037,7803,25122,5161,44234,543,267,276
67150,52042,7803,25126,5161,44239,543,267,276
67155,52046,7803,25127,5161,44243,543,267,276
67160,52049,7803,25130,5161,44246,543,267,276
67165,52050,7803,25131,5161,44247,543,267,276
67170,52055,7803,25134,5161,44252,543,267,276
67175,52057,7803,25134,5161,44254,543,267,276
67180,52065,7803,25138,5161,44262,543,267,276
67185,52068,7803,25140,5161,44265,543,267,276
67190,52073,7803,25143,5161,44270,543,267,276
67195,52077,7803,25146,5161,44274,543,267,276
67200,52080,7803,25149,5161,44277,543,267,276
67205,52081,7803,25150,5161,44278,543,267,276
67210,52086,7803,25151,5161,44283,543,267,276
67215,52088,7803,25152,5161,44285,543,267,276
67220,52096,7803,25154,5161,44293,543,267,276
67225,52099,7803,25155,5161,44296,543,267,276
67230,52104,7803,25155,5161,44301,543,267,276
67235,52108,7803,25158,5161,44305,543,267,276
67240,52111,7803,25158,5161,44308,543,267,276
67245,52112,7803,25158,5161,44309,543,267,276
67250,52117,7803,25159,5161,44314,543,267,276
67255,52119,7803,25160,5161,44316,543,267,276
67260,52127,7803,25162,5161,44324,543,267,276
67265,52130,7803,25163,5161,44327,543,267,276
67270,52135,7803,25165,5161,44332,543,267,276
67275,52139,7803,25165,5161,44336,543,267,276
67280,52142,7803,25168,5161,44339,543,267,276
67285,52143,7803,25169,5161,44340,543,267,276
67290,52148,7803,25170,5161,44345,543,267,276
67295,52150,7803,25172,5161,44347,543,267,276
67300,52158,7803,25176,5161,44355,543,267,276
67305,52161,7803,25177,5161,44358,543,267,276
67310,52166,7803,25179,5161,44363,543,267,276
67315,52170,7803,25180,5161,44367,543,267,276
67320,52173,7803,25182,5161,44370,543,267,276
